"Year";"port";"limfjord_placement";"n_from";"n_to";"trafic";"decLatitude";"decLongitude"
1634;"Aalborg";"east";5;0;5;57,047777;9,918611
1635;"Aalborg";"east";14;2;16;57,047777;9,918611
1636;"Aalborg";"east";10;1;11;57,047777;9,918611
1637;"Aalborg";"east";12;0;12;57,047777;9,918611
1638;"Aalborg";"east";14;0;14;57,047777;9,918611
1639;"Aalborg";"east";10;1;11;57,047777;9,918611
1640;"Aalborg";"east";32;0;32;57,047777;9,918611
1641;"Aalborg";"east";19;0;19;57,047777;9,918611
1642;"Aalborg";"east";22;1;23;57,047777;9,918611
1643;"Aalborg";"east";19;1;20;57,047777;9,918611
1644;"Aalborg";"east";4;0;4;57,047777;9,918611
1645;"Aalborg";"east";0;0;0;57,047777;9,918611
1646;"Aalborg";"east";15;1;16;57,047777;9,918611
1647;"Aalborg";"east";7;1;8;57,047777;9,918611
1648;"Aalborg";"east";6;1;7;57,047777;9,918611
1649;"Aalborg";"east";8;0;8;57,047777;9,918611
1650;"Aalborg";"east";14;3;17;57,047777;9,918611
1651;"Aalborg";"east";5;2;7;57,047777;9,918611
1652;"Aalborg";"east";11;1;12;57,047777;9,918611
1653;"Aalborg";"east";7;1;8;57,047777;9,918611
1654;"Aalborg";"east";3;0;3;57,047777;9,918611
1655;"Aalborg";"east";4;0;4;57,047777;9,918611
1656;"Aalborg";"east";5;0;5;57,047777;9,918611
1657;"Aalborg";"east";4;0;4;57,047777;9,918611
1658;"Aalborg";"east";1;0;1;57,047777;9,918611
1659;"Aalborg";"east";0;0;0;57,047777;9,918611
1660;"Aalborg";"east";0;0;0;57,047777;9,918611
1661;"Aalborg";"east";8;1;9;57,047777;9,918611
1662;"Aalborg";"east";13;2;15;57,047777;9,918611
1663;"Aalborg";"east";15;6;21;57,047777;9,918611
1664;"Aalborg";"east";13;5;18;57,047777;9,918611
1665;"Aalborg";"east";9;5;14;57,047777;9,918611
1666;"Aalborg";"east";10;3;13;57,047777;9,918611
1667;"Aalborg";"east";8;6;14;57,047777;9,918611
1668;"Aalborg";"east";12;3;15;57,047777;9,918611
1669;"Aalborg";"east";6;3;9;57,047777;9,918611
1670;"Aalborg";"east";8;4;12;57,047777;9,918611
1671;"Aalborg";"east";12;5;17;57,047777;9,918611
1672;"Aalborg";"east";15;5;20;57,047777;9,918611
1673;"Aalborg";"east";23;5;28;57,047777;9,918611
1674;"Aalborg";"east";18;11;29;57,047777;9,918611
1675;"Aalborg";"east";3;0;3;57,047777;9,918611
1676;"Aalborg";"east";4;4;8;57,047777;9,918611
1677;"Aalborg";"east";7;2;9;57,047777;9,918611
1678;"Aalborg";"east";7;5;12;57,047777;9,918611
1679;"Aalborg";"east";15;8;23;57,047777;9,918611
1680;"Aalborg";"east";18;11;29;57,047777;9,918611
1681;"Aalborg";"east";17;5;22;57,047777;9,918611
1682;"Aalborg";"east";4;6;10;57,047777;9,918611
1683;"Aalborg";"east";8;5;13;57,047777;9,918611
1684;"Aalborg";"east";12;10;22;57,047777;9,918611
1685;"Aalborg";"east";15;12;27;57,047777;9,918611
1686;"Aalborg";"east";11;5;16;57,047777;9,918611
1687;"Aalborg";"east";16;16;32;57,047777;9,918611
1688;"Aalborg";"east";18;13;31;57,047777;9,918611
1689;"Aalborg";"east";5;5;10;57,047777;9,918611
1690;"Aalborg";"east";12;9;21;57,047777;9,918611
1691;"Aalborg";"east";10;6;16;57,047777;9,918611
1692;"Aalborg";"east";13;7;20;57,047777;9,918611
1693;"Aalborg";"east";15;16;31;57,047777;9,918611
1694;"Aalborg";"east";22;16;38;57,047777;9,918611
1695;"Aalborg";"east";14;10;24;57,047777;9,918611
1696;"Aalborg";"east";19;14;33;57,047777;9,918611
1697;"Aalborg";"east";21;18;39;57,047777;9,918611
1698;"Aalborg";"east";18;14;32;57,047777;9,918611
1699;"Aalborg";"east";21;10;31;57,047777;9,918611
1700;"Aalborg";"east";10;8;18;57,047777;9,918611
1701;"Aalborg";"east";14;10;24;57,047777;9,918611
1702;"Aalborg";"east";18;18;36;57,047777;9,918611
1703;"Aalborg";"east";16;13;29;57,047777;9,918611
1704;"Aalborg";"east";15;14;29;57,047777;9,918611
1705;"Aalborg";"east";26;19;45;57,047777;9,918611
1706;"Aalborg";"east";38;10;48;57,047777;9,918611
1707;"Aalborg";"east";24;14;38;57,047777;9,918611
1708;"Aalborg";"east";24;15;39;57,047777;9,918611
1709;"Aalborg";"east";18;7;25;57,047777;9,918611
1710;"Aalborg";"east";15;7;22;57,047777;9,918611
1711;"Aalborg";"east";16;2;18;57,047777;9,918611
1712;"Aalborg";"east";15;4;19;57,047777;9,918611
1713;"Aalborg";"east";15;3;18;57,047777;9,918611
1714;"Aalborg";"east";8;3;11;57,047777;9,918611
1715;"Aalborg";"east";11;3;14;57,047777;9,918611
1716;"Aalborg";"east";9;6;15;57,047777;9,918611
1717;"Aalborg";"east";16;11;27;57,047777;9,918611
1718;"Aalborg";"east";6;2;8;57,047777;9,918611
1719;"Aalborg";"east";11;8;19;57,047777;9,918611
1720;"Aalborg";"east";13;6;19;57,047777;9,918611
1721;"Aalborg";"east";34;12;46;57,047777;9,918611
1722;"Aalborg";"east";30;10;40;57,047777;9,918611
1723;"Aalborg";"east";28;11;39;57,047777;9,918611
1724;"Aalborg";"east";18;11;29;57,047777;9,918611
1725;"Aalborg";"east";25;16;41;57,047777;9,918611
1726;"Aalborg";"east";21;19;40;57,047777;9,918611
1727;"Aalborg";"east";19;14;33;57,047777;9,918611
1728;"Aalborg";"east";21;21;42;57,047777;9,918611
1729;"Aalborg";"east";19;25;44;57,047777;9,918611
1730;"Aalborg";"east";26;33;59;57,047777;9,918611
1731;"Aalborg";"east";25;24;49;57,047777;9,918611
1732;"Aalborg";"east";15;22;37;57,047777;9,918611
1733;"Aalborg";"east";24;22;46;57,047777;9,918611
1734;"Aalborg";"east";27;25;52;57,047777;9,918611
1735;"Aalborg";"east";23;23;46;57,047777;9,918611
1736;"Aalborg";"east";19;24;43;57,047777;9,918611
1737;"Aalborg";"east";31;33;64;57,047777;9,918611
1738;"Aalborg";"east";18;20;38;57,047777;9,918611
1739;"Aalborg";"east";18;22;40;57,047777;9,918611
1740;"Aalborg";"east";21;22;43;57,047777;9,918611
1741;"Aalborg";"east";28;28;56;57,047777;9,918611
1742;"Aalborg";"east";29;30;59;57,047777;9,918611
1743;"Aalborg";"east";20;20;40;57,047777;9,918611
1744;"Aalborg";"east";18;25;43;57,047777;9,918611
1745;"Aalborg";"east";28;32;60;57,047777;9,918611
1746;"Aalborg";"east";30;44;74;57,047777;9,918611
1747;"Aalborg";"east";19;38;57;57,047777;9,918611
1748;"Aalborg";"east";16;22;38;57,047777;9,918611
1749;"Aalborg";"east";17;29;46;57,047777;9,918611
1750;"Aalborg";"east";9;22;31;57,047777;9,918611
1751;"Aalborg";"east";12;21;33;57,047777;9,918611
1752;"Aalborg";"east";6;21;27;57,047777;9,918611
1753;"Aalborg";"east";8;22;30;57,047777;9,918611
1754;"Aalborg";"east";13;27;40;57,047777;9,918611
1755;"Aalborg";"east";15;22;37;57,047777;9,918611
1756;"Aalborg";"east";9;25;34;57,047777;9,918611
1757;"Aalborg";"east";11;17;28;57,047777;9,918611
1758;"Aalborg";"east";15;23;38;57,047777;9,918611
1759;"Aalborg";"east";18;24;42;57,047777;9,918611
1760;"Aalborg";"east";10;21;31;57,047777;9,918611
1761;"Aalborg";"east";11;24;35;57,047777;9,918611
1762;"Aalborg";"east";6;24;30;57,047777;9,918611
1763;"Aalborg";"east";11;29;40;57,047777;9,918611
1764;"Aalborg";"east";14;18;32;57,047777;9,918611
1765;"Aalborg";"east";15;23;38;57,047777;9,918611
1766;"Aalborg";"east";15;24;39;57,047777;9,918611
1767;"Aalborg";"east";14;28;42;57,047777;9,918611
1768;"Aalborg";"east";11;24;35;57,047777;9,918611
1769;"Aalborg";"east";4;26;30;57,047777;9,918611
1770;"Aalborg";"east";11;23;34;57,047777;9,918611
1771;"Aalborg";"east";6;23;29;57,047777;9,918611
1772;"Aalborg";"east";8;25;33;57,047777;9,918611
1773;"Aalborg";"east";10;21;31;57,047777;9,918611
1774;"Aalborg";"east";9;19;28;57,047777;9,918611
1775;"Aalborg";"east";6;16;22;57,047777;9,918611
1776;"Aalborg";"east";10;21;31;57,047777;9,918611
1777;"Aalborg";"east";10;18;28;57,047777;9,918611
1778;"Aalborg";"east";10;16;26;57,047777;9,918611
1779;"Aalborg";"east";12;18;30;57,047777;9,918611
1780;"Aalborg";"east";7;18;25;57,047777;9,918611
1781;"Aalborg";"east";8;21;29;57,047777;9,918611
1782;"Aalborg";"east";10;25;35;57,047777;9,918611
1783;"Aalborg";"east";8;36;44;57,047777;9,918611
1784;"Aalborg";"east";7;32;39;57,047777;9,918611
1785;"Aalborg";"east";3;20;23;57,047777;9,918611
1786;"Aalborg";"east";9;33;42;57,047777;9,918611
1787;"Aalborg";"east";11;25;36;57,047777;9,918611
1788;"Aalborg";"east";10;22;32;57,047777;9,918611
1789;"Aalborg";"east";7;11;18;57,047777;9,918611
1790;"Aalborg";"east";6;19;25;57,047777;9,918611
1791;"Aalborg";"east";10;26;36;57,047777;9,918611
1792;"Aalborg";"east";12;36;48;57,047777;9,918611
1793;"Aalborg";"east";10;35;45;57,047777;9,918611
1794;"Aalborg";"east";7;33;40;57,047777;9,918611
1795;"Aalborg";"east";7;23;30;57,047777;9,918611
1796;"Aalborg";"east";12;20;32;57,047777;9,918611
1797;"Aalborg";"east";12;28;40;57,047777;9,918611
1798;"Aalborg";"east";17;28;45;57,047777;9,918611
1799;"Aalborg";"east";24;31;55;57,047777;9,918611
1800;"Aalborg";"east";13;19;32;57,047777;9,918611
1801;"Aalborg";"east";15;26;41;57,047777;9,918611
1802;"Aalborg";"east";17;21;38;57,047777;9,918611
1803;"Aalborg";"east";20;32;52;57,047777;9,918611
1804;"Aalborg";"east";42;42;84;57,047777;9,918611
1805;"Aalborg";"east";80;42;122;57,047777;9,918611
1806;"Aalborg";"east";43;33;76;57,047777;9,918611
1807;"Aalborg";"east";8;3;11;57,047777;9,918611
1808;"Aalborg";"east";0;0;0;57,047777;9,918611
1809;"Aalborg";"east";11;0;11;57,047777;9,918611
1810;"Aalborg";"east";6;2;8;57,047777;9,918611
1811;"Aalborg";"east";6;4;10;57,047777;9,918611
1812;"Aalborg";"east";6;2;8;57,047777;9,918611
1813;"Aalborg";"east";4;5;9;57,047777;9,918611
1814;"Aalborg";"east";26;19;45;57,047777;9,918611
1815;"Aalborg";"east";33;17;50;57,047777;9,918611
1816;"Aalborg";"east";62;27;89;57,047777;9,918611
1817;"Aalborg";"east";99;47;146;57,047777;9,918611
1818;"Aalborg";"east";91;37;128;57,047777;9,918611
1819;"Aalborg";"east";77;47;124;57,047777;9,918611
1820;"Aalborg";"east";57;40;97;57,047777;9,918611
1821;"Aalborg";"east";47;35;82;57,047777;9,918611
1822;"Aalborg";"east";53;32;85;57,047777;9,918611
1823;"Aalborg";"east";38;30;68;57,047777;9,918611
1824;"Aalborg";"east";41;26;67;57,047777;9,918611
1825;"Aalborg";"east";45;32;77;57,047777;9,918611
1826;"Aalborg";"east";56;42;98;57,047777;9,918611
1827;"Aalborg";"east";104;57;161;57,047777;9,918611
1828;"Aalborg";"east";107;55;162;57,047777;9,918611
1829;"Aalborg";"east";65;35;100;57,047777;9,918611
1830;"Aalborg";"east";46;24;70;57,047777;9,918611
1831;"Aalborg";"east";19;14;33;57,047777;9,918611
1832;"Aalborg";"east";27;16;43;57,047777;9,918611
1833;"Aalborg";"east";16;14;30;57,047777;9,918611
1834;"Aalborg";"east";21;15;36;57,047777;9,918611
1835;"Aalborg";"east";20;13;33;57,047777;9,918611
1836;"Aalborg";"east";33;19;52;57,047777;9,918611
1837;"Aalborg";"east";24;18;42;57,047777;9,918611
1838;"Aalborg";"east";24;8;32;57,047777;9,918611
1839;"Aalborg";"east";22;10;32;57,047777;9,918611
1840;"Aalborg";"east";19;13;32;57,047777;9,918611
1841;"Aalborg";"east";23;19;42;57,047777;9,918611
1842;"Aalborg";"east";37;16;53;57,047777;9,918611
1843;"Aalborg";"east";51;23;74;57,047777;9,918611
1844;"Aalborg";"east";53;21;74;57,047777;9,918611
1845;"Aalborg";"east";43;16;59;57,047777;9,918611
1846;"Aalborg";"east";47;18;65;57,047777;9,918611
1847;"Aalborg";"east";69;28;97;57,047777;9,918611
1848;"Aalborg";"east";44;16;60;57,047777;9,918611
1849;"Aalborg";"east";49;20;69;57,047777;9,918611
1850;"Aalborg";"east";42;18;60;57,047777;9,918611
1851;"Aalborg";"east";59;18;77;57,047777;9,918611
1852;"Aalborg";"east";68;13;81;57,047777;9,918611
1853;"Aalborg";"east";56;10;66;57,047777;9,918611
1854;"Aalborg";"east";76;15;91;57,047777;9,918611
1855;"Aalborg";"east";77;26;103;57,047777;9,918611
1856;"Aalborg";"east";117;34;151;57,047777;9,918611
1857;"Aalborg";"east";4;7;11;57,047777;9,918611
1634;"Helsingør";"no";4;1;5;56,033333;12,616666
1635;"Helsingør";"no";8;3;11;56,033333;12,616666
1636;"Helsingør";"no";1;1;2;56,033333;12,616666
1637;"Helsingør";"no";0;0;0;56,033333;12,616666
1638;"Helsingør";"no";3;2;5;56,033333;12,616666
1639;"Helsingør";"no";3;2;5;56,033333;12,616666
1640;"Helsingør";"no";1;1;2;56,033333;12,616666
1641;"Helsingør";"no";2;1;3;56,033333;12,616666
1642;"Helsingør";"no";3;0;3;56,033333;12,616666
1643;"Helsingør";"no";1;0;1;56,033333;12,616666
1644;"Helsingør";"no";2;0;2;56,033333;12,616666
1645;"Helsingør";"no";2;0;2;56,033333;12,616666
1646;"Helsingør";"no";2;0;2;56,033333;12,616666
1647;"Helsingør";"no";0;0;0;56,033333;12,616666
1648;"Helsingør";"no";4;0;4;56,033333;12,616666
1649;"Helsingør";"no";2;0;2;56,033333;12,616666
1650;"Helsingør";"no";3;1;4;56,033333;12,616666
1651;"Helsingør";"no";3;1;4;56,033333;12,616666
1652;"Helsingør";"no";3;0;3;56,033333;12,616666
1653;"Helsingør";"no";0;1;1;56,033333;12,616666
1654;"Helsingør";"no";2;0;2;56,033333;12,616666
1655;"Helsingør";"no";7;1;8;56,033333;12,616666
1656;"Helsingør";"no";1;0;1;56,033333;12,616666
1657;"Helsingør";"no";2;2;4;56,033333;12,616666
1658;"Helsingør";"no";1;0;1;56,033333;12,616666
1659;"Helsingør";"no";0;0;0;56,033333;12,616666
1660;"Helsingør";"no";1;0;1;56,033333;12,616666
1661;"Helsingør";"no";2;0;2;56,033333;12,616666
1662;"Helsingør";"no";2;0;2;56,033333;12,616666
1663;"Helsingør";"no";3;0;3;56,033333;12,616666
1664;"Helsingør";"no";5;1;6;56,033333;12,616666
1665;"Helsingør";"no";5;1;6;56,033333;12,616666
1666;"Helsingør";"no";4;0;4;56,033333;12,616666
1667;"Helsingør";"no";1;3;4;56,033333;12,616666
1668;"Helsingør";"no";6;1;7;56,033333;12,616666
1669;"Helsingør";"no";8;2;10;56,033333;12,616666
1670;"Helsingør";"no";6;0;6;56,033333;12,616666
1671;"Helsingør";"no";9;1;10;56,033333;12,616666
1672;"Helsingør";"no";5;3;8;56,033333;12,616666
1673;"Helsingør";"no";2;0;2;56,033333;12,616666
1674;"Helsingør";"no";0;0;0;56,033333;12,616666
1675;"Helsingør";"no";3;2;5;56,033333;12,616666
1676;"Helsingør";"no";0;0;0;56,033333;12,616666
1677;"Helsingør";"no";0;1;1;56,033333;12,616666
1678;"Helsingør";"no";3;3;6;56,033333;12,616666
1679;"Helsingør";"no";1;2;3;56,033333;12,616666
1680;"Helsingør";"no";8;4;12;56,033333;12,616666
1681;"Helsingør";"no";6;8;14;56,033333;12,616666
1682;"Helsingør";"no";7;2;9;56,033333;12,616666
1683;"Helsingør";"no";7;6;13;56,033333;12,616666
1684;"Helsingør";"no";7;4;11;56,033333;12,616666
1685;"Helsingør";"no";10;6;16;56,033333;12,616666
1686;"Helsingør";"no";7;5;12;56,033333;12,616666
1687;"Helsingør";"no";2;1;3;56,033333;12,616666
1688;"Helsingør";"no";12;9;21;56,033333;12,616666
1689;"Helsingør";"no";4;1;5;56,033333;12,616666
1690;"Helsingør";"no";5;4;9;56,033333;12,616666
1691;"Helsingør";"no";6;4;10;56,033333;12,616666
1692;"Helsingør";"no";16;2;18;56,033333;12,616666
1693;"Helsingør";"no";10;3;13;56,033333;12,616666
1694;"Helsingør";"no";10;6;16;56,033333;12,616666
1695;"Helsingør";"no";21;19;40;56,033333;12,616666
1696;"Helsingør";"no";20;15;35;56,033333;12,616666
1697;"Helsingør";"no";14;12;26;56,033333;12,616666
1698;"Helsingør";"no";10;10;20;56,033333;12,616666
1699;"Helsingør";"no";10;4;14;56,033333;12,616666
1700;"Helsingør";"no";6;6;12;56,033333;12,616666
1701;"Helsingør";"no";7;2;9;56,033333;12,616666
1702;"Helsingør";"no";9;9;18;56,033333;12,616666
1703;"Helsingør";"no";11;9;20;56,033333;12,616666
1704;"Helsingør";"no";8;8;16;56,033333;12,616666
1705;"Helsingør";"no";12;7;19;56,033333;12,616666
1706;"Helsingør";"no";5;3;8;56,033333;12,616666
1707;"Helsingør";"no";7;4;11;56,033333;12,616666
1708;"Helsingør";"no";1;0;1;56,033333;12,616666
1709;"Helsingør";"no";10;10;20;56,033333;12,616666
1710;"Helsingør";"no";1;6;7;56,033333;12,616666
1711;"Helsingør";"no";1;2;3;56,033333;12,616666
1712;"Helsingør";"no";0;0;0;56,033333;12,616666
1713;"Helsingør";"no";0;0;0;56,033333;12,616666
1714;"Helsingør";"no";8;3;11;56,033333;12,616666
1715;"Helsingør";"no";3;2;5;56,033333;12,616666
1716;"Helsingør";"no";0;0;0;56,033333;12,616666
1717;"Helsingør";"no";0;1;1;56,033333;12,616666
1718;"Helsingør";"no";1;0;1;56,033333;12,616666
1719;"Helsingør";"no";2;2;4;56,033333;12,616666
1720;"Helsingør";"no";1;2;3;56,033333;12,616666
1721;"Helsingør";"no";2;1;3;56,033333;12,616666
1722;"Helsingør";"no";0;0;0;56,033333;12,616666
1723;"Helsingør";"no";2;1;3;56,033333;12,616666
1724;"Helsingør";"no";4;4;8;56,033333;12,616666
1725;"Helsingør";"no";7;10;17;56,033333;12,616666
1726;"Helsingør";"no";1;1;2;56,033333;12,616666
1727;"Helsingør";"no";3;3;6;56,033333;12,616666
1728;"Helsingør";"no";2;2;4;56,033333;12,616666
1729;"Helsingør";"no";1;1;2;56,033333;12,616666
1730;"Helsingør";"no";3;4;7;56,033333;12,616666
1731;"Helsingør";"no";1;1;2;56,033333;12,616666
1732;"Helsingør";"no";2;5;7;56,033333;12,616666
1733;"Helsingør";"no";1;11;12;56,033333;12,616666
1734;"Helsingør";"no";0;2;2;56,033333;12,616666
1735;"Helsingør";"no";3;8;11;56,033333;12,616666
1736;"Helsingør";"no";3;3;6;56,033333;12,616666
1737;"Helsingør";"no";4;8;12;56,033333;12,616666
1738;"Helsingør";"no";6;4;10;56,033333;12,616666
1739;"Helsingør";"no";8;12;20;56,033333;12,616666
1740;"Helsingør";"no";5;8;13;56,033333;12,616666
1741;"Helsingør";"no";10;10;20;56,033333;12,616666
1742;"Helsingør";"no";3;5;8;56,033333;12,616666
1743;"Helsingør";"no";9;9;18;56,033333;12,616666
1744;"Helsingør";"no";7;13;20;56,033333;12,616666
1745;"Helsingør";"no";7;14;21;56,033333;12,616666
1746;"Helsingør";"no";14;15;29;56,033333;12,616666
1747;"Helsingør";"no";9;11;20;56,033333;12,616666
1748;"Helsingør";"no";6;8;14;56,033333;12,616666
1749;"Helsingør";"no";9;9;18;56,033333;12,616666
1750;"Helsingør";"no";9;6;15;56,033333;12,616666
1751;"Helsingør";"no";14;6;20;56,033333;12,616666
1752;"Helsingør";"no";11;9;20;56,033333;12,616666
1753;"Helsingør";"no";4;7;11;56,033333;12,616666
1754;"Helsingør";"no";12;11;23;56,033333;12,616666
1755;"Helsingør";"no";11;12;23;56,033333;12,616666
1756;"Helsingør";"no";7;11;18;56,033333;12,616666
1757;"Helsingør";"no";4;8;12;56,033333;12,616666
1758;"Helsingør";"no";14;15;29;56,033333;12,616666
1759;"Helsingør";"no";20;24;44;56,033333;12,616666
1760;"Helsingør";"no";13;19;32;56,033333;12,616666
1761;"Helsingør";"no";8;14;22;56,033333;12,616666
1762;"Helsingør";"no";12;19;31;56,033333;12,616666
1763;"Helsingør";"no";12;20;32;56,033333;12,616666
1764;"Helsingør";"no";8;11;19;56,033333;12,616666
1765;"Helsingør";"no";10;28;38;56,033333;12,616666
1766;"Helsingør";"no";6;20;26;56,033333;12,616666
1767;"Helsingør";"no";9;12;21;56,033333;12,616666
1768;"Helsingør";"no";5;12;17;56,033333;12,616666
1769;"Helsingør";"no";8;21;29;56,033333;12,616666
1770;"Helsingør";"no";5;18;23;56,033333;12,616666
1771;"Helsingør";"no";12;20;32;56,033333;12,616666
1772;"Helsingør";"no";7;18;25;56,033333;12,616666
1773;"Helsingør";"no";4;23;27;56,033333;12,616666
1774;"Helsingør";"no";13;34;47;56,033333;12,616666
1775;"Helsingør";"no";10;23;33;56,033333;12,616666
1776;"Helsingør";"no";15;28;43;56,033333;12,616666
1777;"Helsingør";"no";13;25;38;56,033333;12,616666
1778;"Helsingør";"no";15;17;32;56,033333;12,616666
1779;"Helsingør";"no";25;21;46;56,033333;12,616666
1780;"Helsingør";"no";17;25;42;56,033333;12,616666
1781;"Helsingør";"no";18;28;46;56,033333;12,616666
1782;"Helsingør";"no";19;47;66;56,033333;12,616666
1783;"Helsingør";"no";20;67;87;56,033333;12,616666
1784;"Helsingør";"no";15;42;57;56,033333;12,616666
1785;"Helsingør";"no";11;39;50;56,033333;12,616666
1786;"Helsingør";"no";14;50;64;56,033333;12,616666
1787;"Helsingør";"no";10;37;47;56,033333;12,616666
1788;"Helsingør";"no";22;42;64;56,033333;12,616666
1789;"Helsingør";"no";24;30;54;56,033333;12,616666
1790;"Helsingør";"no";20;37;57;56,033333;12,616666
1791;"Helsingør";"no";18;27;45;56,033333;12,616666
1792;"Helsingør";"no";19;21;40;56,033333;12,616666
1793;"Helsingør";"no";13;33;46;56,033333;12,616666
1794;"Helsingør";"no";19;36;55;56,033333;12,616666
1795;"Helsingør";"no";21;28;49;56,033333;12,616666
1796;"Helsingør";"no";17;27;44;56,033333;12,616666
1797;"Helsingør";"no";16;23;39;56,033333;12,616666
1798;"Helsingør";"no";18;25;43;56,033333;12,616666
1799;"Helsingør";"no";20;29;49;56,033333;12,616666
1800;"Helsingør";"no";10;23;33;56,033333;12,616666
1801;"Helsingør";"no";13;27;40;56,033333;12,616666
1802;"Helsingør";"no";16;26;42;56,033333;12,616666
1803;"Helsingør";"no";12;28;40;56,033333;12,616666
1804;"Helsingør";"no";10;31;41;56,033333;12,616666
1805;"Helsingør";"no";15;54;69;56,033333;12,616666
1806;"Helsingør";"no";18;41;59;56,033333;12,616666
1807;"Helsingør";"no";6;31;37;56,033333;12,616666
1808;"Helsingør";"no";0;6;6;56,033333;12,616666
1809;"Helsingør";"no";2;0;2;56,033333;12,616666
1810;"Helsingør";"no";12;33;45;56,033333;12,616666
1811;"Helsingør";"no";27;27;54;56,033333;12,616666
1812;"Helsingør";"no";35;55;90;56,033333;12,616666
1813;"Helsingør";"no";9;16;25;56,033333;12,616666
1814;"Helsingør";"no";21;19;40;56,033333;12,616666
1815;"Helsingør";"no";21;32;53;56,033333;12,616666
1816;"Helsingør";"no";28;26;54;56,033333;12,616666
1817;"Helsingør";"no";39;37;76;56,033333;12,616666
1818;"Helsingør";"no";78;58;136;56,033333;12,616666
1819;"Helsingør";"no";90;42;132;56,033333;12,616666
1820;"Helsingør";"no";60;37;97;56,033333;12,616666
1821;"Helsingør";"no";57;46;103;56,033333;12,616666
1822;"Helsingør";"no";64;48;112;56,033333;12,616666
1823;"Helsingør";"no";81;33;114;56,033333;12,616666
1824;"Helsingør";"no";107;262;369;56,033333;12,616666
1825;"Helsingør";"no";92;333;425;56,033333;12,616666
1826;"Helsingør";"no";95;340;435;56,033333;12,616666
1827;"Helsingør";"no";45;367;412;56,033333;12,616666
1828;"Helsingør";"no";21;351;372;56,033333;12,616666
1829;"Helsingør";"no";28;356;384;56,033333;12,616666
1830;"Helsingør";"no";19;343;362;56,033333;12,616666
1831;"Helsingør";"no";7;268;275;56,033333;12,616666
1832;"Helsingør";"no";8;281;289;56,033333;12,616666
1833;"Helsingør";"no";13;301;314;56,033333;12,616666
1834;"Helsingør";"no";17;318;335;56,033333;12,616666
1835;"Helsingør";"no";16;299;315;56,033333;12,616666
1836;"Helsingør";"no";17;302;319;56,033333;12,616666
1837;"Helsingør";"no";80;298;378;56,033333;12,616666
1838;"Helsingør";"no";83;320;403;56,033333;12,616666
1839;"Helsingør";"no";32;345;377;56,033333;12,616666
1840;"Helsingør";"no";38;326;364;56,033333;12,616666
1841;"Helsingør";"no";37;339;376;56,033333;12,616666
1842;"Helsingør";"no";17;496;513;56,033333;12,616666
1843;"Helsingør";"no";67;484;551;56,033333;12,616666
1844;"Helsingør";"no";90;460;550;56,033333;12,616666
1845;"Helsingør";"no";162;437;599;56,033333;12,616666
1846;"Helsingør";"no";193;465;658;56,033333;12,616666
1847;"Helsingør";"no";186;422;608;56,033333;12,616666
1848;"Helsingør";"no";188;392;580;56,033333;12,616666
1849;"Helsingør";"no";236;343;579;56,033333;12,616666
1850;"Helsingør";"no";147;416;563;56,033333;12,616666
1851;"Helsingør";"no";166;411;577;56,033333;12,616666
1852;"Helsingør";"no";181;320;501;56,033333;12,616666
1853;"Helsingør";"no";168;336;504;56,033333;12,616666
1854;"Helsingør";"no";280;299;579;56,033333;12,616666
1855;"Helsingør";"no";304;253;557;56,033333;12,616666
1856;"Helsingør";"no";252;258;510;56,033333;12,616666
1857;"Helsingør";"no";42;21;63;56,033333;12,616666
1634;"København";"no";27;4;31;55,6775;12,570833
1635;"København";"no";125;6;131;55,6775;12,570833
1636;"København";"no";96;5;101;55,6775;12,570833
1637;"København";"no";92;4;96;55,6775;12,570833
1638;"København";"no";96;5;101;55,6775;12,570833
1639;"København";"no";100;5;105;55,6775;12,570833
1640;"København";"no";87;11;98;55,6775;12,570833
1641;"København";"no";100;18;118;55,6775;12,570833
1642;"København";"no";128;100;228;55,6775;12,570833
1643;"København";"no";112;124;236;55,6775;12,570833
1644;"København";"no";94;44;138;55,6775;12,570833
1645;"København";"no";59;11;70;55,6775;12,570833
1646;"København";"no";78;13;91;55,6775;12,570833
1647;"København";"no";73;11;84;55,6775;12,570833
1648;"København";"no";82;24;106;55,6775;12,570833
1649;"København";"no";60;23;83;55,6775;12,570833
1650;"København";"no";69;72;141;55,6775;12,570833
1651;"København";"no";69;70;139;55,6775;12,570833
1652;"København";"no";51;44;95;55,6775;12,570833
1653;"København";"no";71;32;103;55,6775;12,570833
1654;"København";"no";84;15;99;55,6775;12,570833
1655;"København";"no";55;19;74;55,6775;12,570833
1656;"København";"no";68;12;80;55,6775;12,570833
1657;"København";"no";73;16;89;55,6775;12,570833
1658;"København";"no";53;16;69;55,6775;12,570833
1659;"København";"no";2;0;2;55,6775;12,570833
1660;"København";"no";34;6;40;55,6775;12,570833
1661;"København";"no";59;19;78;55,6775;12,570833
1662;"København";"no";44;30;74;55,6775;12,570833
1663;"København";"no";74;21;95;55,6775;12,570833
1664;"København";"no";100;29;129;55,6775;12,570833
1665;"København";"no";72;60;132;55,6775;12,570833
1666;"København";"no";73;53;126;55,6775;12,570833
1667;"København";"no";49;100;149;55,6775;12,570833
1668;"København";"no";75;130;205;55,6775;12,570833
1669;"København";"no";62;160;222;55,6775;12,570833
1670;"København";"no";102;163;265;55,6775;12,570833
1671;"København";"no";108;182;290;55,6775;12,570833
1672;"København";"no";96;166;262;55,6775;12,570833
1673;"København";"no";105;146;251;55,6775;12,570833
1674;"København";"no";110;144;254;55,6775;12,570833
1675;"København";"no";103;165;268;55,6775;12,570833
1676;"København";"no";54;95;149;55,6775;12,570833
1677;"København";"no";60;121;181;55,6775;12,570833
1678;"København";"no";76;113;189;55,6775;12,570833
1679;"København";"no";122;132;254;55,6775;12,570833
1680;"København";"no";219;347;566;55,6775;12,570833
1681;"København";"no";208;337;545;55,6775;12,570833
1682;"København";"no";191;272;463;55,6775;12,570833
1683;"København";"no";224;322;546;55,6775;12,570833
1684;"København";"no";220;309;529;55,6775;12,570833
1685;"København";"no";274;333;607;55,6775;12,570833
1686;"København";"no";230;339;569;55,6775;12,570833
1687;"København";"no";271;381;652;55,6775;12,570833
1688;"København";"no";295;399;694;55,6775;12,570833
1689;"København";"no";235;316;551;55,6775;12,570833
1690;"København";"no";350;405;755;55,6775;12,570833
1691;"København";"no";325;363;688;55,6775;12,570833
1692;"København";"no";262;413;675;55,6775;12,570833
1693;"København";"no";274;423;697;55,6775;12,570833
1694;"København";"no";324;378;702;55,6775;12,570833
1695;"København";"no";312;453;765;55,6775;12,570833
1696;"København";"no";334;413;747;55,6775;12,570833
1697;"København";"no";247;312;559;55,6775;12,570833
1698;"København";"no";272;303;575;55,6775;12,570833
1699;"København";"no";258;315;573;55,6775;12,570833
1700;"København";"no";194;235;429;55,6775;12,570833
1701;"København";"no";304;360;664;55,6775;12,570833
1702;"København";"no";287;362;649;55,6775;12,570833
1703;"København";"no";257;284;541;55,6775;12,570833
1704;"København";"no";321;408;729;55,6775;12,570833
1705;"København";"no";334;399;733;55,6775;12,570833
1706;"København";"no";322;381;703;55,6775;12,570833
1707;"København";"no";299;379;678;55,6775;12,570833
1708;"København";"no";304;373;677;55,6775;12,570833
1709;"København";"no";254;331;585;55,6775;12,570833
1710;"København";"no";117;86;203;55,6775;12,570833
1711;"København";"no";83;138;221;55,6775;12,570833
1712;"København";"no";58;133;191;55,6775;12,570833
1713;"København";"no";58;93;151;55,6775;12,570833
1714;"København";"no";89;128;217;55,6775;12,570833
1715;"København";"no";72;86;158;55,6775;12,570833
1716;"København";"no";71;100;171;55,6775;12,570833
1717;"København";"no";109;140;249;55,6775;12,570833
1718;"København";"no";84;131;215;55,6775;12,570833
1719;"København";"no";69;101;170;55,6775;12,570833
1720;"København";"no";173;200;373;55,6775;12,570833
1721;"København";"no";135;171;306;55,6775;12,570833
1722;"København";"no";178;216;394;55,6775;12,570833
1723;"København";"no";152;208;360;55,6775;12,570833
1724;"København";"no";134;200;334;55,6775;12,570833
1725;"København";"no";133;216;349;55,6775;12,570833
1726;"København";"no";144;217;361;55,6775;12,570833
1727;"København";"no";182;229;411;55,6775;12,570833
1728;"København";"no";150;202;352;55,6775;12,570833
1729;"København";"no";208;327;535;55,6775;12,570833
1730;"København";"no";216;582;798;55,6775;12,570833
1731;"København";"no";197;407;604;55,6775;12,570833
1732;"København";"no";242;448;690;55,6775;12,570833
1733;"København";"no";234;439;673;55,6775;12,570833
1734;"København";"no";201;339;540;55,6775;12,570833
1735;"København";"no";186;324;510;55,6775;12,570833
1736;"København";"no";189;303;492;55,6775;12,570833
1737;"København";"no";203;288;491;55,6775;12,570833
1738;"København";"no";192;357;549;55,6775;12,570833
1739;"København";"no";177;318;495;55,6775;12,570833
1740;"København";"no";146;272;418;55,6775;12,570833
1741;"København";"no";187;278;465;55,6775;12,570833
1742;"København";"no";183;267;450;55,6775;12,570833
1743;"København";"no";205;265;470;55,6775;12,570833
1744;"København";"no";221;283;504;55,6775;12,570833
1745;"København";"no";236;282;518;55,6775;12,570833
1746;"København";"no";205;310;515;55,6775;12,570833
1747;"København";"no";188;231;419;55,6775;12,570833
1748;"København";"no";196;264;460;55,6775;12,570833
1749;"København";"no";201;262;463;55,6775;12,570833
1750;"København";"no";197;288;485;55,6775;12,570833
1751;"København";"no";232;380;612;55,6775;12,570833
1752;"København";"no";245;342;587;55,6775;12,570833
1753;"København";"no";234;287;521;55,6775;12,570833
1754;"København";"no";215;339;554;55,6775;12,570833
1755;"København";"no";248;324;572;55,6775;12,570833
1756;"København";"no";253;350;603;55,6775;12,570833
1757;"København";"no";256;324;580;55,6775;12,570833
1758;"København";"no";268;335;603;55,6775;12,570833
1759;"København";"no";258;344;602;55,6775;12,570833
1760;"København";"no";300;352;652;55,6775;12,570833
1761;"København";"no";276;377;653;55,6775;12,570833
1762;"København";"no";321;405;726;55,6775;12,570833
1763;"København";"no";318;470;788;55,6775;12,570833
1764;"København";"no";261;371;632;55,6775;12,570833
1765;"København";"no";260;480;740;55,6775;12,570833
1766;"København";"no";279;461;740;55,6775;12,570833
1767;"København";"no";278;437;715;55,6775;12,570833
1768;"København";"no";233;396;629;55,6775;12,570833
1769;"København";"no";250;394;644;55,6775;12,570833
1770;"København";"no";249;400;649;55,6775;12,570833
1771;"København";"no";254;387;641;55,6775;12,570833
1772;"København";"no";301;416;717;55,6775;12,570833
1773;"København";"no";265;440;705;55,6775;12,570833
1774;"København";"no";259;433;692;55,6775;12,570833
1775;"København";"no";359;497;856;55,6775;12,570833
1776;"København";"no";343;479;822;55,6775;12,570833
1777;"København";"no";354;511;865;55,6775;12,570833
1778;"København";"no";397;525;922;55,6775;12,570833
1779;"København";"no";436;600;1036;55,6775;12,570833
1780;"København";"no";413;645;1058;55,6775;12,570833
1781;"København";"no";550;811;1361;55,6775;12,570833
1782;"København";"no";556;852;1408;55,6775;12,570833
1783;"København";"no";443;774;1217;55,6775;12,570833
1784;"København";"no";439;648;1087;55,6775;12,570833
1785;"København";"no";404;639;1043;55,6775;12,570833
1786;"København";"no";343;586;929;55,6775;12,570833
1787;"København";"no";415;580;995;55,6775;12,570833
1788;"København";"no";394;599;993;55,6775;12,570833
1789;"København";"no";415;599;1014;55,6775;12,570833
1790;"København";"no";396;581;977;55,6775;12,570833
1791;"København";"no";427;596;1023;55,6775;12,570833
1792;"København";"no";361;552;913;55,6775;12,570833
1793;"København";"no";431;567;998;55,6775;12,570833
1794;"København";"no";543;734;1277;55,6775;12,570833
1795;"København";"no";665;819;1484;55,6775;12,570833
1796;"København";"no";601;886;1487;55,6775;12,570833
1797;"København";"no";493;820;1313;55,6775;12,570833
1798;"København";"no";525;823;1348;55,6775;12,570833
1799;"København";"no";507;754;1261;55,6775;12,570833
1800;"København";"no";541;903;1444;55,6775;12,570833
1801;"København";"no";524;812;1336;55,6775;12,570833
1802;"København";"no";559;828;1387;55,6775;12,570833
1803;"København";"no";548;823;1371;55,6775;12,570833
1804;"København";"no";590;907;1497;55,6775;12,570833
1805;"København";"no";606;1032;1638;55,6775;12,570833
1806;"København";"no";619;852;1471;55,6775;12,570833
1807;"København";"no";106;195;301;55,6775;12,570833
1808;"København";"no";25;50;75;55,6775;12,570833
1809;"København";"no";111;112;223;55,6775;12,570833
1810;"København";"no";319;530;849;55,6775;12,570833
1811;"København";"no";497;638;1135;55,6775;12,570833
1812;"København";"no";671;774;1445;55,6775;12,570833
1813;"København";"no";204;189;393;55,6775;12,570833
1814;"København";"no";335;359;694;55,6775;12,570833
1815;"København";"no";529;665;1194;55,6775;12,570833
1816;"København";"no";647;852;1499;55,6775;12,570833
1817;"København";"no";518;745;1263;55,6775;12,570833
1818;"København";"no";647;715;1362;55,6775;12,570833
1819;"København";"no";513;701;1214;55,6775;12,570833
1820;"København";"no";476;645;1121;55,6775;12,570833
1821;"København";"no";586;637;1223;55,6775;12,570833
1822;"København";"no";464;550;1014;55,6775;12,570833
1823;"København";"no";489;581;1070;55,6775;12,570833
1824;"København";"no";480;642;1122;55,6775;12,570833
1825;"København";"no";530;649;1179;55,6775;12,570833
1826;"København";"no";504;712;1216;55,6775;12,570833
1827;"København";"no";568;769;1337;55,6775;12,570833
1828;"København";"no";500;759;1259;55,6775;12,570833
1829;"København";"no";465;644;1109;55,6775;12,570833
1830;"København";"no";520;688;1208;55,6775;12,570833
1831;"København";"no";561;666;1227;55,6775;12,570833
1832;"København";"no";533;653;1186;55,6775;12,570833
1833;"København";"no";510;650;1160;55,6775;12,570833
1834;"København";"no";490;605;1095;55,6775;12,570833
1835;"København";"no";464;620;1084;55,6775;12,570833
1836;"København";"no";493;589;1082;55,6775;12,570833
1837;"København";"no";499;637;1136;55,6775;12,570833
1838;"København";"no";471;616;1087;55,6775;12,570833
1839;"København";"no";435;632;1067;55,6775;12,570833
1840;"København";"no";443;689;1132;55,6775;12,570833
1841;"København";"no";468;700;1168;55,6775;12,570833
1842;"København";"no";523;778;1301;55,6775;12,570833
1843;"København";"no";553;868;1421;55,6775;12,570833
1844;"København";"no";578;996;1574;55,6775;12,570833
1845;"København";"no";613;1083;1696;55,6775;12,570833
1846;"København";"no";650;1151;1801;55,6775;12,570833
1847;"København";"no";704;1170;1874;55,6775;12,570833
1848;"København";"no";649;1195;1844;55,6775;12,570833
1849;"København";"no";795;1270;2065;55,6775;12,570833
1850;"København";"no";656;1397;2053;55,6775;12,570833
1851;"København";"no";734;1347;2081;55,6775;12,570833
1852;"København";"no";740;1398;2138;55,6775;12,570833
1853;"København";"no";695;1393;2088;55,6775;12,570833
1854;"København";"no";920;1667;2587;55,6775;12,570833
1855;"København";"no";868;1611;2479;55,6775;12,570833
1856;"København";"no";887;1758;2645;55,6775;12,570833
1857;"København";"no";108;183;291;55,6775;12,570833
1634;"Køge";"no";14;0;14;55,457777;12,181944
1635;"Køge";"no";43;7;50;55,457777;12,181944
1636;"Køge";"no";24;0;24;55,457777;12,181944
1637;"Køge";"no";32;0;32;55,457777;12,181944
1638;"Køge";"no";26;0;26;55,457777;12,181944
1639;"Køge";"no";24;0;24;55,457777;12,181944
1640;"Køge";"no";25;1;26;55,457777;12,181944
1641;"Køge";"no";29;3;32;55,457777;12,181944
1642;"Køge";"no";39;6;45;55,457777;12,181944
1643;"Køge";"no";36;12;48;55,457777;12,181944
1644;"Køge";"no";13;4;17;55,457777;12,181944
1645;"Køge";"no";14;0;14;55,457777;12,181944
1646;"Køge";"no";19;1;20;55,457777;12,181944
1647;"Køge";"no";19;2;21;55,457777;12,181944
1648;"Køge";"no";23;4;27;55,457777;12,181944
1649;"Køge";"no";22;2;24;55,457777;12,181944
1650;"Køge";"no";11;2;13;55,457777;12,181944
1651;"Køge";"no";14;3;17;55,457777;12,181944
1652;"Køge";"no";6;1;7;55,457777;12,181944
1653;"Køge";"no";8;4;12;55,457777;12,181944
1654;"Køge";"no";12;0;12;55,457777;12,181944
1655;"Køge";"no";16;2;18;55,457777;12,181944
1656;"Køge";"no";11;1;12;55,457777;12,181944
1657;"Køge";"no";10;1;11;55,457777;12,181944
1658;"Køge";"no";4;0;4;55,457777;12,181944
1659;"Køge";"no";0;0;0;55,457777;12,181944
1660;"Køge";"no";0;0;0;55,457777;12,181944
1661;"Køge";"no";1;0;1;55,457777;12,181944
1662;"Køge";"no";3;0;3;55,457777;12,181944
1663;"Køge";"no";12;1;13;55,457777;12,181944
1664;"Køge";"no";27;8;35;55,457777;12,181944
1665;"Køge";"no";21;4;25;55,457777;12,181944
1666;"Køge";"no";10;3;13;55,457777;12,181944
1667;"Køge";"no";9;7;16;55,457777;12,181944
1668;"Køge";"no";24;12;36;55,457777;12,181944
1669;"Køge";"no";36;17;53;55,457777;12,181944
1670;"Køge";"no";35;19;54;55,457777;12,181944
1671;"Køge";"no";34;7;41;55,457777;12,181944
1672;"Køge";"no";31;11;42;55,457777;12,181944
1673;"Køge";"no";37;16;53;55,457777;12,181944
1674;"Køge";"no";27;20;47;55,457777;12,181944
1675;"Køge";"no";22;7;29;55,457777;12,181944
1676;"Køge";"no";12;3;15;55,457777;12,181944
1677;"Køge";"no";8;3;11;55,457777;12,181944
1678;"Køge";"no";5;3;8;55,457777;12,181944
1679;"Køge";"no";5;0;5;55,457777;12,181944
1680;"Køge";"no";23;17;40;55,457777;12,181944
1681;"Køge";"no";20;8;28;55,457777;12,181944
1682;"Køge";"no";23;15;38;55,457777;12,181944
1683;"Køge";"no";15;8;23;55,457777;12,181944
1684;"Køge";"no";14;13;27;55,457777;12,181944
1685;"Køge";"no";9;6;15;55,457777;12,181944
1686;"Køge";"no";42;26;68;55,457777;12,181944
1687;"Køge";"no";37;22;59;55,457777;12,181944
1688;"Køge";"no";20;11;31;55,457777;12,181944
1689;"Køge";"no";17;10;27;55,457777;12,181944
1690;"Køge";"no";24;24;48;55,457777;12,181944
1691;"Køge";"no";22;21;43;55,457777;12,181944
1692;"Køge";"no";33;18;51;55,457777;12,181944
1693;"Køge";"no";42;29;71;55,457777;12,181944
1694;"Køge";"no";39;40;79;55,457777;12,181944
1695;"Køge";"no";34;36;70;55,457777;12,181944
1696;"Køge";"no";42;28;70;55,457777;12,181944
1697;"Køge";"no";19;27;46;55,457777;12,181944
1698;"Køge";"no";20;22;42;55,457777;12,181944
1699;"Køge";"no";14;15;29;55,457777;12,181944
1700;"Køge";"no";8;4;12;55,457777;12,181944
1701;"Køge";"no";21;15;36;55,457777;12,181944
1702;"Køge";"no";28;24;52;55,457777;12,181944
1703;"Køge";"no";22;19;41;55,457777;12,181944
1704;"Køge";"no";21;15;36;55,457777;12,181944
1705;"Køge";"no";26;22;48;55,457777;12,181944
1706;"Køge";"no";24;16;40;55,457777;12,181944
1707;"Køge";"no";27;20;47;55,457777;12,181944
1708;"Køge";"no";30;24;54;55,457777;12,181944
1709;"Køge";"no";11;14;25;55,457777;12,181944
1710;"Køge";"no";3;0;3;55,457777;12,181944
1711;"Køge";"no";0;0;0;55,457777;12,181944
1712;"Køge";"no";0;0;0;55,457777;12,181944
1713;"Køge";"no";2;0;2;55,457777;12,181944
1714;"Køge";"no";0;0;0;55,457777;12,181944
1715;"Køge";"no";1;0;1;55,457777;12,181944
1716;"Køge";"no";0;0;0;55,457777;12,181944
1717;"Køge";"no";3;0;3;55,457777;12,181944
1718;"Køge";"no";2;0;2;55,457777;12,181944
1719;"Køge";"no";0;0;0;55,457777;12,181944
1720;"Køge";"no";7;4;11;55,457777;12,181944
1721;"Køge";"no";9;7;16;55,457777;12,181944
1722;"Køge";"no";13;15;28;55,457777;12,181944
1723;"Køge";"no";17;11;28;55,457777;12,181944
1724;"Køge";"no";10;5;15;55,457777;12,181944
1725;"Køge";"no";11;5;16;55,457777;12,181944
1726;"Køge";"no";11;7;18;55,457777;12,181944
1727;"Køge";"no";3;1;4;55,457777;12,181944
1728;"Køge";"no";5;4;9;55,457777;12,181944
1729;"Køge";"no";5;2;7;55,457777;12,181944
1730;"Køge";"no";8;3;11;55,457777;12,181944
1731;"Køge";"no";5;3;8;55,457777;12,181944
1732;"Køge";"no";10;8;18;55,457777;12,181944
1733;"Køge";"no";10;2;12;55,457777;12,181944
1734;"Køge";"no";15;6;21;55,457777;12,181944
1735;"Køge";"no";12;9;21;55,457777;12,181944
1736;"Køge";"no";8;8;16;55,457777;12,181944
1737;"Køge";"no";16;7;23;55,457777;12,181944
1738;"Køge";"no";24;12;36;55,457777;12,181944
1739;"Køge";"no";13;10;23;55,457777;12,181944
1740;"Køge";"no";9;9;18;55,457777;12,181944
1741;"Køge";"no";8;10;18;55,457777;12,181944
1742;"Køge";"no";10;11;21;55,457777;12,181944
1743;"Køge";"no";14;15;29;55,457777;12,181944
1744;"Køge";"no";13;15;28;55,457777;12,181944
1745;"Køge";"no";13;5;18;55,457777;12,181944
1746;"Køge";"no";10;11;21;55,457777;12,181944
1747;"Køge";"no";10;8;18;55,457777;12,181944
1748;"Køge";"no";11;9;20;55,457777;12,181944
1749;"Køge";"no";12;19;31;55,457777;12,181944
1750;"Køge";"no";22;16;38;55,457777;12,181944
1751;"Køge";"no";25;14;39;55,457777;12,181944
1752;"Køge";"no";28;16;44;55,457777;12,181944
1753;"Køge";"no";25;17;42;55,457777;12,181944
1754;"Køge";"no";28;13;41;55,457777;12,181944
1755;"Køge";"no";24;13;37;55,457777;12,181944
1756;"Køge";"no";15;15;30;55,457777;12,181944
1757;"Køge";"no";17;13;30;55,457777;12,181944
1758;"Køge";"no";11;10;21;55,457777;12,181944
1759;"Køge";"no";12;8;20;55,457777;12,181944
1760;"Køge";"no";10;6;16;55,457777;12,181944
1761;"Køge";"no";20;8;28;55,457777;12,181944
1762;"Køge";"no";22;12;34;55,457777;12,181944
1763;"Køge";"no";21;10;31;55,457777;12,181944
1764;"Køge";"no";17;14;31;55,457777;12,181944
1765;"Køge";"no";22;15;37;55,457777;12,181944
1766;"Køge";"no";17;16;33;55,457777;12,181944
1767;"Køge";"no";18;15;33;55,457777;12,181944
1768;"Køge";"no";14;10;24;55,457777;12,181944
1769;"Køge";"no";22;14;36;55,457777;12,181944
1770;"Køge";"no";24;15;39;55,457777;12,181944
1771;"Køge";"no";17;13;30;55,457777;12,181944
1772;"Køge";"no";15;7;22;55,457777;12,181944
1773;"Køge";"no";16;10;26;55,457777;12,181944
1774;"Køge";"no";14;12;26;55,457777;12,181944
1775;"Køge";"no";22;12;34;55,457777;12,181944
1776;"Køge";"no";27;8;35;55,457777;12,181944
1777;"Køge";"no";24;7;31;55,457777;12,181944
1778;"Køge";"no";32;4;36;55,457777;12,181944
1779;"Køge";"no";23;8;31;55,457777;12,181944
1780;"Køge";"no";25;9;34;55,457777;12,181944
1781;"Køge";"no";24;8;32;55,457777;12,181944
1782;"Køge";"no";18;12;30;55,457777;12,181944
1783;"Køge";"no";27;15;42;55,457777;12,181944
1784;"Køge";"no";10;8;18;55,457777;12,181944
1785;"Køge";"no";17;11;28;55,457777;12,181944
1786;"Køge";"no";13;12;25;55,457777;12,181944
1787;"Køge";"no";9;6;15;55,457777;12,181944
1788;"Køge";"no";30;13;43;55,457777;12,181944
1789;"Køge";"no";18;14;32;55,457777;12,181944
1790;"Køge";"no";17;15;32;55,457777;12,181944
1791;"Køge";"no";18;8;26;55,457777;12,181944
1792;"Køge";"no";24;11;35;55,457777;12,181944
1793;"Køge";"no";24;12;36;55,457777;12,181944
1794;"Køge";"no";29;12;41;55,457777;12,181944
1795;"Køge";"no";46;14;60;55,457777;12,181944
1796;"Køge";"no";38;17;55;55,457777;12,181944
1797;"Køge";"no";38;35;73;55,457777;12,181944
1798;"Køge";"no";33;31;64;55,457777;12,181944
1799;"Køge";"no";25;28;53;55,457777;12,181944
1800;"Køge";"no";40;37;77;55,457777;12,181944
1801;"Køge";"no";32;33;65;55,457777;12,181944
1802;"Køge";"no";32;31;63;55,457777;12,181944
1803;"Køge";"no";45;40;85;55,457777;12,181944
1804;"Køge";"no";50;42;92;55,457777;12,181944
1805;"Køge";"no";39;41;80;55,457777;12,181944
1806;"Køge";"no";14;20;34;55,457777;12,181944
1807;"Køge";"no";1;1;2;55,457777;12,181944
1808;"Køge";"no";0;0;0;55,457777;12,181944
1809;"Køge";"no";0;1;1;55,457777;12,181944
1810;"Køge";"no";0;0;0;55,457777;12,181944
1811;"Køge";"no";2;2;4;55,457777;12,181944
1812;"Køge";"no";1;2;3;55,457777;12,181944
1813;"Køge";"no";0;0;0;55,457777;12,181944
1814;"Køge";"no";1;1;2;55,457777;12,181944
1815;"Køge";"no";6;6;12;55,457777;12,181944
1816;"Køge";"no";13;9;22;55,457777;12,181944
1817;"Køge";"no";13;11;24;55,457777;12,181944
1818;"Køge";"no";7;5;12;55,457777;12,181944
1819;"Køge";"no";10;5;15;55,457777;12,181944
1820;"Køge";"no";8;7;15;55,457777;12,181944
1821;"Køge";"no";8;5;13;55,457777;12,181944
1822;"Køge";"no";7;11;18;55,457777;12,181944
1823;"Køge";"no";5;8;13;55,457777;12,181944
1824;"Køge";"no";12;8;20;55,457777;12,181944
1825;"Køge";"no";9;13;22;55,457777;12,181944
1826;"Køge";"no";6;11;17;55,457777;12,181944
1827;"Køge";"no";6;11;17;55,457777;12,181944
1828;"Køge";"no";16;20;36;55,457777;12,181944
1829;"Køge";"no";16;21;37;55,457777;12,181944
1830;"Køge";"no";10;20;30;55,457777;12,181944
1831;"Køge";"no";3;9;12;55,457777;12,181944
1832;"Køge";"no";9;12;21;55,457777;12,181944
1833;"Køge";"no";18;13;31;55,457777;12,181944
1834;"Køge";"no";15;13;28;55,457777;12,181944
1835;"Køge";"no";21;16;37;55,457777;12,181944
1836;"Køge";"no";17;15;32;55,457777;12,181944
1837;"Køge";"no";19;17;36;55,457777;12,181944
1838;"Køge";"no";19;16;35;55,457777;12,181944
1839;"Køge";"no";41;19;60;55,457777;12,181944
1840;"Køge";"no";43;16;59;55,457777;12,181944
1841;"Køge";"no";43;21;64;55,457777;12,181944
1842;"Køge";"no";22;16;38;55,457777;12,181944
1843;"Køge";"no";36;15;51;55,457777;12,181944
1844;"Køge";"no";60;29;89;55,457777;12,181944
1845;"Køge";"no";64;34;98;55,457777;12,181944
1846;"Køge";"no";74;36;110;55,457777;12,181944
1847;"Køge";"no";61;30;91;55,457777;12,181944
1848;"Køge";"no";77;32;109;55,457777;12,181944
1849;"Køge";"no";84;24;108;55,457777;12,181944
1850;"Køge";"no";87;37;124;55,457777;12,181944
1851;"Køge";"no";84;34;118;55,457777;12,181944
1852;"Køge";"no";114;50;164;55,457777;12,181944
1853;"Køge";"no";89;45;134;55,457777;12,181944
1854;"Køge";"no";79;45;124;55,457777;12,181944
1855;"Køge";"no";114;75;189;55,457777;12,181944
1856;"Køge";"no";50;42;92;55,457777;12,181944
1857;"Køge";"no";10;1;11;55,457777;12,181944
1634;"Maribo";"no";1;0;1;54,776388;11,5
1635;"Maribo";"no";4;0;4;54,776388;11,5
1636;"Maribo";"no";0;0;0;54,776388;11,5
1637;"Maribo";"no";2;0;2;54,776388;11,5
1638;"Maribo";"no";0;0;0;54,776388;11,5
1639;"Maribo";"no";1;0;1;54,776388;11,5
1640;"Maribo";"no";0;0;0;54,776388;11,5
1641;"Maribo";"no";0;0;0;54,776388;11,5
1642;"Maribo";"no";0;0;0;54,776388;11,5
1643;"Maribo";"no";0;0;0;54,776388;11,5
1644;"Maribo";"no";0;0;0;54,776388;11,5
1645;"Maribo";"no";0;0;0;54,776388;11,5
1646;"Maribo";"no";0;0;0;54,776388;11,5
1647;"Maribo";"no";0;0;0;54,776388;11,5
1648;"Maribo";"no";0;0;0;54,776388;11,5
1649;"Maribo";"no";0;0;0;54,776388;11,5
1650;"Maribo";"no";0;0;0;54,776388;11,5
1651;"Maribo";"no";0;0;0;54,776388;11,5
1652;"Maribo";"no";0;0;0;54,776388;11,5
1653;"Maribo";"no";0;0;0;54,776388;11,5
1654;"Maribo";"no";0;0;0;54,776388;11,5
1655;"Maribo";"no";0;0;0;54,776388;11,5
1656;"Maribo";"no";0;0;0;54,776388;11,5
1657;"Maribo";"no";0;0;0;54,776388;11,5
1658;"Maribo";"no";0;0;0;54,776388;11,5
1659;"Maribo";"no";0;0;0;54,776388;11,5
1660;"Maribo";"no";0;0;0;54,776388;11,5
1661;"Maribo";"no";0;0;0;54,776388;11,5
1662;"Maribo";"no";0;0;0;54,776388;11,5
1663;"Maribo";"no";0;0;0;54,776388;11,5
1664;"Maribo";"no";0;0;0;54,776388;11,5
1665;"Maribo";"no";0;0;0;54,776388;11,5
1666;"Maribo";"no";0;0;0;54,776388;11,5
1667;"Maribo";"no";0;0;0;54,776388;11,5
1668;"Maribo";"no";0;0;0;54,776388;11,5
1669;"Maribo";"no";0;0;0;54,776388;11,5
1670;"Maribo";"no";0;0;0;54,776388;11,5
1671;"Maribo";"no";0;0;0;54,776388;11,5
1672;"Maribo";"no";0;0;0;54,776388;11,5
1673;"Maribo";"no";0;0;0;54,776388;11,5
1674;"Maribo";"no";0;0;0;54,776388;11,5
1675;"Maribo";"no";0;0;0;54,776388;11,5
1676;"Maribo";"no";0;0;0;54,776388;11,5
1677;"Maribo";"no";0;0;0;54,776388;11,5
1678;"Maribo";"no";0;0;0;54,776388;11,5
1679;"Maribo";"no";0;0;0;54,776388;11,5
1680;"Maribo";"no";0;0;0;54,776388;11,5
1681;"Maribo";"no";0;0;0;54,776388;11,5
1682;"Maribo";"no";0;0;0;54,776388;11,5
1683;"Maribo";"no";0;0;0;54,776388;11,5
1684;"Maribo";"no";0;0;0;54,776388;11,5
1685;"Maribo";"no";0;0;0;54,776388;11,5
1686;"Maribo";"no";0;0;0;54,776388;11,5
1687;"Maribo";"no";0;0;0;54,776388;11,5
1688;"Maribo";"no";0;0;0;54,776388;11,5
1689;"Maribo";"no";0;0;0;54,776388;11,5
1690;"Maribo";"no";0;0;0;54,776388;11,5
1691;"Maribo";"no";0;0;0;54,776388;11,5
1692;"Maribo";"no";0;0;0;54,776388;11,5
1693;"Maribo";"no";0;0;0;54,776388;11,5
1694;"Maribo";"no";0;0;0;54,776388;11,5
1695;"Maribo";"no";0;0;0;54,776388;11,5
1696;"Maribo";"no";0;0;0;54,776388;11,5
1697;"Maribo";"no";0;0;0;54,776388;11,5
1698;"Maribo";"no";0;0;0;54,776388;11,5
1699;"Maribo";"no";0;0;0;54,776388;11,5
1700;"Maribo";"no";0;0;0;54,776388;11,5
1701;"Maribo";"no";0;0;0;54,776388;11,5
1702;"Maribo";"no";0;0;0;54,776388;11,5
1703;"Maribo";"no";0;0;0;54,776388;11,5
1704;"Maribo";"no";0;0;0;54,776388;11,5
1705;"Maribo";"no";0;0;0;54,776388;11,5
1706;"Maribo";"no";0;0;0;54,776388;11,5
1707;"Maribo";"no";0;0;0;54,776388;11,5
1708;"Maribo";"no";0;0;0;54,776388;11,5
1709;"Maribo";"no";0;0;0;54,776388;11,5
1710;"Maribo";"no";0;0;0;54,776388;11,5
1711;"Maribo";"no";0;0;0;54,776388;11,5
1712;"Maribo";"no";0;0;0;54,776388;11,5
1713;"Maribo";"no";0;0;0;54,776388;11,5
1714;"Maribo";"no";0;0;0;54,776388;11,5
1715;"Maribo";"no";0;0;0;54,776388;11,5
1716;"Maribo";"no";0;0;0;54,776388;11,5
1717;"Maribo";"no";0;0;0;54,776388;11,5
1718;"Maribo";"no";0;0;0;54,776388;11,5
1719;"Maribo";"no";0;0;0;54,776388;11,5
1720;"Maribo";"no";0;0;0;54,776388;11,5
1721;"Maribo";"no";0;0;0;54,776388;11,5
1722;"Maribo";"no";0;0;0;54,776388;11,5
1723;"Maribo";"no";0;0;0;54,776388;11,5
1724;"Maribo";"no";0;0;0;54,776388;11,5
1725;"Maribo";"no";0;0;0;54,776388;11,5
1726;"Maribo";"no";0;0;0;54,776388;11,5
1727;"Maribo";"no";0;0;0;54,776388;11,5
1728;"Maribo";"no";0;0;0;54,776388;11,5
1729;"Maribo";"no";0;0;0;54,776388;11,5
1730;"Maribo";"no";0;0;0;54,776388;11,5
1731;"Maribo";"no";0;0;0;54,776388;11,5
1732;"Maribo";"no";0;0;0;54,776388;11,5
1733;"Maribo";"no";0;0;0;54,776388;11,5
1734;"Maribo";"no";0;0;0;54,776388;11,5
1735;"Maribo";"no";0;0;0;54,776388;11,5
1736;"Maribo";"no";0;0;0;54,776388;11,5
1737;"Maribo";"no";0;0;0;54,776388;11,5
1738;"Maribo";"no";0;0;0;54,776388;11,5
1739;"Maribo";"no";0;0;0;54,776388;11,5
1740;"Maribo";"no";0;0;0;54,776388;11,5
1741;"Maribo";"no";0;0;0;54,776388;11,5
1742;"Maribo";"no";0;0;0;54,776388;11,5
1743;"Maribo";"no";0;0;0;54,776388;11,5
1744;"Maribo";"no";0;0;0;54,776388;11,5
1745;"Maribo";"no";0;0;0;54,776388;11,5
1746;"Maribo";"no";0;0;0;54,776388;11,5
1747;"Maribo";"no";0;0;0;54,776388;11,5
1748;"Maribo";"no";0;0;0;54,776388;11,5
1749;"Maribo";"no";0;0;0;54,776388;11,5
1750;"Maribo";"no";0;0;0;54,776388;11,5
1751;"Maribo";"no";0;0;0;54,776388;11,5
1752;"Maribo";"no";0;0;0;54,776388;11,5
1753;"Maribo";"no";0;0;0;54,776388;11,5
1754;"Maribo";"no";0;0;0;54,776388;11,5
1755;"Maribo";"no";0;0;0;54,776388;11,5
1756;"Maribo";"no";0;0;0;54,776388;11,5
1757;"Maribo";"no";0;0;0;54,776388;11,5
1758;"Maribo";"no";0;0;0;54,776388;11,5
1759;"Maribo";"no";0;0;0;54,776388;11,5
1760;"Maribo";"no";0;0;0;54,776388;11,5
1761;"Maribo";"no";0;0;0;54,776388;11,5
1762;"Maribo";"no";0;0;0;54,776388;11,5
1763;"Maribo";"no";0;0;0;54,776388;11,5
1764;"Maribo";"no";0;0;0;54,776388;11,5
1765;"Maribo";"no";0;0;0;54,776388;11,5
1766;"Maribo";"no";0;0;0;54,776388;11,5
1767;"Maribo";"no";0;0;0;54,776388;11,5
1768;"Maribo";"no";0;0;0;54,776388;11,5
1769;"Maribo";"no";0;0;0;54,776388;11,5
1770;"Maribo";"no";0;0;0;54,776388;11,5
1771;"Maribo";"no";0;0;0;54,776388;11,5
1772;"Maribo";"no";0;0;0;54,776388;11,5
1773;"Maribo";"no";0;0;0;54,776388;11,5
1774;"Maribo";"no";0;0;0;54,776388;11,5
1775;"Maribo";"no";0;0;0;54,776388;11,5
1776;"Maribo";"no";0;0;0;54,776388;11,5
1777;"Maribo";"no";0;0;0;54,776388;11,5
1778;"Maribo";"no";0;0;0;54,776388;11,5
1779;"Maribo";"no";0;0;0;54,776388;11,5
1780;"Maribo";"no";0;0;0;54,776388;11,5
1781;"Maribo";"no";0;0;0;54,776388;11,5
1782;"Maribo";"no";0;0;0;54,776388;11,5
1783;"Maribo";"no";0;0;0;54,776388;11,5
1784;"Maribo";"no";0;0;0;54,776388;11,5
1785;"Maribo";"no";0;0;0;54,776388;11,5
1786;"Maribo";"no";0;0;0;54,776388;11,5
1787;"Maribo";"no";0;0;0;54,776388;11,5
1788;"Maribo";"no";0;0;0;54,776388;11,5
1789;"Maribo";"no";0;0;0;54,776388;11,5
1790;"Maribo";"no";0;0;0;54,776388;11,5
1791;"Maribo";"no";0;0;0;54,776388;11,5
1792;"Maribo";"no";0;0;0;54,776388;11,5
1793;"Maribo";"no";0;0;0;54,776388;11,5
1794;"Maribo";"no";0;0;0;54,776388;11,5
1795;"Maribo";"no";0;0;0;54,776388;11,5
1796;"Maribo";"no";0;0;0;54,776388;11,5
1797;"Maribo";"no";0;0;0;54,776388;11,5
1798;"Maribo";"no";0;0;0;54,776388;11,5
1799;"Maribo";"no";0;0;0;54,776388;11,5
1800;"Maribo";"no";0;0;0;54,776388;11,5
1801;"Maribo";"no";0;0;0;54,776388;11,5
1802;"Maribo";"no";0;0;0;54,776388;11,5
1803;"Maribo";"no";0;0;0;54,776388;11,5
1804;"Maribo";"no";0;0;0;54,776388;11,5
1805;"Maribo";"no";0;0;0;54,776388;11,5
1806;"Maribo";"no";0;0;0;54,776388;11,5
1807;"Maribo";"no";0;0;0;54,776388;11,5
1808;"Maribo";"no";0;0;0;54,776388;11,5
1809;"Maribo";"no";0;0;0;54,776388;11,5
1810;"Maribo";"no";0;0;0;54,776388;11,5
1811;"Maribo";"no";0;0;0;54,776388;11,5
1812;"Maribo";"no";0;0;0;54,776388;11,5
1813;"Maribo";"no";0;0;0;54,776388;11,5
1814;"Maribo";"no";0;0;0;54,776388;11,5
1815;"Maribo";"no";0;0;0;54,776388;11,5
1816;"Maribo";"no";0;0;0;54,776388;11,5
1817;"Maribo";"no";0;0;0;54,776388;11,5
1818;"Maribo";"no";0;0;0;54,776388;11,5
1819;"Maribo";"no";0;1;1;54,776388;11,5
1820;"Maribo";"no";0;0;0;54,776388;11,5
1821;"Maribo";"no";0;1;1;54,776388;11,5
1822;"Maribo";"no";0;2;2;54,776388;11,5
1823;"Maribo";"no";0;1;1;54,776388;11,5
1824;"Maribo";"no";0;0;0;54,776388;11,5
1825;"Maribo";"no";0;0;0;54,776388;11,5
1826;"Maribo";"no";0;0;0;54,776388;11,5
1827;"Maribo";"no";0;1;1;54,776388;11,5
1828;"Maribo";"no";0;0;0;54,776388;11,5
1829;"Maribo";"no";0;0;0;54,776388;11,5
1830;"Maribo";"no";0;0;0;54,776388;11,5
1831;"Maribo";"no";0;0;0;54,776388;11,5
1832;"Maribo";"no";0;0;0;54,776388;11,5
1833;"Maribo";"no";0;0;0;54,776388;11,5
1834;"Maribo";"no";0;0;0;54,776388;11,5
1835;"Maribo";"no";0;0;0;54,776388;11,5
1836;"Maribo";"no";0;0;0;54,776388;11,5
1837;"Maribo";"no";0;0;0;54,776388;11,5
1838;"Maribo";"no";0;0;0;54,776388;11,5
1839;"Maribo";"no";0;0;0;54,776388;11,5
1840;"Maribo";"no";0;0;0;54,776388;11,5
1841;"Maribo";"no";0;1;1;54,776388;11,5
1842;"Maribo";"no";0;0;0;54,776388;11,5
1843;"Maribo";"no";0;0;0;54,776388;11,5
1844;"Maribo";"no";0;0;0;54,776388;11,5
1845;"Maribo";"no";0;0;0;54,776388;11,5
1846;"Maribo";"no";0;0;0;54,776388;11,5
1847;"Maribo";"no";0;0;0;54,776388;11,5
1848;"Maribo";"no";0;0;0;54,776388;11,5
1849;"Maribo";"no";0;1;1;54,776388;11,5
1850;"Maribo";"no";0;0;0;54,776388;11,5
1851;"Maribo";"no";0;0;0;54,776388;11,5
1852;"Maribo";"no";0;0;0;54,776388;11,5
1853;"Maribo";"no";0;0;0;54,776388;11,5
1854;"Maribo";"no";0;0;0;54,776388;11,5
1855;"Maribo";"no";0;0;0;54,776388;11,5
1856;"Maribo";"no";0;1;1;54,776388;11,5
1857;"Maribo";"no";0;0;0;54,776388;11,5
1634;"Nykøbing Falster";"no";1;0;1;54,768888;11,874166
1635;"Nykøbing Falster";"no";7;0;7;54,768888;11,874166
1636;"Nykøbing Falster";"no";6;0;6;54,768888;11,874166
1637;"Nykøbing Falster";"no";4;0;4;54,768888;11,874166
1638;"Nykøbing Falster";"no";4;0;4;54,768888;11,874166
1639;"Nykøbing Falster";"no";4;0;4;54,768888;11,874166
1640;"Nykøbing Falster";"no";2;0;2;54,768888;11,874166
1641;"Nykøbing Falster";"no";4;0;4;54,768888;11,874166
1642;"Nykøbing Falster";"no";3;1;4;54,768888;11,874166
1643;"Nykøbing Falster";"no";3;1;4;54,768888;11,874166
1644;"Nykøbing Falster";"no";3;3;6;54,768888;11,874166
1645;"Nykøbing Falster";"no";0;0;0;54,768888;11,874166
1646;"Nykøbing Falster";"no";3;0;3;54,768888;11,874166
1647;"Nykøbing Falster";"no";3;1;4;54,768888;11,874166
1648;"Nykøbing Falster";"no";2;0;2;54,768888;11,874166
1649;"Nykøbing Falster";"no";3;0;3;54,768888;11,874166
1650;"Nykøbing Falster";"no";0;0;0;54,768888;11,874166
1651;"Nykøbing Falster";"no";3;0;3;54,768888;11,874166
1652;"Nykøbing Falster";"no";0;0;0;54,768888;11,874166
1653;"Nykøbing Falster";"no";0;0;0;54,768888;11,874166
1654;"Nykøbing Falster";"no";0;0;0;54,768888;11,874166
1655;"Nykøbing Falster";"no";2;0;2;54,768888;11,874166
1656;"Nykøbing Falster";"no";2;0;2;54,768888;11,874166
1657;"Nykøbing Falster";"no";2;0;2;54,768888;11,874166
1658;"Nykøbing Falster";"no";2;0;2;54,768888;11,874166
1659;"Nykøbing Falster";"no";0;0;0;54,768888;11,874166
1660;"Nykøbing Falster";"no";0;0;0;54,768888;11,874166
1661;"Nykøbing Falster";"no";2;0;2;54,768888;11,874166
1662;"Nykøbing Falster";"no";1;0;1;54,768888;11,874166
1663;"Nykøbing Falster";"no";1;0;1;54,768888;11,874166
1664;"Nykøbing Falster";"no";0;0;0;54,768888;11,874166
1665;"Nykøbing Falster";"no";0;0;0;54,768888;11,874166
1666;"Nykøbing Falster";"no";1;0;1;54,768888;11,874166
1667;"Nykøbing Falster";"no";2;0;2;54,768888;11,874166
1668;"Nykøbing Falster";"no";0;0;0;54,768888;11,874166
1669;"Nykøbing Falster";"no";3;4;7;54,768888;11,874166
1670;"Nykøbing Falster";"no";2;2;4;54,768888;11,874166
1671;"Nykøbing Falster";"no";1;1;2;54,768888;11,874166
1672;"Nykøbing Falster";"no";0;1;1;54,768888;11,874166
1673;"Nykøbing Falster";"no";1;1;2;54,768888;11,874166
1674;"Nykøbing Falster";"no";2;0;2;54,768888;11,874166
1675;"Nykøbing Falster";"no";0;0;0;54,768888;11,874166
1676;"Nykøbing Falster";"no";0;0;0;54,768888;11,874166
1677;"Nykøbing Falster";"no";1;0;1;54,768888;11,874166
1678;"Nykøbing Falster";"no";0;2;2;54,768888;11,874166
1679;"Nykøbing Falster";"no";0;1;1;54,768888;11,874166
1680;"Nykøbing Falster";"no";2;0;2;54,768888;11,874166
1681;"Nykøbing Falster";"no";3;1;4;54,768888;11,874166
1682;"Nykøbing Falster";"no";0;1;1;54,768888;11,874166
1683;"Nykøbing Falster";"no";0;3;3;54,768888;11,874166
1684;"Nykøbing Falster";"no";2;1;3;54,768888;11,874166
1685;"Nykøbing Falster";"no";2;0;2;54,768888;11,874166
1686;"Nykøbing Falster";"no";0;0;0;54,768888;11,874166
1687;"Nykøbing Falster";"no";0;1;1;54,768888;11,874166
1688;"Nykøbing Falster";"no";0;0;0;54,768888;11,874166
1689;"Nykøbing Falster";"no";0;0;0;54,768888;11,874166
1690;"Nykøbing Falster";"no";0;0;0;54,768888;11,874166
1691;"Nykøbing Falster";"no";0;1;1;54,768888;11,874166
1692;"Nykøbing Falster";"no";1;0;1;54,768888;11,874166
1693;"Nykøbing Falster";"no";2;1;3;54,768888;11,874166
1694;"Nykøbing Falster";"no";0;0;0;54,768888;11,874166
1695;"Nykøbing Falster";"no";2;0;2;54,768888;11,874166
1696;"Nykøbing Falster";"no";0;1;1;54,768888;11,874166
1697;"Nykøbing Falster";"no";0;2;2;54,768888;11,874166
1698;"Nykøbing Falster";"no";0;0;0;54,768888;11,874166
1699;"Nykøbing Falster";"no";0;0;0;54,768888;11,874166
1700;"Nykøbing Falster";"no";0;1;1;54,768888;11,874166
1701;"Nykøbing Falster";"no";0;0;0;54,768888;11,874166
1702;"Nykøbing Falster";"no";1;1;2;54,768888;11,874166
1703;"Nykøbing Falster";"no";0;0;0;54,768888;11,874166
1704;"Nykøbing Falster";"no";0;0;0;54,768888;11,874166
1705;"Nykøbing Falster";"no";1;2;3;54,768888;11,874166
1706;"Nykøbing Falster";"no";0;2;2;54,768888;11,874166
1707;"Nykøbing Falster";"no";0;0;0;54,768888;11,874166
1708;"Nykøbing Falster";"no";1;0;1;54,768888;11,874166
1709;"Nykøbing Falster";"no";0;0;0;54,768888;11,874166
1710;"Nykøbing Falster";"no";0;0;0;54,768888;11,874166
1711;"Nykøbing Falster";"no";2;0;2;54,768888;11,874166
1712;"Nykøbing Falster";"no";0;0;0;54,768888;11,874166
1713;"Nykøbing Falster";"no";1;0;1;54,768888;11,874166
1714;"Nykøbing Falster";"no";2;0;2;54,768888;11,874166
1715;"Nykøbing Falster";"no";0;0;0;54,768888;11,874166
1716;"Nykøbing Falster";"no";0;0;0;54,768888;11,874166
1717;"Nykøbing Falster";"no";0;0;0;54,768888;11,874166
1718;"Nykøbing Falster";"no";1;0;1;54,768888;11,874166
1719;"Nykøbing Falster";"no";0;0;0;54,768888;11,874166
1720;"Nykøbing Falster";"no";0;0;0;54,768888;11,874166
1721;"Nykøbing Falster";"no";0;0;0;54,768888;11,874166
1722;"Nykøbing Falster";"no";0;0;0;54,768888;11,874166
1723;"Nykøbing Falster";"no";0;0;0;54,768888;11,874166
1724;"Nykøbing Falster";"no";1;0;1;54,768888;11,874166
1725;"Nykøbing Falster";"no";1;0;1;54,768888;11,874166
1726;"Nykøbing Falster";"no";0;0;0;54,768888;11,874166
1727;"Nykøbing Falster";"no";0;0;0;54,768888;11,874166
1728;"Nykøbing Falster";"no";0;1;1;54,768888;11,874166
1729;"Nykøbing Falster";"no";0;0;0;54,768888;11,874166
1730;"Nykøbing Falster";"no";0;0;0;54,768888;11,874166
1731;"Nykøbing Falster";"no";0;0;0;54,768888;11,874166
1732;"Nykøbing Falster";"no";0;0;0;54,768888;11,874166
1733;"Nykøbing Falster";"no";0;0;0;54,768888;11,874166
1734;"Nykøbing Falster";"no";0;0;0;54,768888;11,874166
1735;"Nykøbing Falster";"no";1;0;1;54,768888;11,874166
1736;"Nykøbing Falster";"no";0;0;0;54,768888;11,874166
1737;"Nykøbing Falster";"no";0;0;0;54,768888;11,874166
1738;"Nykøbing Falster";"no";0;0;0;54,768888;11,874166
1739;"Nykøbing Falster";"no";0;0;0;54,768888;11,874166
1740;"Nykøbing Falster";"no";0;1;1;54,768888;11,874166
1741;"Nykøbing Falster";"no";1;0;1;54,768888;11,874166
1742;"Nykøbing Falster";"no";0;1;1;54,768888;11,874166
1743;"Nykøbing Falster";"no";0;1;1;54,768888;11,874166
1744;"Nykøbing Falster";"no";0;1;1;54,768888;11,874166
1745;"Nykøbing Falster";"no";2;0;2;54,768888;11,874166
1746;"Nykøbing Falster";"no";0;1;1;54,768888;11,874166
1747;"Nykøbing Falster";"no";2;0;2;54,768888;11,874166
1748;"Nykøbing Falster";"no";3;0;3;54,768888;11,874166
1749;"Nykøbing Falster";"no";0;0;0;54,768888;11,874166
1750;"Nykøbing Falster";"no";1;1;2;54,768888;11,874166
1751;"Nykøbing Falster";"no";1;2;3;54,768888;11,874166
1752;"Nykøbing Falster";"no";2;2;4;54,768888;11,874166
1753;"Nykøbing Falster";"no";1;0;1;54,768888;11,874166
1754;"Nykøbing Falster";"no";2;0;2;54,768888;11,874166
1755;"Nykøbing Falster";"no";1;0;1;54,768888;11,874166
1756;"Nykøbing Falster";"no";0;0;0;54,768888;11,874166
1757;"Nykøbing Falster";"no";3;1;4;54,768888;11,874166
1758;"Nykøbing Falster";"no";2;4;6;54,768888;11,874166
1759;"Nykøbing Falster";"no";4;9;13;54,768888;11,874166
1760;"Nykøbing Falster";"no";6;10;16;54,768888;11,874166
1761;"Nykøbing Falster";"no";8;6;14;54,768888;11,874166
1762;"Nykøbing Falster";"no";2;2;4;54,768888;11,874166
1763;"Nykøbing Falster";"no";1;1;2;54,768888;11,874166
1764;"Nykøbing Falster";"no";0;0;0;54,768888;11,874166
1765;"Nykøbing Falster";"no";0;0;0;54,768888;11,874166
1766;"Nykøbing Falster";"no";0;0;0;54,768888;11,874166
1767;"Nykøbing Falster";"no";1;0;1;54,768888;11,874166
1768;"Nykøbing Falster";"no";0;1;1;54,768888;11,874166
1769;"Nykøbing Falster";"no";3;0;3;54,768888;11,874166
1770;"Nykøbing Falster";"no";0;0;0;54,768888;11,874166
1771;"Nykøbing Falster";"no";0;0;0;54,768888;11,874166
1772;"Nykøbing Falster";"no";2;3;5;54,768888;11,874166
1773;"Nykøbing Falster";"no";0;0;0;54,768888;11,874166
1774;"Nykøbing Falster";"no";0;0;0;54,768888;11,874166
1775;"Nykøbing Falster";"no";0;0;0;54,768888;11,874166
1776;"Nykøbing Falster";"no";0;0;0;54,768888;11,874166
1777;"Nykøbing Falster";"no";0;1;1;54,768888;11,874166
1778;"Nykøbing Falster";"no";0;1;1;54,768888;11,874166
1779;"Nykøbing Falster";"no";0;0;0;54,768888;11,874166
1780;"Nykøbing Falster";"no";0;0;0;54,768888;11,874166
1781;"Nykøbing Falster";"no";0;1;1;54,768888;11,874166
1782;"Nykøbing Falster";"no";0;1;1;54,768888;11,874166
1783;"Nykøbing Falster";"no";0;0;0;54,768888;11,874166
1784;"Nykøbing Falster";"no";0;0;0;54,768888;11,874166
1785;"Nykøbing Falster";"no";0;0;0;54,768888;11,874166
1786;"Nykøbing Falster";"no";0;3;3;54,768888;11,874166
1787;"Nykøbing Falster";"no";3;0;3;54,768888;11,874166
1788;"Nykøbing Falster";"no";0;2;2;54,768888;11,874166
1789;"Nykøbing Falster";"no";3;0;3;54,768888;11,874166
1790;"Nykøbing Falster";"no";0;0;0;54,768888;11,874166
1791;"Nykøbing Falster";"no";0;1;1;54,768888;11,874166
1792;"Nykøbing Falster";"no";0;0;0;54,768888;11,874166
1793;"Nykøbing Falster";"no";0;1;1;54,768888;11,874166
1794;"Nykøbing Falster";"no";0;0;0;54,768888;11,874166
1795;"Nykøbing Falster";"no";0;0;0;54,768888;11,874166
1796;"Nykøbing Falster";"no";0;4;4;54,768888;11,874166
1797;"Nykøbing Falster";"no";0;1;1;54,768888;11,874166
1798;"Nykøbing Falster";"no";1;1;2;54,768888;11,874166
1799;"Nykøbing Falster";"no";0;0;0;54,768888;11,874166
1800;"Nykøbing Falster";"no";1;1;2;54,768888;11,874166
1801;"Nykøbing Falster";"no";1;1;2;54,768888;11,874166
1802;"Nykøbing Falster";"no";0;0;0;54,768888;11,874166
1803;"Nykøbing Falster";"no";0;0;0;54,768888;11,874166
1804;"Nykøbing Falster";"no";0;1;1;54,768888;11,874166
1805;"Nykøbing Falster";"no";1;0;1;54,768888;11,874166
1806;"Nykøbing Falster";"no";1;3;4;54,768888;11,874166
1807;"Nykøbing Falster";"no";0;0;0;54,768888;11,874166
1808;"Nykøbing Falster";"no";0;0;0;54,768888;11,874166
1809;"Nykøbing Falster";"no";0;0;0;54,768888;11,874166
1810;"Nykøbing Falster";"no";0;1;1;54,768888;11,874166
1811;"Nykøbing Falster";"no";0;0;0;54,768888;11,874166
1812;"Nykøbing Falster";"no";0;0;0;54,768888;11,874166
1813;"Nykøbing Falster";"no";2;2;4;54,768888;11,874166
1814;"Nykøbing Falster";"no";1;1;2;54,768888;11,874166
1815;"Nykøbing Falster";"no";0;1;1;54,768888;11,874166
1816;"Nykøbing Falster";"no";0;2;2;54,768888;11,874166
1817;"Nykøbing Falster";"no";2;0;2;54,768888;11,874166
1818;"Nykøbing Falster";"no";2;0;2;54,768888;11,874166
1819;"Nykøbing Falster";"no";1;0;1;54,768888;11,874166
1820;"Nykøbing Falster";"no";4;2;6;54,768888;11,874166
1821;"Nykøbing Falster";"no";4;2;6;54,768888;11,874166
1822;"Nykøbing Falster";"no";0;0;0;54,768888;11,874166
1823;"Nykøbing Falster";"no";1;1;2;54,768888;11,874166
1824;"Nykøbing Falster";"no";0;3;3;54,768888;11,874166
1825;"Nykøbing Falster";"no";3;2;5;54,768888;11,874166
1826;"Nykøbing Falster";"no";3;0;3;54,768888;11,874166
1827;"Nykøbing Falster";"no";1;0;1;54,768888;11,874166
1828;"Nykøbing Falster";"no";3;1;4;54,768888;11,874166
1829;"Nykøbing Falster";"no";1;3;4;54,768888;11,874166
1830;"Nykøbing Falster";"no";1;2;3;54,768888;11,874166
1831;"Nykøbing Falster";"no";2;1;3;54,768888;11,874166
1832;"Nykøbing Falster";"no";4;1;5;54,768888;11,874166
1833;"Nykøbing Falster";"no";2;1;3;54,768888;11,874166
1834;"Nykøbing Falster";"no";2;1;3;54,768888;11,874166
1835;"Nykøbing Falster";"no";0;0;0;54,768888;11,874166
1836;"Nykøbing Falster";"no";1;0;1;54,768888;11,874166
1837;"Nykøbing Falster";"no";3;2;5;54,768888;11,874166
1838;"Nykøbing Falster";"no";2;1;3;54,768888;11,874166
1839;"Nykøbing Falster";"no";1;3;4;54,768888;11,874166
1840;"Nykøbing Falster";"no";7;3;10;54,768888;11,874166
1841;"Nykøbing Falster";"no";4;0;4;54,768888;11,874166
1842;"Nykøbing Falster";"no";6;5;11;54,768888;11,874166
1843;"Nykøbing Falster";"no";7;5;12;54,768888;11,874166
1844;"Nykøbing Falster";"no";15;6;21;54,768888;11,874166
1845;"Nykøbing Falster";"no";11;3;14;54,768888;11,874166
1846;"Nykøbing Falster";"no";6;9;15;54,768888;11,874166
1847;"Nykøbing Falster";"no";12;9;21;54,768888;11,874166
1848;"Nykøbing Falster";"no";9;7;16;54,768888;11,874166
1849;"Nykøbing Falster";"no";12;6;18;54,768888;11,874166
1850;"Nykøbing Falster";"no";4;7;11;54,768888;11,874166
1851;"Nykøbing Falster";"no";7;10;17;54,768888;11,874166
1852;"Nykøbing Falster";"no";5;3;8;54,768888;11,874166
1853;"Nykøbing Falster";"no";2;5;7;54,768888;11,874166
1854;"Nykøbing Falster";"no";6;8;14;54,768888;11,874166
1855;"Nykøbing Falster";"no";6;6;12;54,768888;11,874166
1856;"Nykøbing Falster";"no";5;7;12;54,768888;11,874166
1857;"Nykøbing Falster";"no";0;0;0;54,768888;11,874166
1634;"Præstø";"no";1;0;1;55,116666;12,05
1635;"Præstø";"no";3;0;3;55,116666;12,05
1636;"Præstø";"no";0;0;0;55,116666;12,05
1637;"Præstø";"no";3;0;3;55,116666;12,05
1638;"Præstø";"no";2;0;2;55,116666;12,05
1639;"Præstø";"no";1;0;1;55,116666;12,05
1640;"Præstø";"no";0;0;0;55,116666;12,05
1641;"Præstø";"no";1;0;1;55,116666;12,05
1642;"Præstø";"no";2;0;2;55,116666;12,05
1643;"Præstø";"no";3;0;3;55,116666;12,05
1644;"Præstø";"no";0;0;0;55,116666;12,05
1645;"Præstø";"no";0;0;0;55,116666;12,05
1646;"Præstø";"no";1;0;1;55,116666;12,05
1647;"Præstø";"no";1;0;1;55,116666;12,05
1648;"Præstø";"no";1;0;1;55,116666;12,05
1649;"Præstø";"no";3;0;3;55,116666;12,05
1650;"Præstø";"no";2;1;3;55,116666;12,05
1651;"Præstø";"no";2;0;2;55,116666;12,05
1652;"Præstø";"no";1;1;2;55,116666;12,05
1653;"Præstø";"no";2;0;2;55,116666;12,05
1654;"Præstø";"no";2;0;2;55,116666;12,05
1655;"Præstø";"no";2;0;2;55,116666;12,05
1656;"Præstø";"no";3;0;3;55,116666;12,05
1657;"Præstø";"no";0;0;0;55,116666;12,05
1658;"Præstø";"no";0;0;0;55,116666;12,05
1659;"Præstø";"no";0;0;0;55,116666;12,05
1660;"Præstø";"no";0;0;0;55,116666;12,05
1661;"Præstø";"no";0;0;0;55,116666;12,05
1662;"Præstø";"no";0;0;0;55,116666;12,05
1663;"Præstø";"no";0;0;0;55,116666;12,05
1664;"Præstø";"no";0;0;0;55,116666;12,05
1665;"Præstø";"no";1;0;1;55,116666;12,05
1666;"Præstø";"no";0;0;0;55,116666;12,05
1667;"Præstø";"no";0;0;0;55,116666;12,05
1668;"Præstø";"no";0;0;0;55,116666;12,05
1669;"Præstø";"no";0;0;0;55,116666;12,05
1670;"Præstø";"no";0;0;0;55,116666;12,05
1671;"Præstø";"no";2;1;3;55,116666;12,05
1672;"Præstø";"no";1;2;3;55,116666;12,05
1673;"Præstø";"no";4;0;4;55,116666;12,05
1674;"Præstø";"no";2;0;2;55,116666;12,05
1675;"Præstø";"no";0;0;0;55,116666;12,05
1676;"Præstø";"no";0;0;0;55,116666;12,05
1677;"Præstø";"no";0;0;0;55,116666;12,05
1678;"Præstø";"no";0;0;0;55,116666;12,05
1679;"Præstø";"no";0;0;0;55,116666;12,05
1680;"Præstø";"no";0;0;0;55,116666;12,05
1681;"Præstø";"no";0;0;0;55,116666;12,05
1682;"Præstø";"no";0;0;0;55,116666;12,05
1683;"Præstø";"no";0;0;0;55,116666;12,05
1684;"Præstø";"no";0;1;1;55,116666;12,05
1685;"Præstø";"no";0;0;0;55,116666;12,05
1686;"Præstø";"no";2;0;2;55,116666;12,05
1687;"Præstø";"no";0;0;0;55,116666;12,05
1688;"Præstø";"no";0;0;0;55,116666;12,05
1689;"Præstø";"no";0;1;1;55,116666;12,05
1690;"Præstø";"no";5;1;6;55,116666;12,05
1691;"Præstø";"no";0;0;0;55,116666;12,05
1692;"Præstø";"no";0;0;0;55,116666;12,05
1693;"Præstø";"no";2;2;4;55,116666;12,05
1694;"Præstø";"no";0;0;0;55,116666;12,05
1695;"Præstø";"no";0;0;0;55,116666;12,05
1696;"Præstø";"no";1;1;2;55,116666;12,05
1697;"Præstø";"no";0;0;0;55,116666;12,05
1698;"Præstø";"no";1;0;1;55,116666;12,05
1699;"Præstø";"no";0;0;0;55,116666;12,05
1700;"Præstø";"no";1;0;1;55,116666;12,05
1701;"Præstø";"no";0;0;0;55,116666;12,05
1702;"Præstø";"no";1;0;1;55,116666;12,05
1703;"Præstø";"no";2;1;3;55,116666;12,05
1704;"Præstø";"no";1;1;2;55,116666;12,05
1705;"Præstø";"no";0;0;0;55,116666;12,05
1706;"Præstø";"no";1;1;2;55,116666;12,05
1707;"Præstø";"no";0;0;0;55,116666;12,05
1708;"Præstø";"no";1;0;1;55,116666;12,05
1709;"Præstø";"no";0;0;0;55,116666;12,05
1710;"Præstø";"no";0;0;0;55,116666;12,05
1711;"Præstø";"no";0;0;0;55,116666;12,05
1712;"Præstø";"no";0;0;0;55,116666;12,05
1713;"Præstø";"no";0;0;0;55,116666;12,05
1714;"Præstø";"no";0;0;0;55,116666;12,05
1715;"Præstø";"no";0;0;0;55,116666;12,05
1716;"Præstø";"no";0;0;0;55,116666;12,05
1717;"Præstø";"no";0;0;0;55,116666;12,05
1718;"Præstø";"no";0;0;0;55,116666;12,05
1719;"Præstø";"no";0;0;0;55,116666;12,05
1720;"Præstø";"no";0;0;0;55,116666;12,05
1721;"Præstø";"no";0;0;0;55,116666;12,05
1722;"Præstø";"no";0;1;1;55,116666;12,05
1723;"Præstø";"no";1;0;1;55,116666;12,05
1724;"Præstø";"no";0;0;0;55,116666;12,05
1725;"Præstø";"no";1;0;1;55,116666;12,05
1726;"Præstø";"no";1;0;1;55,116666;12,05
1727;"Præstø";"no";1;0;1;55,116666;12,05
1728;"Præstø";"no";0;1;1;55,116666;12,05
1729;"Præstø";"no";0;0;0;55,116666;12,05
1730;"Præstø";"no";0;0;0;55,116666;12,05
1731;"Præstø";"no";1;0;1;55,116666;12,05
1732;"Præstø";"no";0;0;0;55,116666;12,05
1733;"Præstø";"no";1;0;1;55,116666;12,05
1734;"Præstø";"no";2;0;2;55,116666;12,05
1735;"Præstø";"no";0;0;0;55,116666;12,05
1736;"Præstø";"no";0;0;0;55,116666;12,05
1737;"Præstø";"no";0;1;1;55,116666;12,05
1738;"Præstø";"no";3;1;4;55,116666;12,05
1739;"Præstø";"no";0;0;0;55,116666;12,05
1740;"Præstø";"no";2;0;2;55,116666;12,05
1741;"Præstø";"no";1;0;1;55,116666;12,05
1742;"Præstø";"no";2;1;3;55,116666;12,05
1743;"Præstø";"no";1;1;2;55,116666;12,05
1744;"Præstø";"no";2;3;5;55,116666;12,05
1745;"Præstø";"no";1;4;5;55,116666;12,05
1746;"Præstø";"no";0;0;0;55,116666;12,05
1747;"Præstø";"no";1;1;2;55,116666;12,05
1748;"Præstø";"no";0;0;0;55,116666;12,05
1749;"Præstø";"no";1;1;2;55,116666;12,05
1750;"Præstø";"no";2;1;3;55,116666;12,05
1751;"Præstø";"no";3;2;5;55,116666;12,05
1752;"Præstø";"no";4;5;9;55,116666;12,05
1753;"Præstø";"no";7;4;11;55,116666;12,05
1754;"Præstø";"no";9;4;13;55,116666;12,05
1755;"Præstø";"no";2;2;4;55,116666;12,05
1756;"Præstø";"no";3;3;6;55,116666;12,05
1757;"Præstø";"no";2;4;6;55,116666;12,05
1758;"Præstø";"no";1;4;5;55,116666;12,05
1759;"Præstø";"no";0;2;2;55,116666;12,05
1760;"Præstø";"no";2;1;3;55,116666;12,05
1761;"Præstø";"no";4;5;9;55,116666;12,05
1762;"Præstø";"no";3;3;6;55,116666;12,05
1763;"Præstø";"no";2;1;3;55,116666;12,05
1764;"Præstø";"no";3;4;7;55,116666;12,05
1765;"Præstø";"no";3;3;6;55,116666;12,05
1766;"Præstø";"no";6;2;8;55,116666;12,05
1767;"Præstø";"no";3;1;4;55,116666;12,05
1768;"Præstø";"no";3;1;4;55,116666;12,05
1769;"Præstø";"no";3;0;3;55,116666;12,05
1770;"Præstø";"no";6;2;8;55,116666;12,05
1771;"Præstø";"no";1;1;2;55,116666;12,05
1772;"Præstø";"no";3;2;5;55,116666;12,05
1773;"Præstø";"no";0;2;2;55,116666;12,05
1774;"Præstø";"no";2;2;4;55,116666;12,05
1775;"Præstø";"no";8;4;12;55,116666;12,05
1776;"Præstø";"no";5;2;7;55,116666;12,05
1777;"Præstø";"no";1;0;1;55,116666;12,05
1778;"Præstø";"no";2;2;4;55,116666;12,05
1779;"Præstø";"no";2;0;2;55,116666;12,05
1780;"Præstø";"no";2;2;4;55,116666;12,05
1781;"Præstø";"no";3;1;4;55,116666;12,05
1782;"Præstø";"no";2;0;2;55,116666;12,05
1783;"Præstø";"no";5;3;8;55,116666;12,05
1784;"Præstø";"no";1;0;1;55,116666;12,05
1785;"Præstø";"no";1;0;1;55,116666;12,05
1786;"Præstø";"no";0;0;0;55,116666;12,05
1787;"Præstø";"no";4;1;5;55,116666;12,05
1788;"Præstø";"no";5;0;5;55,116666;12,05
1789;"Præstø";"no";2;1;3;55,116666;12,05
1790;"Præstø";"no";1;1;2;55,116666;12,05
1791;"Præstø";"no";3;1;4;55,116666;12,05
1792;"Præstø";"no";7;1;8;55,116666;12,05
1793;"Præstø";"no";3;2;5;55,116666;12,05
1794;"Præstø";"no";4;1;5;55,116666;12,05
1795;"Præstø";"no";8;2;10;55,116666;12,05
1796;"Præstø";"no";6;12;18;55,116666;12,05
1797;"Præstø";"no";7;6;13;55,116666;12,05
1798;"Præstø";"no";9;6;15;55,116666;12,05
1799;"Præstø";"no";8;6;14;55,116666;12,05
1800;"Præstø";"no";7;7;14;55,116666;12,05
1801;"Præstø";"no";6;6;12;55,116666;12,05
1802;"Præstø";"no";7;8;15;55,116666;12,05
1803;"Præstø";"no";13;7;20;55,116666;12,05
1804;"Præstø";"no";6;2;8;55,116666;12,05
1805;"Præstø";"no";6;5;11;55,116666;12,05
1806;"Præstø";"no";5;8;13;55,116666;12,05
1807;"Præstø";"no";0;0;0;55,116666;12,05
1808;"Præstø";"no";0;0;0;55,116666;12,05
1809;"Præstø";"no";0;0;0;55,116666;12,05
1810;"Præstø";"no";0;0;0;55,116666;12,05
1811;"Præstø";"no";0;0;0;55,116666;12,05
1812;"Præstø";"no";0;0;0;55,116666;12,05
1813;"Præstø";"no";0;0;0;55,116666;12,05
1814;"Præstø";"no";0;0;0;55,116666;12,05
1815;"Præstø";"no";1;2;3;55,116666;12,05
1816;"Præstø";"no";2;1;3;55,116666;12,05
1817;"Præstø";"no";1;2;3;55,116666;12,05
1818;"Præstø";"no";4;3;7;55,116666;12,05
1819;"Præstø";"no";8;6;14;55,116666;12,05
1820;"Præstø";"no";11;9;20;55,116666;12,05
1821;"Præstø";"no";13;7;20;55,116666;12,05
1822;"Præstø";"no";5;7;12;55,116666;12,05
1823;"Præstø";"no";10;7;17;55,116666;12,05
1824;"Præstø";"no";17;6;23;55,116666;12,05
1825;"Præstø";"no";16;10;26;55,116666;12,05
1826;"Præstø";"no";7;10;17;55,116666;12,05
1827;"Præstø";"no";14;7;21;55,116666;12,05
1828;"Præstø";"no";17;8;25;55,116666;12,05
1829;"Præstø";"no";10;6;16;55,116666;12,05
1830;"Præstø";"no";10;17;27;55,116666;12,05
1831;"Præstø";"no";9;8;17;55,116666;12,05
1832;"Præstø";"no";14;10;24;55,116666;12,05
1833;"Præstø";"no";25;17;42;55,116666;12,05
1834;"Præstø";"no";24;14;38;55,116666;12,05
1835;"Præstø";"no";16;11;27;55,116666;12,05
1836;"Præstø";"no";14;12;26;55,116666;12,05
1837;"Præstø";"no";17;11;28;55,116666;12,05
1838;"Præstø";"no";14;22;36;55,116666;12,05
1839;"Præstø";"no";23;14;37;55,116666;12,05
1840;"Præstø";"no";29;13;42;55,116666;12,05
1841;"Præstø";"no";22;11;33;55,116666;12,05
1842;"Præstø";"no";15;9;24;55,116666;12,05
1843;"Præstø";"no";18;8;26;55,116666;12,05
1844;"Præstø";"no";33;13;46;55,116666;12,05
1845;"Præstø";"no";26;14;40;55,116666;12,05
1846;"Præstø";"no";30;18;48;55,116666;12,05
1847;"Præstø";"no";19;14;33;55,116666;12,05
1848;"Præstø";"no";38;20;58;55,116666;12,05
1849;"Præstø";"no";37;18;55;55,116666;12,05
1850;"Præstø";"no";34;19;53;55,116666;12,05
1851;"Præstø";"no";30;19;49;55,116666;12,05
1852;"Præstø";"no";32;12;44;55,116666;12,05
1853;"Præstø";"no";21;13;34;55,116666;12,05
1854;"Præstø";"no";37;12;49;55,116666;12,05
1855;"Præstø";"no";29;19;48;55,116666;12,05
1856;"Præstø";"no";28;21;49;55,116666;12,05
1857;"Præstø";"no";6;1;7;55,116666;12,05
1634;"Æbeltoft";"no";2;0;2;56,194166;10,681944
1635;"Æbeltoft";"no";1;0;1;56,194166;10,681944
1636;"Æbeltoft";"no";0;0;0;56,194166;10,681944
1637;"Æbeltoft";"no";0;0;0;56,194166;10,681944
1638;"Æbeltoft";"no";2;0;2;56,194166;10,681944
1639;"Æbeltoft";"no";1;0;1;56,194166;10,681944
1640;"Æbeltoft";"no";0;0;0;56,194166;10,681944
1641;"Æbeltoft";"no";1;0;1;56,194166;10,681944
1642;"Æbeltoft";"no";0;1;1;56,194166;10,681944
1643;"Æbeltoft";"no";4;2;6;56,194166;10,681944
1644;"Æbeltoft";"no";1;1;2;56,194166;10,681944
1645;"Æbeltoft";"no";0;0;0;56,194166;10,681944
1646;"Æbeltoft";"no";0;0;0;56,194166;10,681944
1647;"Æbeltoft";"no";0;0;0;56,194166;10,681944
1648;"Æbeltoft";"no";0;0;0;56,194166;10,681944
1649;"Æbeltoft";"no";0;0;0;56,194166;10,681944
1650;"Æbeltoft";"no";0;0;0;56,194166;10,681944
1651;"Æbeltoft";"no";0;0;0;56,194166;10,681944
1652;"Æbeltoft";"no";0;0;0;56,194166;10,681944
1653;"Æbeltoft";"no";0;0;0;56,194166;10,681944
1654;"Æbeltoft";"no";0;0;0;56,194166;10,681944
1655;"Æbeltoft";"no";0;0;0;56,194166;10,681944
1656;"Æbeltoft";"no";0;0;0;56,194166;10,681944
1657;"Æbeltoft";"no";0;0;0;56,194166;10,681944
1658;"Æbeltoft";"no";0;0;0;56,194166;10,681944
1659;"Æbeltoft";"no";0;0;0;56,194166;10,681944
1660;"Æbeltoft";"no";0;0;0;56,194166;10,681944
1661;"Æbeltoft";"no";1;0;1;56,194166;10,681944
1662;"Æbeltoft";"no";0;0;0;56,194166;10,681944
1663;"Æbeltoft";"no";0;0;0;56,194166;10,681944
1664;"Æbeltoft";"no";0;0;0;56,194166;10,681944
1665;"Æbeltoft";"no";0;0;0;56,194166;10,681944
1666;"Æbeltoft";"no";0;0;0;56,194166;10,681944
1667;"Æbeltoft";"no";1;0;1;56,194166;10,681944
1668;"Æbeltoft";"no";0;0;0;56,194166;10,681944
1669;"Æbeltoft";"no";0;0;0;56,194166;10,681944
1670;"Æbeltoft";"no";0;0;0;56,194166;10,681944
1671;"Æbeltoft";"no";0;1;1;56,194166;10,681944
1672;"Æbeltoft";"no";0;0;0;56,194166;10,681944
1673;"Æbeltoft";"no";0;0;0;56,194166;10,681944
1674;"Æbeltoft";"no";0;0;0;56,194166;10,681944
1675;"Æbeltoft";"no";0;0;0;56,194166;10,681944
1676;"Æbeltoft";"no";0;0;0;56,194166;10,681944
1677;"Æbeltoft";"no";0;0;0;56,194166;10,681944
1678;"Æbeltoft";"no";1;1;2;56,194166;10,681944
1679;"Æbeltoft";"no";0;0;0;56,194166;10,681944
1680;"Æbeltoft";"no";1;2;3;56,194166;10,681944
1681;"Æbeltoft";"no";0;0;0;56,194166;10,681944
1682;"Æbeltoft";"no";0;0;0;56,194166;10,681944
1683;"Æbeltoft";"no";0;0;0;56,194166;10,681944
1684;"Æbeltoft";"no";0;0;0;56,194166;10,681944
1685;"Æbeltoft";"no";0;0;0;56,194166;10,681944
1686;"Æbeltoft";"no";0;1;1;56,194166;10,681944
1687;"Æbeltoft";"no";0;0;0;56,194166;10,681944
1688;"Æbeltoft";"no";0;0;0;56,194166;10,681944
1689;"Æbeltoft";"no";0;0;0;56,194166;10,681944
1690;"Æbeltoft";"no";0;1;1;56,194166;10,681944
1691;"Æbeltoft";"no";0;0;0;56,194166;10,681944
1692;"Æbeltoft";"no";0;0;0;56,194166;10,681944
1693;"Æbeltoft";"no";0;0;0;56,194166;10,681944
1694;"Æbeltoft";"no";0;0;0;56,194166;10,681944
1695;"Æbeltoft";"no";0;0;0;56,194166;10,681944
1696;"Æbeltoft";"no";0;0;0;56,194166;10,681944
1697;"Æbeltoft";"no";0;0;0;56,194166;10,681944
1698;"Æbeltoft";"no";0;0;0;56,194166;10,681944
1699;"Æbeltoft";"no";0;0;0;56,194166;10,681944
1700;"Æbeltoft";"no";0;0;0;56,194166;10,681944
1701;"Æbeltoft";"no";0;0;0;56,194166;10,681944
1702;"Æbeltoft";"no";0;0;0;56,194166;10,681944
1703;"Æbeltoft";"no";0;0;0;56,194166;10,681944
1704;"Æbeltoft";"no";0;0;0;56,194166;10,681944
1705;"Æbeltoft";"no";0;0;0;56,194166;10,681944
1706;"Æbeltoft";"no";0;0;0;56,194166;10,681944
1707;"Æbeltoft";"no";0;0;0;56,194166;10,681944
1708;"Æbeltoft";"no";0;0;0;56,194166;10,681944
1709;"Æbeltoft";"no";0;0;0;56,194166;10,681944
1710;"Æbeltoft";"no";0;0;0;56,194166;10,681944
1711;"Æbeltoft";"no";0;0;0;56,194166;10,681944
1712;"Æbeltoft";"no";0;0;0;56,194166;10,681944
1713;"Æbeltoft";"no";0;0;0;56,194166;10,681944
1714;"Æbeltoft";"no";0;0;0;56,194166;10,681944
1715;"Æbeltoft";"no";0;0;0;56,194166;10,681944
1716;"Æbeltoft";"no";0;0;0;56,194166;10,681944
1717;"Æbeltoft";"no";1;0;1;56,194166;10,681944
1718;"Æbeltoft";"no";0;0;0;56,194166;10,681944
1719;"Æbeltoft";"no";0;0;0;56,194166;10,681944
1720;"Æbeltoft";"no";0;1;1;56,194166;10,681944
1721;"Æbeltoft";"no";0;0;0;56,194166;10,681944
1722;"Æbeltoft";"no";0;0;0;56,194166;10,681944
1723;"Æbeltoft";"no";0;0;0;56,194166;10,681944
1724;"Æbeltoft";"no";0;1;1;56,194166;10,681944
1725;"Æbeltoft";"no";0;0;0;56,194166;10,681944
1726;"Æbeltoft";"no";0;0;0;56,194166;10,681944
1727;"Æbeltoft";"no";0;0;0;56,194166;10,681944
1728;"Æbeltoft";"no";0;0;0;56,194166;10,681944
1729;"Æbeltoft";"no";0;0;0;56,194166;10,681944
1730;"Æbeltoft";"no";0;0;0;56,194166;10,681944
1731;"Æbeltoft";"no";0;1;1;56,194166;10,681944
1732;"Æbeltoft";"no";0;1;1;56,194166;10,681944
1733;"Æbeltoft";"no";0;0;0;56,194166;10,681944
1734;"Æbeltoft";"no";0;1;1;56,194166;10,681944
1735;"Æbeltoft";"no";0;0;0;56,194166;10,681944
1736;"Æbeltoft";"no";0;0;0;56,194166;10,681944
1737;"Æbeltoft";"no";0;0;0;56,194166;10,681944
1738;"Æbeltoft";"no";0;1;1;56,194166;10,681944
1739;"Æbeltoft";"no";0;0;0;56,194166;10,681944
1740;"Æbeltoft";"no";0;0;0;56,194166;10,681944
1741;"Æbeltoft";"no";0;0;0;56,194166;10,681944
1742;"Æbeltoft";"no";0;0;0;56,194166;10,681944
1743;"Æbeltoft";"no";0;0;0;56,194166;10,681944
1744;"Æbeltoft";"no";0;0;0;56,194166;10,681944
1745;"Æbeltoft";"no";0;0;0;56,194166;10,681944
1746;"Æbeltoft";"no";0;1;1;56,194166;10,681944
1747;"Æbeltoft";"no";0;0;0;56,194166;10,681944
1748;"Æbeltoft";"no";0;0;0;56,194166;10,681944
1749;"Æbeltoft";"no";0;0;0;56,194166;10,681944
1750;"Æbeltoft";"no";0;1;1;56,194166;10,681944
1751;"Æbeltoft";"no";0;0;0;56,194166;10,681944
1752;"Æbeltoft";"no";0;0;0;56,194166;10,681944
1753;"Æbeltoft";"no";0;0;0;56,194166;10,681944
1754;"Æbeltoft";"no";0;0;0;56,194166;10,681944
1755;"Æbeltoft";"no";0;0;0;56,194166;10,681944
1756;"Æbeltoft";"no";0;0;0;56,194166;10,681944
1757;"Æbeltoft";"no";0;0;0;56,194166;10,681944
1758;"Æbeltoft";"no";0;0;0;56,194166;10,681944
1759;"Æbeltoft";"no";0;0;0;56,194166;10,681944
1760;"Æbeltoft";"no";0;0;0;56,194166;10,681944
1761;"Æbeltoft";"no";1;1;2;56,194166;10,681944
1762;"Æbeltoft";"no";0;0;0;56,194166;10,681944
1763;"Æbeltoft";"no";0;1;1;56,194166;10,681944
1764;"Æbeltoft";"no";0;0;0;56,194166;10,681944
1765;"Æbeltoft";"no";1;0;1;56,194166;10,681944
1766;"Æbeltoft";"no";0;1;1;56,194166;10,681944
1767;"Æbeltoft";"no";0;0;0;56,194166;10,681944
1768;"Æbeltoft";"no";0;1;1;56,194166;10,681944
1769;"Æbeltoft";"no";1;0;1;56,194166;10,681944
1770;"Æbeltoft";"no";0;0;0;56,194166;10,681944
1771;"Æbeltoft";"no";1;2;3;56,194166;10,681944
1772;"Æbeltoft";"no";0;0;0;56,194166;10,681944
1773;"Æbeltoft";"no";0;0;0;56,194166;10,681944
1774;"Æbeltoft";"no";0;1;1;56,194166;10,681944
1775;"Æbeltoft";"no";0;0;0;56,194166;10,681944
1776;"Æbeltoft";"no";0;0;0;56,194166;10,681944
1777;"Æbeltoft";"no";0;0;0;56,194166;10,681944
1778;"Æbeltoft";"no";0;0;0;56,194166;10,681944
1779;"Æbeltoft";"no";0;0;0;56,194166;10,681944
1780;"Æbeltoft";"no";0;0;0;56,194166;10,681944
1781;"Æbeltoft";"no";0;0;0;56,194166;10,681944
1782;"Æbeltoft";"no";0;0;0;56,194166;10,681944
1783;"Æbeltoft";"no";0;0;0;56,194166;10,681944
1784;"Æbeltoft";"no";0;0;0;56,194166;10,681944
1785;"Æbeltoft";"no";1;0;1;56,194166;10,681944
1786;"Æbeltoft";"no";0;0;0;56,194166;10,681944
1787;"Æbeltoft";"no";0;0;0;56,194166;10,681944
1788;"Æbeltoft";"no";0;0;0;56,194166;10,681944
1789;"Æbeltoft";"no";0;0;0;56,194166;10,681944
1790;"Æbeltoft";"no";0;0;0;56,194166;10,681944
1791;"Æbeltoft";"no";0;0;0;56,194166;10,681944
1792;"Æbeltoft";"no";0;0;0;56,194166;10,681944
1793;"Æbeltoft";"no";0;0;0;56,194166;10,681944
1794;"Æbeltoft";"no";0;0;0;56,194166;10,681944
1795;"Æbeltoft";"no";0;0;0;56,194166;10,681944
1796;"Æbeltoft";"no";0;0;0;56,194166;10,681944
1797;"Æbeltoft";"no";0;0;0;56,194166;10,681944
1798;"Æbeltoft";"no";0;0;0;56,194166;10,681944
1799;"Æbeltoft";"no";0;0;0;56,194166;10,681944
1800;"Æbeltoft";"no";100;21;121;56,194166;10,681944
1801;"Æbeltoft";"no";14;3;17;56,194166;10,681944
1802;"Æbeltoft";"no";3;0;3;56,194166;10,681944
1803;"Æbeltoft";"no";14;9;23;56,194166;10,681944
1804;"Æbeltoft";"no";5;0;5;56,194166;10,681944
1805;"Æbeltoft";"no";4;3;7;56,194166;10,681944
1806;"Æbeltoft";"no";1;0;1;56,194166;10,681944
1807;"Æbeltoft";"no";4;2;6;56,194166;10,681944
1808;"Æbeltoft";"no";0;0;0;56,194166;10,681944
1809;"Æbeltoft";"no";0;0;0;56,194166;10,681944
1810;"Æbeltoft";"no";0;0;0;56,194166;10,681944
1811;"Æbeltoft";"no";0;0;0;56,194166;10,681944
1812;"Æbeltoft";"no";0;0;0;56,194166;10,681944
1813;"Æbeltoft";"no";0;0;0;56,194166;10,681944
1814;"Æbeltoft";"no";0;0;0;56,194166;10,681944
1815;"Æbeltoft";"no";0;0;0;56,194166;10,681944
1816;"Æbeltoft";"no";1;1;2;56,194166;10,681944
1817;"Æbeltoft";"no";0;0;0;56,194166;10,681944
1818;"Æbeltoft";"no";1;1;2;56,194166;10,681944
1819;"Æbeltoft";"no";0;0;0;56,194166;10,681944
1820;"Æbeltoft";"no";0;0;0;56,194166;10,681944
1821;"Æbeltoft";"no";0;0;0;56,194166;10,681944
1822;"Æbeltoft";"no";0;0;0;56,194166;10,681944
1823;"Æbeltoft";"no";0;0;0;56,194166;10,681944
1824;"Æbeltoft";"no";0;0;0;56,194166;10,681944
1825;"Æbeltoft";"no";0;1;1;56,194166;10,681944
1826;"Æbeltoft";"no";0;1;1;56,194166;10,681944
1827;"Æbeltoft";"no";0;1;1;56,194166;10,681944
1828;"Æbeltoft";"no";0;1;1;56,194166;10,681944
1829;"Æbeltoft";"no";1;0;1;56,194166;10,681944
1830;"Æbeltoft";"no";2;0;2;56,194166;10,681944
1831;"Æbeltoft";"no";0;0;0;56,194166;10,681944
1832;"Æbeltoft";"no";0;0;0;56,194166;10,681944
1833;"Æbeltoft";"no";0;0;0;56,194166;10,681944
1834;"Æbeltoft";"no";1;0;1;56,194166;10,681944
1835;"Æbeltoft";"no";0;0;0;56,194166;10,681944
1836;"Æbeltoft";"no";0;0;0;56,194166;10,681944
1837;"Æbeltoft";"no";0;0;0;56,194166;10,681944
1838;"Æbeltoft";"no";0;0;0;56,194166;10,681944
1839;"Æbeltoft";"no";0;0;0;56,194166;10,681944
1840;"Æbeltoft";"no";0;0;0;56,194166;10,681944
1841;"Æbeltoft";"no";0;0;0;56,194166;10,681944
1842;"Æbeltoft";"no";0;1;1;56,194166;10,681944
1843;"Æbeltoft";"no";1;0;1;56,194166;10,681944
1844;"Æbeltoft";"no";1;1;2;56,194166;10,681944
1845;"Æbeltoft";"no";3;0;3;56,194166;10,681944
1846;"Æbeltoft";"no";2;1;3;56,194166;10,681944
1847;"Æbeltoft";"no";5;0;5;56,194166;10,681944
1848;"Æbeltoft";"no";1;2;3;56,194166;10,681944
1849;"Æbeltoft";"no";0;2;2;56,194166;10,681944
1850;"Æbeltoft";"no";3;1;4;56,194166;10,681944
1851;"Æbeltoft";"no";1;3;4;56,194166;10,681944
1852;"Æbeltoft";"no";4;1;5;56,194166;10,681944
1853;"Æbeltoft";"no";2;4;6;56,194166;10,681944
1854;"Æbeltoft";"no";4;1;5;56,194166;10,681944
1855;"Æbeltoft";"no";4;0;4;56,194166;10,681944
1856;"Æbeltoft";"no";8;2;10;56,194166;10,681944
1857;"Æbeltoft";"no";0;0;0;56,194166;10,681944
1634;"Aarhus";"no";0;0;0;56,15;10,216666
1635;"Aarhus";"no";1;0;1;56,15;10,216666
1636;"Aarhus";"no";0;0;0;56,15;10,216666
1637;"Aarhus";"no";1;0;1;56,15;10,216666
1638;"Aarhus";"no";1;0;1;56,15;10,216666
1639;"Aarhus";"no";3;1;4;56,15;10,216666
1640;"Aarhus";"no";3;0;3;56,15;10,216666
1641;"Aarhus";"no";7;0;7;56,15;10,216666
1642;"Aarhus";"no";3;0;3;56,15;10,216666
1643;"Aarhus";"no";8;3;11;56,15;10,216666
1644;"Aarhus";"no";0;0;0;56,15;10,216666
1645;"Aarhus";"no";0;0;0;56,15;10,216666
1646;"Aarhus";"no";2;0;2;56,15;10,216666
1647;"Aarhus";"no";3;0;3;56,15;10,216666
1648;"Aarhus";"no";0;0;0;56,15;10,216666
1649;"Aarhus";"no";1;0;1;56,15;10,216666
1650;"Aarhus";"no";1;0;1;56,15;10,216666
1651;"Aarhus";"no";0;0;0;56,15;10,216666
1652;"Aarhus";"no";1;0;1;56,15;10,216666
1653;"Aarhus";"no";0;0;0;56,15;10,216666
1654;"Aarhus";"no";0;0;0;56,15;10,216666
1655;"Aarhus";"no";0;0;0;56,15;10,216666
1656;"Aarhus";"no";0;0;0;56,15;10,216666
1657;"Aarhus";"no";0;0;0;56,15;10,216666
1658;"Aarhus";"no";0;0;0;56,15;10,216666
1659;"Aarhus";"no";0;0;0;56,15;10,216666
1660;"Aarhus";"no";1;0;1;56,15;10,216666
1661;"Aarhus";"no";1;0;1;56,15;10,216666
1662;"Aarhus";"no";0;0;0;56,15;10,216666
1663;"Aarhus";"no";0;0;0;56,15;10,216666
1664;"Aarhus";"no";0;0;0;56,15;10,216666
1665;"Aarhus";"no";1;0;1;56,15;10,216666
1666;"Aarhus";"no";1;0;1;56,15;10,216666
1667;"Aarhus";"no";2;1;3;56,15;10,216666
1668;"Aarhus";"no";2;0;2;56,15;10,216666
1669;"Aarhus";"no";0;0;0;56,15;10,216666
1670;"Aarhus";"no";0;1;1;56,15;10,216666
1671;"Aarhus";"no";0;1;1;56,15;10,216666
1672;"Aarhus";"no";1;0;1;56,15;10,216666
1673;"Aarhus";"no";1;0;1;56,15;10,216666
1674;"Aarhus";"no";0;0;0;56,15;10,216666
1675;"Aarhus";"no";0;0;0;56,15;10,216666
1676;"Aarhus";"no";0;0;0;56,15;10,216666
1677;"Aarhus";"no";0;0;0;56,15;10,216666
1678;"Aarhus";"no";0;1;1;56,15;10,216666
1679;"Aarhus";"no";0;0;0;56,15;10,216666
1680;"Aarhus";"no";1;0;1;56,15;10,216666
1681;"Aarhus";"no";0;0;0;56,15;10,216666
1682;"Aarhus";"no";0;1;1;56,15;10,216666
1683;"Aarhus";"no";0;1;1;56,15;10,216666
1684;"Aarhus";"no";0;1;1;56,15;10,216666
1685;"Aarhus";"no";5;2;7;56,15;10,216666
1686;"Aarhus";"no";1;0;1;56,15;10,216666
1687;"Aarhus";"no";0;2;2;56,15;10,216666
1688;"Aarhus";"no";0;1;1;56,15;10,216666
1689;"Aarhus";"no";0;0;0;56,15;10,216666
1690;"Aarhus";"no";0;1;1;56,15;10,216666
1691;"Aarhus";"no";1;2;3;56,15;10,216666
1692;"Aarhus";"no";1;1;2;56,15;10,216666
1693;"Aarhus";"no";1;1;2;56,15;10,216666
1694;"Aarhus";"no";1;3;4;56,15;10,216666
1695;"Aarhus";"no";1;1;2;56,15;10,216666
1696;"Aarhus";"no";0;4;4;56,15;10,216666
1697;"Aarhus";"no";5;6;11;56,15;10,216666
1698;"Aarhus";"no";2;1;3;56,15;10,216666
1699;"Aarhus";"no";2;1;3;56,15;10,216666
1700;"Aarhus";"no";2;2;4;56,15;10,216666
1701;"Aarhus";"no";1;2;3;56,15;10,216666
1702;"Aarhus";"no";1;3;4;56,15;10,216666
1703;"Aarhus";"no";0;2;2;56,15;10,216666
1704;"Aarhus";"no";2;2;4;56,15;10,216666
1705;"Aarhus";"no";2;4;6;56,15;10,216666
1706;"Aarhus";"no";2;2;4;56,15;10,216666
1707;"Aarhus";"no";1;2;3;56,15;10,216666
1708;"Aarhus";"no";1;1;2;56,15;10,216666
1709;"Aarhus";"no";1;1;2;56,15;10,216666
1710;"Aarhus";"no";0;0;0;56,15;10,216666
1711;"Aarhus";"no";0;0;0;56,15;10,216666
1712;"Aarhus";"no";1;0;1;56,15;10,216666
1713;"Aarhus";"no";0;0;0;56,15;10,216666
1714;"Aarhus";"no";0;0;0;56,15;10,216666
1715;"Aarhus";"no";0;1;1;56,15;10,216666
1716;"Aarhus";"no";0;0;0;56,15;10,216666
1717;"Aarhus";"no";0;0;0;56,15;10,216666
1718;"Aarhus";"no";0;0;0;56,15;10,216666
1719;"Aarhus";"no";0;0;0;56,15;10,216666
1720;"Aarhus";"no";0;1;1;56,15;10,216666
1721;"Aarhus";"no";1;1;2;56,15;10,216666
1722;"Aarhus";"no";3;4;7;56,15;10,216666
1723;"Aarhus";"no";1;1;2;56,15;10,216666
1724;"Aarhus";"no";0;1;1;56,15;10,216666
1725;"Aarhus";"no";2;3;5;56,15;10,216666
1726;"Aarhus";"no";0;2;2;56,15;10,216666
1727;"Aarhus";"no";1;6;7;56,15;10,216666
1728;"Aarhus";"no";0;3;3;56,15;10,216666
1729;"Aarhus";"no";3;5;8;56,15;10,216666
1730;"Aarhus";"no";3;3;6;56,15;10,216666
1731;"Aarhus";"no";1;3;4;56,15;10,216666
1732;"Aarhus";"no";2;2;4;56,15;10,216666
1733;"Aarhus";"no";2;3;5;56,15;10,216666
1734;"Aarhus";"no";2;3;5;56,15;10,216666
1735;"Aarhus";"no";2;3;5;56,15;10,216666
1736;"Aarhus";"no";3;4;7;56,15;10,216666
1737;"Aarhus";"no";5;3;8;56,15;10,216666
1738;"Aarhus";"no";4;6;10;56,15;10,216666
1739;"Aarhus";"no";3;2;5;56,15;10,216666
1740;"Aarhus";"no";0;4;4;56,15;10,216666
1741;"Aarhus";"no";2;5;7;56,15;10,216666
1742;"Aarhus";"no";3;5;8;56,15;10,216666
1743;"Aarhus";"no";0;2;2;56,15;10,216666
1744;"Aarhus";"no";1;1;2;56,15;10,216666
1745;"Aarhus";"no";0;2;2;56,15;10,216666
1746;"Aarhus";"no";1;7;8;56,15;10,216666
1747;"Aarhus";"no";1;6;7;56,15;10,216666
1748;"Aarhus";"no";3;6;9;56,15;10,216666
1749;"Aarhus";"no";0;4;4;56,15;10,216666
1750;"Aarhus";"no";1;5;6;56,15;10,216666
1751;"Aarhus";"no";2;4;6;56,15;10,216666
1752;"Aarhus";"no";2;3;5;56,15;10,216666
1753;"Aarhus";"no";1;2;3;56,15;10,216666
1754;"Aarhus";"no";3;5;8;56,15;10,216666
1755;"Aarhus";"no";3;3;6;56,15;10,216666
1756;"Aarhus";"no";1;4;5;56,15;10,216666
1757;"Aarhus";"no";2;3;5;56,15;10,216666
1758;"Aarhus";"no";2;1;3;56,15;10,216666
1759;"Aarhus";"no";1;2;3;56,15;10,216666
1760;"Aarhus";"no";2;2;4;56,15;10,216666
1761;"Aarhus";"no";1;3;4;56,15;10,216666
1762;"Aarhus";"no";0;1;1;56,15;10,216666
1763;"Aarhus";"no";1;1;2;56,15;10,216666
1764;"Aarhus";"no";2;2;4;56,15;10,216666
1765;"Aarhus";"no";0;1;1;56,15;10,216666
1766;"Aarhus";"no";1;2;3;56,15;10,216666
1767;"Aarhus";"no";1;1;2;56,15;10,216666
1768;"Aarhus";"no";0;0;0;56,15;10,216666
1769;"Aarhus";"no";1;3;4;56,15;10,216666
1770;"Aarhus";"no";0;2;2;56,15;10,216666
1771;"Aarhus";"no";1;2;3;56,15;10,216666
1772;"Aarhus";"no";3;1;4;56,15;10,216666
1773;"Aarhus";"no";2;1;3;56,15;10,216666
1774;"Aarhus";"no";0;1;1;56,15;10,216666
1775;"Aarhus";"no";0;1;1;56,15;10,216666
1776;"Aarhus";"no";2;2;4;56,15;10,216666
1777;"Aarhus";"no";1;1;2;56,15;10,216666
1778;"Aarhus";"no";2;3;5;56,15;10,216666
1779;"Aarhus";"no";2;3;5;56,15;10,216666
1780;"Aarhus";"no";4;2;6;56,15;10,216666
1781;"Aarhus";"no";3;2;5;56,15;10,216666
1782;"Aarhus";"no";1;2;3;56,15;10,216666
1783;"Aarhus";"no";3;4;7;56,15;10,216666
1784;"Aarhus";"no";3;7;10;56,15;10,216666
1785;"Aarhus";"no";1;1;2;56,15;10,216666
1786;"Aarhus";"no";3;8;11;56,15;10,216666
1787;"Aarhus";"no";1;6;7;56,15;10,216666
1788;"Aarhus";"no";1;2;3;56,15;10,216666
1789;"Aarhus";"no";1;1;2;56,15;10,216666
1790;"Aarhus";"no";1;3;4;56,15;10,216666
1791;"Aarhus";"no";4;4;8;56,15;10,216666
1792;"Aarhus";"no";6;3;9;56,15;10,216666
1793;"Aarhus";"no";2;1;3;56,15;10,216666
1794;"Aarhus";"no";1;3;4;56,15;10,216666
1795;"Aarhus";"no";0;0;0;56,15;10,216666
1796;"Aarhus";"no";1;2;3;56,15;10,216666
1797;"Aarhus";"no";3;4;7;56,15;10,216666
1798;"Aarhus";"no";4;7;11;56,15;10,216666
1799;"Aarhus";"no";7;11;18;56,15;10,216666
1800;"Aarhus";"no";0;0;0;56,15;10,216666
1801;"Aarhus";"no";2;2;4;56,15;10,216666
1802;"Aarhus";"no";3;1;4;56,15;10,216666
1803;"Aarhus";"no";4;11;15;56,15;10,216666
1804;"Aarhus";"no";6;11;17;56,15;10,216666
1805;"Aarhus";"no";13;14;27;56,15;10,216666
1806;"Aarhus";"no";5;11;16;56,15;10,216666
1807;"Aarhus";"no";1;1;2;56,15;10,216666
1808;"Aarhus";"no";0;0;0;56,15;10,216666
1809;"Aarhus";"no";0;0;0;56,15;10,216666
1810;"Aarhus";"no";0;0;0;56,15;10,216666
1811;"Aarhus";"no";0;2;2;56,15;10,216666
1812;"Aarhus";"no";0;0;0;56,15;10,216666
1813;"Aarhus";"no";0;1;1;56,15;10,216666
1814;"Aarhus";"no";4;5;9;56,15;10,216666
1815;"Aarhus";"no";9;12;21;56,15;10,216666
1816;"Aarhus";"no";7;6;13;56,15;10,216666
1817;"Aarhus";"no";6;3;9;56,15;10,216666
1818;"Aarhus";"no";4;2;6;56,15;10,216666
1819;"Aarhus";"no";7;9;16;56,15;10,216666
1820;"Aarhus";"no";6;6;12;56,15;10,216666
1821;"Aarhus";"no";8;8;16;56,15;10,216666
1822;"Aarhus";"no";5;4;9;56,15;10,216666
1823;"Aarhus";"no";2;6;8;56,15;10,216666
1824;"Aarhus";"no";4;2;6;56,15;10,216666
1825;"Aarhus";"no";1;4;5;56,15;10,216666
1826;"Aarhus";"no";6;6;12;56,15;10,216666
1827;"Aarhus";"no";7;7;14;56,15;10,216666
1828;"Aarhus";"no";10;3;13;56,15;10,216666
1829;"Aarhus";"no";10;9;19;56,15;10,216666
1830;"Aarhus";"no";19;5;24;56,15;10,216666
1831;"Aarhus";"no";23;18;41;56,15;10,216666
1832;"Aarhus";"no";13;7;20;56,15;10,216666
1833;"Aarhus";"no";6;5;11;56,15;10,216666
1834;"Aarhus";"no";10;6;16;56,15;10,216666
1835;"Aarhus";"no";12;4;16;56,15;10,216666
1836;"Aarhus";"no";6;2;8;56,15;10,216666
1837;"Aarhus";"no";10;2;12;56,15;10,216666
1838;"Aarhus";"no";11;4;15;56,15;10,216666
1839;"Aarhus";"no";6;4;10;56,15;10,216666
1840;"Aarhus";"no";7;4;11;56,15;10,216666
1841;"Aarhus";"no";8;9;17;56,15;10,216666
1842;"Aarhus";"no";22;6;28;56,15;10,216666
1843;"Aarhus";"no";31;11;42;56,15;10,216666
1844;"Aarhus";"no";28;10;38;56,15;10,216666
1845;"Aarhus";"no";38;9;47;56,15;10,216666
1846;"Aarhus";"no";51;13;64;56,15;10,216666
1847;"Aarhus";"no";67;19;86;56,15;10,216666
1848;"Aarhus";"no";35;17;52;56,15;10,216666
1849;"Aarhus";"no";34;16;50;56,15;10,216666
1850;"Aarhus";"no";65;19;84;56,15;10,216666
1851;"Aarhus";"no";63;21;84;56,15;10,216666
1852;"Aarhus";"no";56;11;67;56,15;10,216666
1853;"Aarhus";"no";41;22;63;56,15;10,216666
1854;"Aarhus";"no";53;21;74;56,15;10,216666
1855;"Aarhus";"no";46;19;65;56,15;10,216666
1856;"Aarhus";"no";87;29;116;56,15;10,216666
1857;"Aarhus";"no";5;2;7;56,15;10,216666
1634;"Aars";"no";0;0;0;56,803888;9,514166
1635;"Aars";"no";1;0;1;56,803888;9,514166
1636;"Aars";"no";1;0;1;56,803888;9,514166
1637;"Aars";"no";9;0;9;56,803888;9,514166
1638;"Aars";"no";2;0;2;56,803888;9,514166
1639;"Aars";"no";3;0;3;56,803888;9,514166
1640;"Aars";"no";1;0;1;56,803888;9,514166
1641;"Aars";"no";4;0;4;56,803888;9,514166
1642;"Aars";"no";1;0;1;56,803888;9,514166
1643;"Aars";"no";3;0;3;56,803888;9,514166
1644;"Aars";"no";0;1;1;56,803888;9,514166
1645;"Aars";"no";1;0;1;56,803888;9,514166
1646;"Aars";"no";2;0;2;56,803888;9,514166
1647;"Aars";"no";1;0;1;56,803888;9,514166
1648;"Aars";"no";0;0;0;56,803888;9,514166
1649;"Aars";"no";0;0;0;56,803888;9,514166
1650;"Aars";"no";0;0;0;56,803888;9,514166
1651;"Aars";"no";1;0;1;56,803888;9,514166
1652;"Aars";"no";0;0;0;56,803888;9,514166
1653;"Aars";"no";0;0;0;56,803888;9,514166
1654;"Aars";"no";0;0;0;56,803888;9,514166
1655;"Aars";"no";0;0;0;56,803888;9,514166
1656;"Aars";"no";1;1;2;56,803888;9,514166
1657;"Aars";"no";0;0;0;56,803888;9,514166
1658;"Aars";"no";0;0;0;56,803888;9,514166
1659;"Aars";"no";0;0;0;56,803888;9,514166
1660;"Aars";"no";0;0;0;56,803888;9,514166
1661;"Aars";"no";0;0;0;56,803888;9,514166
1662;"Aars";"no";0;0;0;56,803888;9,514166
1663;"Aars";"no";0;1;1;56,803888;9,514166
1664;"Aars";"no";1;0;1;56,803888;9,514166
1665;"Aars";"no";1;1;2;56,803888;9,514166
1666;"Aars";"no";0;0;0;56,803888;9,514166
1667;"Aars";"no";2;1;3;56,803888;9,514166
1668;"Aars";"no";0;1;1;56,803888;9,514166
1669;"Aars";"no";0;0;0;56,803888;9,514166
1670;"Aars";"no";0;0;0;56,803888;9,514166
1671;"Aars";"no";0;1;1;56,803888;9,514166
1672;"Aars";"no";0;1;1;56,803888;9,514166
1673;"Aars";"no";1;2;3;56,803888;9,514166
1674;"Aars";"no";3;1;4;56,803888;9,514166
1675;"Aars";"no";0;0;0;56,803888;9,514166
1676;"Aars";"no";0;0;0;56,803888;9,514166
1677;"Aars";"no";0;0;0;56,803888;9,514166
1678;"Aars";"no";0;0;0;56,803888;9,514166
1679;"Aars";"no";0;6;6;56,803888;9,514166
1680;"Aars";"no";1;1;2;56,803888;9,514166
1681;"Aars";"no";0;0;0;56,803888;9,514166
1682;"Aars";"no";0;0;0;56,803888;9,514166
1683;"Aars";"no";0;1;1;56,803888;9,514166
1684;"Aars";"no";0;0;0;56,803888;9,514166
1685;"Aars";"no";3;14;17;56,803888;9,514166
1686;"Aars";"no";0;1;1;56,803888;9,514166
1687;"Aars";"no";0;1;1;56,803888;9,514166
1688;"Aars";"no";0;1;1;56,803888;9,514166
1689;"Aars";"no";2;0;2;56,803888;9,514166
1690;"Aars";"no";0;0;0;56,803888;9,514166
1691;"Aars";"no";1;2;3;56,803888;9,514166
1692;"Aars";"no";1;0;1;56,803888;9,514166
1693;"Aars";"no";0;0;0;56,803888;9,514166
1694;"Aars";"no";0;1;1;56,803888;9,514166
1695;"Aars";"no";0;0;0;56,803888;9,514166
1696;"Aars";"no";0;0;0;56,803888;9,514166
1697;"Aars";"no";0;0;0;56,803888;9,514166
1698;"Aars";"no";0;0;0;56,803888;9,514166
1699;"Aars";"no";0;0;0;56,803888;9,514166
1700;"Aars";"no";0;0;0;56,803888;9,514166
1701;"Aars";"no";0;0;0;56,803888;9,514166
1702;"Aars";"no";0;0;0;56,803888;9,514166
1703;"Aars";"no";0;0;0;56,803888;9,514166
1704;"Aars";"no";0;0;0;56,803888;9,514166
1705;"Aars";"no";0;0;0;56,803888;9,514166
1706;"Aars";"no";0;0;0;56,803888;9,514166
1707;"Aars";"no";0;0;0;56,803888;9,514166
1708;"Aars";"no";0;0;0;56,803888;9,514166
1709;"Aars";"no";0;0;0;56,803888;9,514166
1710;"Aars";"no";0;0;0;56,803888;9,514166
1711;"Aars";"no";0;0;0;56,803888;9,514166
1712;"Aars";"no";0;0;0;56,803888;9,514166
1713;"Aars";"no";0;1;1;56,803888;9,514166
1714;"Aars";"no";0;0;0;56,803888;9,514166
1715;"Aars";"no";0;0;0;56,803888;9,514166
1716;"Aars";"no";0;0;0;56,803888;9,514166
1717;"Aars";"no";0;0;0;56,803888;9,514166
1718;"Aars";"no";0;0;0;56,803888;9,514166
1719;"Aars";"no";0;0;0;56,803888;9,514166
1720;"Aars";"no";0;0;0;56,803888;9,514166
1721;"Aars";"no";0;0;0;56,803888;9,514166
1722;"Aars";"no";0;0;0;56,803888;9,514166
1723;"Aars";"no";0;0;0;56,803888;9,514166
1724;"Aars";"no";0;0;0;56,803888;9,514166
1725;"Aars";"no";0;0;0;56,803888;9,514166
1726;"Aars";"no";0;0;0;56,803888;9,514166
1727;"Aars";"no";0;0;0;56,803888;9,514166
1728;"Aars";"no";0;0;0;56,803888;9,514166
1729;"Aars";"no";0;0;0;56,803888;9,514166
1730;"Aars";"no";0;0;0;56,803888;9,514166
1731;"Aars";"no";0;0;0;56,803888;9,514166
1732;"Aars";"no";0;0;0;56,803888;9,514166
1733;"Aars";"no";0;0;0;56,803888;9,514166
1734;"Aars";"no";0;0;0;56,803888;9,514166
1735;"Aars";"no";0;0;0;56,803888;9,514166
1736;"Aars";"no";0;0;0;56,803888;9,514166
1737;"Aars";"no";0;0;0;56,803888;9,514166
1738;"Aars";"no";0;0;0;56,803888;9,514166
1739;"Aars";"no";0;0;0;56,803888;9,514166
1740;"Aars";"no";0;0;0;56,803888;9,514166
1741;"Aars";"no";0;0;0;56,803888;9,514166
1742;"Aars";"no";0;0;0;56,803888;9,514166
1743;"Aars";"no";0;0;0;56,803888;9,514166
1744;"Aars";"no";0;0;0;56,803888;9,514166
1745;"Aars";"no";0;0;0;56,803888;9,514166
1746;"Aars";"no";0;0;0;56,803888;9,514166
1747;"Aars";"no";0;0;0;56,803888;9,514166
1748;"Aars";"no";0;0;0;56,803888;9,514166
1749;"Aars";"no";0;0;0;56,803888;9,514166
1750;"Aars";"no";0;0;0;56,803888;9,514166
1751;"Aars";"no";0;0;0;56,803888;9,514166
1752;"Aars";"no";0;0;0;56,803888;9,514166
1753;"Aars";"no";0;0;0;56,803888;9,514166
1754;"Aars";"no";0;0;0;56,803888;9,514166
1755;"Aars";"no";0;0;0;56,803888;9,514166
1756;"Aars";"no";0;0;0;56,803888;9,514166
1757;"Aars";"no";0;0;0;56,803888;9,514166
1758;"Aars";"no";0;0;0;56,803888;9,514166
1759;"Aars";"no";0;0;0;56,803888;9,514166
1760;"Aars";"no";0;0;0;56,803888;9,514166
1761;"Aars";"no";0;0;0;56,803888;9,514166
1762;"Aars";"no";0;0;0;56,803888;9,514166
1763;"Aars";"no";0;0;0;56,803888;9,514166
1764;"Aars";"no";0;0;0;56,803888;9,514166
1765;"Aars";"no";0;0;0;56,803888;9,514166
1766;"Aars";"no";0;0;0;56,803888;9,514166
1767;"Aars";"no";0;0;0;56,803888;9,514166
1768;"Aars";"no";0;0;0;56,803888;9,514166
1769;"Aars";"no";0;0;0;56,803888;9,514166
1770;"Aars";"no";0;0;0;56,803888;9,514166
1771;"Aars";"no";0;0;0;56,803888;9,514166
1772;"Aars";"no";0;0;0;56,803888;9,514166
1773;"Aars";"no";0;0;0;56,803888;9,514166
1774;"Aars";"no";0;0;0;56,803888;9,514166
1775;"Aars";"no";0;0;0;56,803888;9,514166
1776;"Aars";"no";0;0;0;56,803888;9,514166
1777;"Aars";"no";0;0;0;56,803888;9,514166
1778;"Aars";"no";0;0;0;56,803888;9,514166
1779;"Aars";"no";0;0;0;56,803888;9,514166
1780;"Aars";"no";0;0;0;56,803888;9,514166
1781;"Aars";"no";0;0;0;56,803888;9,514166
1782;"Aars";"no";0;0;0;56,803888;9,514166
1783;"Aars";"no";0;0;0;56,803888;9,514166
1784;"Aars";"no";0;0;0;56,803888;9,514166
1785;"Aars";"no";0;0;0;56,803888;9,514166
1786;"Aars";"no";0;0;0;56,803888;9,514166
1787;"Aars";"no";0;0;0;56,803888;9,514166
1788;"Aars";"no";0;0;0;56,803888;9,514166
1789;"Aars";"no";0;0;0;56,803888;9,514166
1790;"Aars";"no";0;0;0;56,803888;9,514166
1791;"Aars";"no";0;0;0;56,803888;9,514166
1792;"Aars";"no";0;0;0;56,803888;9,514166
1793;"Aars";"no";0;0;0;56,803888;9,514166
1794;"Aars";"no";0;0;0;56,803888;9,514166
1795;"Aars";"no";0;0;0;56,803888;9,514166
1796;"Aars";"no";0;0;0;56,803888;9,514166
1797;"Aars";"no";0;0;0;56,803888;9,514166
1798;"Aars";"no";0;0;0;56,803888;9,514166
1799;"Aars";"no";0;0;0;56,803888;9,514166
1800;"Aars";"no";0;0;0;56,803888;9,514166
1801;"Aars";"no";0;0;0;56,803888;9,514166
1802;"Aars";"no";0;0;0;56,803888;9,514166
1803;"Aars";"no";0;0;0;56,803888;9,514166
1804;"Aars";"no";0;0;0;56,803888;9,514166
1805;"Aars";"no";0;0;0;56,803888;9,514166
1806;"Aars";"no";0;0;0;56,803888;9,514166
1807;"Aars";"no";0;0;0;56,803888;9,514166
1808;"Aars";"no";0;0;0;56,803888;9,514166
1809;"Aars";"no";0;0;0;56,803888;9,514166
1810;"Aars";"no";0;0;0;56,803888;9,514166
1811;"Aars";"no";0;0;0;56,803888;9,514166
1812;"Aars";"no";0;0;0;56,803888;9,514166
1813;"Aars";"no";0;0;0;56,803888;9,514166
1814;"Aars";"no";0;0;0;56,803888;9,514166
1815;"Aars";"no";0;0;0;56,803888;9,514166
1816;"Aars";"no";0;0;0;56,803888;9,514166
1817;"Aars";"no";0;0;0;56,803888;9,514166
1818;"Aars";"no";0;0;0;56,803888;9,514166
1819;"Aars";"no";0;0;0;56,803888;9,514166
1820;"Aars";"no";0;0;0;56,803888;9,514166
1821;"Aars";"no";0;0;0;56,803888;9,514166
1822;"Aars";"no";0;0;0;56,803888;9,514166
1823;"Aars";"no";0;0;0;56,803888;9,514166
1824;"Aars";"no";0;0;0;56,803888;9,514166
1825;"Aars";"no";0;0;0;56,803888;9,514166
1826;"Aars";"no";0;0;0;56,803888;9,514166
1827;"Aars";"no";0;0;0;56,803888;9,514166
1828;"Aars";"no";0;0;0;56,803888;9,514166
1829;"Aars";"no";0;0;0;56,803888;9,514166
1830;"Aars";"no";0;0;0;56,803888;9,514166
1831;"Aars";"no";0;0;0;56,803888;9,514166
1832;"Aars";"no";0;0;0;56,803888;9,514166
1833;"Aars";"no";0;0;0;56,803888;9,514166
1834;"Aars";"no";0;0;0;56,803888;9,514166
1835;"Aars";"no";0;0;0;56,803888;9,514166
1836;"Aars";"no";0;0;0;56,803888;9,514166
1837;"Aars";"no";0;0;0;56,803888;9,514166
1838;"Aars";"no";0;0;0;56,803888;9,514166
1839;"Aars";"no";0;0;0;56,803888;9,514166
1840;"Aars";"no";0;0;0;56,803888;9,514166
1841;"Aars";"no";0;0;0;56,803888;9,514166
1842;"Aars";"no";0;0;0;56,803888;9,514166
1843;"Aars";"no";0;0;0;56,803888;9,514166
1844;"Aars";"no";0;0;0;56,803888;9,514166
1845;"Aars";"no";0;0;0;56,803888;9,514166
1846;"Aars";"no";0;0;0;56,803888;9,514166
1847;"Aars";"no";0;0;0;56,803888;9,514166
1848;"Aars";"no";0;0;0;56,803888;9,514166
1849;"Aars";"no";0;0;0;56,803888;9,514166
1850;"Aars";"no";0;0;0;56,803888;9,514166
1851;"Aars";"no";0;0;0;56,803888;9,514166
1852;"Aars";"no";0;0;0;56,803888;9,514166
1853;"Aars";"no";0;0;0;56,803888;9,514166
1854;"Aars";"no";0;0;0;56,803888;9,514166
1855;"Aars";"no";0;0;0;56,803888;9,514166
1856;"Aars";"no";0;0;0;56,803888;9,514166
1857;"Aars";"no";0;0;0;56,803888;9,514166
1634;"Amager";"no";0;0;0;55,616666;12,616666
1635;"Amager";"no";3;0;3;55,616666;12,616666
1636;"Amager";"no";0;0;0;55,616666;12,616666
1637;"Amager";"no";2;0;2;55,616666;12,616666
1638;"Amager";"no";2;0;2;55,616666;12,616666
1639;"Amager";"no";2;0;2;55,616666;12,616666
1640;"Amager";"no";1;0;1;55,616666;12,616666
1641;"Amager";"no";2;0;2;55,616666;12,616666
1642;"Amager";"no";0;0;0;55,616666;12,616666
1643;"Amager";"no";0;0;0;55,616666;12,616666
1644;"Amager";"no";0;0;0;55,616666;12,616666
1645;"Amager";"no";0;0;0;55,616666;12,616666
1646;"Amager";"no";0;0;0;55,616666;12,616666
1647;"Amager";"no";1;0;1;55,616666;12,616666
1648;"Amager";"no";2;0;2;55,616666;12,616666
1649;"Amager";"no";0;0;0;55,616666;12,616666
1650;"Amager";"no";0;1;1;55,616666;12,616666
1651;"Amager";"no";1;1;2;55,616666;12,616666
1652;"Amager";"no";0;0;0;55,616666;12,616666
1653;"Amager";"no";0;0;0;55,616666;12,616666
1654;"Amager";"no";0;0;0;55,616666;12,616666
1655;"Amager";"no";0;0;0;55,616666;12,616666
1656;"Amager";"no";0;0;0;55,616666;12,616666
1657;"Amager";"no";0;0;0;55,616666;12,616666
1658;"Amager";"no";0;0;0;55,616666;12,616666
1659;"Amager";"no";0;0;0;55,616666;12,616666
1660;"Amager";"no";0;0;0;55,616666;12,616666
1661;"Amager";"no";0;0;0;55,616666;12,616666
1662;"Amager";"no";0;0;0;55,616666;12,616666
1663;"Amager";"no";0;0;0;55,616666;12,616666
1664;"Amager";"no";0;0;0;55,616666;12,616666
1665;"Amager";"no";0;0;0;55,616666;12,616666
1666;"Amager";"no";0;0;0;55,616666;12,616666
1667;"Amager";"no";0;0;0;55,616666;12,616666
1668;"Amager";"no";0;0;0;55,616666;12,616666
1669;"Amager";"no";0;1;1;55,616666;12,616666
1670;"Amager";"no";0;0;0;55,616666;12,616666
1671;"Amager";"no";0;1;1;55,616666;12,616666
1672;"Amager";"no";0;0;0;55,616666;12,616666
1673;"Amager";"no";0;0;0;55,616666;12,616666
1674;"Amager";"no";0;0;0;55,616666;12,616666
1675;"Amager";"no";0;0;0;55,616666;12,616666
1676;"Amager";"no";0;0;0;55,616666;12,616666
1677;"Amager";"no";0;0;0;55,616666;12,616666
1678;"Amager";"no";1;0;1;55,616666;12,616666
1679;"Amager";"no";0;1;1;55,616666;12,616666
1680;"Amager";"no";0;1;1;55,616666;12,616666
1681;"Amager";"no";0;0;0;55,616666;12,616666
1682;"Amager";"no";0;0;0;55,616666;12,616666
1683;"Amager";"no";0;1;1;55,616666;12,616666
1684;"Amager";"no";0;0;0;55,616666;12,616666
1685;"Amager";"no";0;0;0;55,616666;12,616666
1686;"Amager";"no";0;0;0;55,616666;12,616666
1687;"Amager";"no";0;0;0;55,616666;12,616666
1688;"Amager";"no";0;1;1;55,616666;12,616666
1689;"Amager";"no";0;1;1;55,616666;12,616666
1690;"Amager";"no";0;0;0;55,616666;12,616666
1691;"Amager";"no";0;0;0;55,616666;12,616666
1692;"Amager";"no";0;0;0;55,616666;12,616666
1693;"Amager";"no";0;0;0;55,616666;12,616666
1694;"Amager";"no";0;0;0;55,616666;12,616666
1695;"Amager";"no";0;0;0;55,616666;12,616666
1696;"Amager";"no";0;0;0;55,616666;12,616666
1697;"Amager";"no";0;0;0;55,616666;12,616666
1698;"Amager";"no";0;0;0;55,616666;12,616666
1699;"Amager";"no";0;0;0;55,616666;12,616666
1700;"Amager";"no";0;0;0;55,616666;12,616666
1701;"Amager";"no";0;0;0;55,616666;12,616666
1702;"Amager";"no";0;0;0;55,616666;12,616666
1703;"Amager";"no";0;0;0;55,616666;12,616666
1704;"Amager";"no";0;0;0;55,616666;12,616666
1705;"Amager";"no";0;0;0;55,616666;12,616666
1706;"Amager";"no";0;0;0;55,616666;12,616666
1707;"Amager";"no";0;0;0;55,616666;12,616666
1708;"Amager";"no";0;0;0;55,616666;12,616666
1709;"Amager";"no";0;0;0;55,616666;12,616666
1710;"Amager";"no";0;0;0;55,616666;12,616666
1711;"Amager";"no";0;0;0;55,616666;12,616666
1712;"Amager";"no";0;0;0;55,616666;12,616666
1713;"Amager";"no";0;0;0;55,616666;12,616666
1714;"Amager";"no";0;0;0;55,616666;12,616666
1715;"Amager";"no";0;0;0;55,616666;12,616666
1716;"Amager";"no";0;0;0;55,616666;12,616666
1717;"Amager";"no";0;0;0;55,616666;12,616666
1718;"Amager";"no";0;0;0;55,616666;12,616666
1719;"Amager";"no";0;0;0;55,616666;12,616666
1720;"Amager";"no";0;0;0;55,616666;12,616666
1721;"Amager";"no";0;0;0;55,616666;12,616666
1722;"Amager";"no";0;0;0;55,616666;12,616666
1723;"Amager";"no";0;0;0;55,616666;12,616666
1724;"Amager";"no";0;0;0;55,616666;12,616666
1725;"Amager";"no";0;0;0;55,616666;12,616666
1726;"Amager";"no";0;0;0;55,616666;12,616666
1727;"Amager";"no";0;0;0;55,616666;12,616666
1728;"Amager";"no";0;0;0;55,616666;12,616666
1729;"Amager";"no";0;0;0;55,616666;12,616666
1730;"Amager";"no";0;0;0;55,616666;12,616666
1731;"Amager";"no";0;0;0;55,616666;12,616666
1732;"Amager";"no";0;0;0;55,616666;12,616666
1733;"Amager";"no";0;0;0;55,616666;12,616666
1734;"Amager";"no";0;0;0;55,616666;12,616666
1735;"Amager";"no";0;0;0;55,616666;12,616666
1736;"Amager";"no";0;0;0;55,616666;12,616666
1737;"Amager";"no";0;0;0;55,616666;12,616666
1738;"Amager";"no";0;0;0;55,616666;12,616666
1739;"Amager";"no";0;0;0;55,616666;12,616666
1740;"Amager";"no";0;0;0;55,616666;12,616666
1741;"Amager";"no";0;0;0;55,616666;12,616666
1742;"Amager";"no";0;0;0;55,616666;12,616666
1743;"Amager";"no";0;0;0;55,616666;12,616666
1744;"Amager";"no";0;0;0;55,616666;12,616666
1745;"Amager";"no";0;0;0;55,616666;12,616666
1746;"Amager";"no";0;0;0;55,616666;12,616666
1747;"Amager";"no";0;0;0;55,616666;12,616666
1748;"Amager";"no";0;0;0;55,616666;12,616666
1749;"Amager";"no";0;0;0;55,616666;12,616666
1750;"Amager";"no";0;0;0;55,616666;12,616666
1751;"Amager";"no";0;0;0;55,616666;12,616666
1752;"Amager";"no";0;0;0;55,616666;12,616666
1753;"Amager";"no";0;0;0;55,616666;12,616666
1754;"Amager";"no";0;0;0;55,616666;12,616666
1755;"Amager";"no";0;0;0;55,616666;12,616666
1756;"Amager";"no";0;0;0;55,616666;12,616666
1757;"Amager";"no";0;0;0;55,616666;12,616666
1758;"Amager";"no";0;0;0;55,616666;12,616666
1759;"Amager";"no";0;0;0;55,616666;12,616666
1760;"Amager";"no";0;0;0;55,616666;12,616666
1761;"Amager";"no";0;0;0;55,616666;12,616666
1762;"Amager";"no";0;0;0;55,616666;12,616666
1763;"Amager";"no";0;0;0;55,616666;12,616666
1764;"Amager";"no";0;0;0;55,616666;12,616666
1765;"Amager";"no";0;0;0;55,616666;12,616666
1766;"Amager";"no";0;0;0;55,616666;12,616666
1767;"Amager";"no";0;0;0;55,616666;12,616666
1768;"Amager";"no";0;0;0;55,616666;12,616666
1769;"Amager";"no";0;0;0;55,616666;12,616666
1770;"Amager";"no";0;0;0;55,616666;12,616666
1771;"Amager";"no";0;0;0;55,616666;12,616666
1772;"Amager";"no";0;0;0;55,616666;12,616666
1773;"Amager";"no";0;0;0;55,616666;12,616666
1774;"Amager";"no";0;0;0;55,616666;12,616666
1775;"Amager";"no";0;0;0;55,616666;12,616666
1776;"Amager";"no";0;0;0;55,616666;12,616666
1777;"Amager";"no";0;0;0;55,616666;12,616666
1778;"Amager";"no";0;0;0;55,616666;12,616666
1779;"Amager";"no";0;0;0;55,616666;12,616666
1780;"Amager";"no";0;0;0;55,616666;12,616666
1781;"Amager";"no";0;0;0;55,616666;12,616666
1782;"Amager";"no";0;0;0;55,616666;12,616666
1783;"Amager";"no";0;0;0;55,616666;12,616666
1784;"Amager";"no";0;0;0;55,616666;12,616666
1785;"Amager";"no";0;0;0;55,616666;12,616666
1786;"Amager";"no";0;0;0;55,616666;12,616666
1787;"Amager";"no";0;0;0;55,616666;12,616666
1788;"Amager";"no";0;0;0;55,616666;12,616666
1789;"Amager";"no";0;0;0;55,616666;12,616666
1790;"Amager";"no";0;0;0;55,616666;12,616666
1791;"Amager";"no";0;0;0;55,616666;12,616666
1792;"Amager";"no";0;0;0;55,616666;12,616666
1793;"Amager";"no";0;0;0;55,616666;12,616666
1794;"Amager";"no";0;0;0;55,616666;12,616666
1795;"Amager";"no";0;0;0;55,616666;12,616666
1796;"Amager";"no";0;0;0;55,616666;12,616666
1797;"Amager";"no";0;0;0;55,616666;12,616666
1798;"Amager";"no";0;0;0;55,616666;12,616666
1799;"Amager";"no";0;0;0;55,616666;12,616666
1800;"Amager";"no";0;0;0;55,616666;12,616666
1801;"Amager";"no";0;0;0;55,616666;12,616666
1802;"Amager";"no";0;0;0;55,616666;12,616666
1803;"Amager";"no";0;0;0;55,616666;12,616666
1804;"Amager";"no";0;0;0;55,616666;12,616666
1805;"Amager";"no";0;0;0;55,616666;12,616666
1806;"Amager";"no";0;0;0;55,616666;12,616666
1807;"Amager";"no";0;0;0;55,616666;12,616666
1808;"Amager";"no";0;0;0;55,616666;12,616666
1809;"Amager";"no";0;0;0;55,616666;12,616666
1810;"Amager";"no";0;0;0;55,616666;12,616666
1811;"Amager";"no";0;0;0;55,616666;12,616666
1812;"Amager";"no";0;0;0;55,616666;12,616666
1813;"Amager";"no";0;0;0;55,616666;12,616666
1814;"Amager";"no";0;0;0;55,616666;12,616666
1815;"Amager";"no";0;0;0;55,616666;12,616666
1816;"Amager";"no";0;0;0;55,616666;12,616666
1817;"Amager";"no";0;0;0;55,616666;12,616666
1818;"Amager";"no";0;0;0;55,616666;12,616666
1819;"Amager";"no";0;0;0;55,616666;12,616666
1820;"Amager";"no";0;0;0;55,616666;12,616666
1821;"Amager";"no";0;0;0;55,616666;12,616666
1822;"Amager";"no";0;0;0;55,616666;12,616666
1823;"Amager";"no";0;0;0;55,616666;12,616666
1824;"Amager";"no";0;0;0;55,616666;12,616666
1825;"Amager";"no";0;0;0;55,616666;12,616666
1826;"Amager";"no";0;0;0;55,616666;12,616666
1827;"Amager";"no";0;0;0;55,616666;12,616666
1828;"Amager";"no";0;0;0;55,616666;12,616666
1829;"Amager";"no";0;0;0;55,616666;12,616666
1830;"Amager";"no";0;0;0;55,616666;12,616666
1831;"Amager";"no";0;0;0;55,616666;12,616666
1832;"Amager";"no";0;0;0;55,616666;12,616666
1833;"Amager";"no";0;0;0;55,616666;12,616666
1834;"Amager";"no";0;0;0;55,616666;12,616666
1835;"Amager";"no";0;0;0;55,616666;12,616666
1836;"Amager";"no";0;0;0;55,616666;12,616666
1837;"Amager";"no";0;0;0;55,616666;12,616666
1838;"Amager";"no";0;0;0;55,616666;12,616666
1839;"Amager";"no";0;0;0;55,616666;12,616666
1840;"Amager";"no";0;0;0;55,616666;12,616666
1841;"Amager";"no";0;0;0;55,616666;12,616666
1842;"Amager";"no";0;0;0;55,616666;12,616666
1843;"Amager";"no";0;0;0;55,616666;12,616666
1844;"Amager";"no";0;0;0;55,616666;12,616666
1845;"Amager";"no";0;0;0;55,616666;12,616666
1846;"Amager";"no";0;0;0;55,616666;12,616666
1847;"Amager";"no";0;0;0;55,616666;12,616666
1848;"Amager";"no";0;0;0;55,616666;12,616666
1849;"Amager";"no";0;0;0;55,616666;12,616666
1850;"Amager";"no";0;0;0;55,616666;12,616666
1851;"Amager";"no";0;0;0;55,616666;12,616666
1852;"Amager";"no";0;0;0;55,616666;12,616666
1853;"Amager";"no";0;0;0;55,616666;12,616666
1854;"Amager";"no";0;0;0;55,616666;12,616666
1855;"Amager";"no";0;0;0;55,616666;12,616666
1856;"Amager";"no";0;0;0;55,616666;12,616666
1857;"Amager";"no";0;0;0;55,616666;12,616666
1634;"Borreby";"no";0;0;0;55,2328;11,29
1635;"Borreby";"no";3;0;3;55,2328;11,29
1636;"Borreby";"no";0;0;0;55,2328;11,29
1637;"Borreby";"no";0;0;0;55,2328;11,29
1638;"Borreby";"no";0;0;0;55,2328;11,29
1639;"Borreby";"no";0;0;0;55,2328;11,29
1640;"Borreby";"no";0;0;0;55,2328;11,29
1641;"Borreby";"no";0;0;0;55,2328;11,29
1642;"Borreby";"no";0;0;0;55,2328;11,29
1643;"Borreby";"no";0;0;0;55,2328;11,29
1644;"Borreby";"no";0;0;0;55,2328;11,29
1645;"Borreby";"no";0;0;0;55,2328;11,29
1646;"Borreby";"no";0;0;0;55,2328;11,29
1647;"Borreby";"no";0;0;0;55,2328;11,29
1648;"Borreby";"no";0;0;0;55,2328;11,29
1649;"Borreby";"no";0;0;0;55,2328;11,29
1650;"Borreby";"no";0;0;0;55,2328;11,29
1651;"Borreby";"no";0;0;0;55,2328;11,29
1652;"Borreby";"no";0;0;0;55,2328;11,29
1653;"Borreby";"no";0;0;0;55,2328;11,29
1654;"Borreby";"no";0;0;0;55,2328;11,29
1655;"Borreby";"no";0;0;0;55,2328;11,29
1656;"Borreby";"no";0;0;0;55,2328;11,29
1657;"Borreby";"no";0;0;0;55,2328;11,29
1658;"Borreby";"no";0;0;0;55,2328;11,29
1659;"Borreby";"no";0;0;0;55,2328;11,29
1660;"Borreby";"no";0;0;0;55,2328;11,29
1661;"Borreby";"no";0;0;0;55,2328;11,29
1662;"Borreby";"no";0;0;0;55,2328;11,29
1663;"Borreby";"no";0;0;0;55,2328;11,29
1664;"Borreby";"no";0;0;0;55,2328;11,29
1665;"Borreby";"no";0;0;0;55,2328;11,29
1666;"Borreby";"no";0;0;0;55,2328;11,29
1667;"Borreby";"no";0;0;0;55,2328;11,29
1668;"Borreby";"no";0;0;0;55,2328;11,29
1669;"Borreby";"no";0;0;0;55,2328;11,29
1670;"Borreby";"no";0;0;0;55,2328;11,29
1671;"Borreby";"no";0;0;0;55,2328;11,29
1672;"Borreby";"no";0;0;0;55,2328;11,29
1673;"Borreby";"no";0;0;0;55,2328;11,29
1674;"Borreby";"no";0;0;0;55,2328;11,29
1675;"Borreby";"no";0;0;0;55,2328;11,29
1676;"Borreby";"no";0;0;0;55,2328;11,29
1677;"Borreby";"no";0;0;0;55,2328;11,29
1678;"Borreby";"no";0;0;0;55,2328;11,29
1679;"Borreby";"no";0;0;0;55,2328;11,29
1680;"Borreby";"no";0;0;0;55,2328;11,29
1681;"Borreby";"no";0;0;0;55,2328;11,29
1682;"Borreby";"no";0;0;0;55,2328;11,29
1683;"Borreby";"no";0;0;0;55,2328;11,29
1684;"Borreby";"no";0;0;0;55,2328;11,29
1685;"Borreby";"no";0;0;0;55,2328;11,29
1686;"Borreby";"no";0;0;0;55,2328;11,29
1687;"Borreby";"no";0;0;0;55,2328;11,29
1688;"Borreby";"no";0;0;0;55,2328;11,29
1689;"Borreby";"no";0;0;0;55,2328;11,29
1690;"Borreby";"no";0;0;0;55,2328;11,29
1691;"Borreby";"no";0;0;0;55,2328;11,29
1692;"Borreby";"no";0;0;0;55,2328;11,29
1693;"Borreby";"no";0;0;0;55,2328;11,29
1694;"Borreby";"no";0;0;0;55,2328;11,29
1695;"Borreby";"no";0;0;0;55,2328;11,29
1696;"Borreby";"no";0;0;0;55,2328;11,29
1697;"Borreby";"no";0;0;0;55,2328;11,29
1698;"Borreby";"no";0;0;0;55,2328;11,29
1699;"Borreby";"no";0;0;0;55,2328;11,29
1700;"Borreby";"no";0;0;0;55,2328;11,29
1701;"Borreby";"no";0;0;0;55,2328;11,29
1702;"Borreby";"no";0;0;0;55,2328;11,29
1703;"Borreby";"no";0;0;0;55,2328;11,29
1704;"Borreby";"no";0;0;0;55,2328;11,29
1705;"Borreby";"no";0;0;0;55,2328;11,29
1706;"Borreby";"no";0;0;0;55,2328;11,29
1707;"Borreby";"no";0;0;0;55,2328;11,29
1708;"Borreby";"no";0;0;0;55,2328;11,29
1709;"Borreby";"no";0;0;0;55,2328;11,29
1710;"Borreby";"no";0;0;0;55,2328;11,29
1711;"Borreby";"no";0;0;0;55,2328;11,29
1712;"Borreby";"no";0;0;0;55,2328;11,29
1713;"Borreby";"no";0;0;0;55,2328;11,29
1714;"Borreby";"no";0;0;0;55,2328;11,29
1715;"Borreby";"no";0;0;0;55,2328;11,29
1716;"Borreby";"no";0;0;0;55,2328;11,29
1717;"Borreby";"no";0;0;0;55,2328;11,29
1718;"Borreby";"no";0;0;0;55,2328;11,29
1719;"Borreby";"no";0;0;0;55,2328;11,29
1720;"Borreby";"no";0;0;0;55,2328;11,29
1721;"Borreby";"no";0;0;0;55,2328;11,29
1722;"Borreby";"no";0;0;0;55,2328;11,29
1723;"Borreby";"no";0;0;0;55,2328;11,29
1724;"Borreby";"no";0;0;0;55,2328;11,29
1725;"Borreby";"no";0;0;0;55,2328;11,29
1726;"Borreby";"no";0;0;0;55,2328;11,29
1727;"Borreby";"no";0;0;0;55,2328;11,29
1728;"Borreby";"no";0;0;0;55,2328;11,29
1729;"Borreby";"no";0;0;0;55,2328;11,29
1730;"Borreby";"no";0;0;0;55,2328;11,29
1731;"Borreby";"no";0;0;0;55,2328;11,29
1732;"Borreby";"no";0;0;0;55,2328;11,29
1733;"Borreby";"no";0;0;0;55,2328;11,29
1734;"Borreby";"no";0;0;0;55,2328;11,29
1735;"Borreby";"no";0;0;0;55,2328;11,29
1736;"Borreby";"no";0;0;0;55,2328;11,29
1737;"Borreby";"no";0;0;0;55,2328;11,29
1738;"Borreby";"no";0;0;0;55,2328;11,29
1739;"Borreby";"no";0;0;0;55,2328;11,29
1740;"Borreby";"no";0;0;0;55,2328;11,29
1741;"Borreby";"no";0;0;0;55,2328;11,29
1742;"Borreby";"no";0;0;0;55,2328;11,29
1743;"Borreby";"no";0;0;0;55,2328;11,29
1744;"Borreby";"no";0;0;0;55,2328;11,29
1745;"Borreby";"no";0;0;0;55,2328;11,29
1746;"Borreby";"no";0;0;0;55,2328;11,29
1747;"Borreby";"no";0;0;0;55,2328;11,29
1748;"Borreby";"no";0;0;0;55,2328;11,29
1749;"Borreby";"no";0;0;0;55,2328;11,29
1750;"Borreby";"no";0;0;0;55,2328;11,29
1751;"Borreby";"no";0;0;0;55,2328;11,29
1752;"Borreby";"no";0;0;0;55,2328;11,29
1753;"Borreby";"no";0;0;0;55,2328;11,29
1754;"Borreby";"no";0;0;0;55,2328;11,29
1755;"Borreby";"no";0;0;0;55,2328;11,29
1756;"Borreby";"no";0;0;0;55,2328;11,29
1757;"Borreby";"no";0;0;0;55,2328;11,29
1758;"Borreby";"no";0;0;0;55,2328;11,29
1759;"Borreby";"no";0;0;0;55,2328;11,29
1760;"Borreby";"no";0;0;0;55,2328;11,29
1761;"Borreby";"no";0;0;0;55,2328;11,29
1762;"Borreby";"no";0;0;0;55,2328;11,29
1763;"Borreby";"no";0;0;0;55,2328;11,29
1764;"Borreby";"no";0;0;0;55,2328;11,29
1765;"Borreby";"no";0;0;0;55,2328;11,29
1766;"Borreby";"no";0;0;0;55,2328;11,29
1767;"Borreby";"no";0;0;0;55,2328;11,29
1768;"Borreby";"no";0;0;0;55,2328;11,29
1769;"Borreby";"no";0;0;0;55,2328;11,29
1770;"Borreby";"no";0;0;0;55,2328;11,29
1771;"Borreby";"no";0;0;0;55,2328;11,29
1772;"Borreby";"no";0;0;0;55,2328;11,29
1773;"Borreby";"no";0;0;0;55,2328;11,29
1774;"Borreby";"no";0;0;0;55,2328;11,29
1775;"Borreby";"no";0;0;0;55,2328;11,29
1776;"Borreby";"no";0;0;0;55,2328;11,29
1777;"Borreby";"no";0;0;0;55,2328;11,29
1778;"Borreby";"no";0;0;0;55,2328;11,29
1779;"Borreby";"no";0;0;0;55,2328;11,29
1780;"Borreby";"no";0;0;0;55,2328;11,29
1781;"Borreby";"no";0;0;0;55,2328;11,29
1782;"Borreby";"no";0;0;0;55,2328;11,29
1783;"Borreby";"no";0;0;0;55,2328;11,29
1784;"Borreby";"no";0;0;0;55,2328;11,29
1785;"Borreby";"no";0;0;0;55,2328;11,29
1786;"Borreby";"no";0;0;0;55,2328;11,29
1787;"Borreby";"no";0;0;0;55,2328;11,29
1788;"Borreby";"no";0;0;0;55,2328;11,29
1789;"Borreby";"no";0;0;0;55,2328;11,29
1790;"Borreby";"no";0;0;0;55,2328;11,29
1791;"Borreby";"no";0;0;0;55,2328;11,29
1792;"Borreby";"no";0;0;0;55,2328;11,29
1793;"Borreby";"no";0;0;0;55,2328;11,29
1794;"Borreby";"no";0;0;0;55,2328;11,29
1795;"Borreby";"no";0;0;0;55,2328;11,29
1796;"Borreby";"no";0;0;0;55,2328;11,29
1797;"Borreby";"no";0;0;0;55,2328;11,29
1798;"Borreby";"no";0;0;0;55,2328;11,29
1799;"Borreby";"no";0;0;0;55,2328;11,29
1800;"Borreby";"no";0;0;0;55,2328;11,29
1801;"Borreby";"no";0;0;0;55,2328;11,29
1802;"Borreby";"no";0;0;0;55,2328;11,29
1803;"Borreby";"no";0;0;0;55,2328;11,29
1804;"Borreby";"no";0;0;0;55,2328;11,29
1805;"Borreby";"no";0;0;0;55,2328;11,29
1806;"Borreby";"no";0;0;0;55,2328;11,29
1807;"Borreby";"no";0;0;0;55,2328;11,29
1808;"Borreby";"no";0;0;0;55,2328;11,29
1809;"Borreby";"no";0;0;0;55,2328;11,29
1810;"Borreby";"no";0;0;0;55,2328;11,29
1811;"Borreby";"no";0;0;0;55,2328;11,29
1812;"Borreby";"no";0;0;0;55,2328;11,29
1813;"Borreby";"no";0;0;0;55,2328;11,29
1814;"Borreby";"no";0;0;0;55,2328;11,29
1815;"Borreby";"no";0;0;0;55,2328;11,29
1816;"Borreby";"no";0;0;0;55,2328;11,29
1817;"Borreby";"no";0;0;0;55,2328;11,29
1818;"Borreby";"no";0;0;0;55,2328;11,29
1819;"Borreby";"no";0;0;0;55,2328;11,29
1820;"Borreby";"no";0;0;0;55,2328;11,29
1821;"Borreby";"no";0;0;0;55,2328;11,29
1822;"Borreby";"no";0;0;0;55,2328;11,29
1823;"Borreby";"no";0;0;0;55,2328;11,29
1824;"Borreby";"no";0;0;0;55,2328;11,29
1825;"Borreby";"no";0;0;0;55,2328;11,29
1826;"Borreby";"no";0;0;0;55,2328;11,29
1827;"Borreby";"no";0;0;0;55,2328;11,29
1828;"Borreby";"no";0;0;0;55,2328;11,29
1829;"Borreby";"no";0;0;0;55,2328;11,29
1830;"Borreby";"no";0;0;0;55,2328;11,29
1831;"Borreby";"no";0;0;0;55,2328;11,29
1832;"Borreby";"no";0;0;0;55,2328;11,29
1833;"Borreby";"no";0;0;0;55,2328;11,29
1834;"Borreby";"no";0;0;0;55,2328;11,29
1835;"Borreby";"no";0;0;0;55,2328;11,29
1836;"Borreby";"no";0;0;0;55,2328;11,29
1837;"Borreby";"no";0;0;0;55,2328;11,29
1838;"Borreby";"no";0;0;0;55,2328;11,29
1839;"Borreby";"no";0;0;0;55,2328;11,29
1840;"Borreby";"no";0;0;0;55,2328;11,29
1841;"Borreby";"no";0;0;0;55,2328;11,29
1842;"Borreby";"no";0;0;0;55,2328;11,29
1843;"Borreby";"no";0;0;0;55,2328;11,29
1844;"Borreby";"no";0;0;0;55,2328;11,29
1845;"Borreby";"no";0;0;0;55,2328;11,29
1846;"Borreby";"no";0;0;0;55,2328;11,29
1847;"Borreby";"no";0;0;0;55,2328;11,29
1848;"Borreby";"no";0;0;0;55,2328;11,29
1849;"Borreby";"no";0;0;0;55,2328;11,29
1850;"Borreby";"no";0;0;0;55,2328;11,29
1851;"Borreby";"no";0;0;0;55,2328;11,29
1852;"Borreby";"no";0;0;0;55,2328;11,29
1853;"Borreby";"no";0;0;0;55,2328;11,29
1854;"Borreby";"no";0;0;0;55,2328;11,29
1855;"Borreby";"no";0;0;0;55,2328;11,29
1856;"Borreby";"no";0;0;0;55,2328;11,29
1857;"Borreby";"no";0;0;0;55,2328;11,29
1634;"Fjerritslev";"no";0;0;0;57,0902548;9,0922894
1635;"Fjerritslev";"no";1;0;1;57,0902548;9,0922894
1636;"Fjerritslev";"no";0;0;0;57,0902548;9,0922894
1637;"Fjerritslev";"no";0;0;0;57,0902548;9,0922894
1638;"Fjerritslev";"no";0;0;0;57,0902548;9,0922894
1639;"Fjerritslev";"no";0;0;0;57,0902548;9,0922894
1640;"Fjerritslev";"no";0;0;0;57,0902548;9,0922894
1641;"Fjerritslev";"no";0;0;0;57,0902548;9,0922894
1642;"Fjerritslev";"no";0;0;0;57,0902548;9,0922894
1643;"Fjerritslev";"no";0;0;0;57,0902548;9,0922894
1644;"Fjerritslev";"no";0;0;0;57,0902548;9,0922894
1645;"Fjerritslev";"no";0;0;0;57,0902548;9,0922894
1646;"Fjerritslev";"no";0;0;0;57,0902548;9,0922894
1647;"Fjerritslev";"no";0;0;0;57,0902548;9,0922894
1648;"Fjerritslev";"no";0;0;0;57,0902548;9,0922894
1649;"Fjerritslev";"no";0;0;0;57,0902548;9,0922894
1650;"Fjerritslev";"no";0;0;0;57,0902548;9,0922894
1651;"Fjerritslev";"no";0;0;0;57,0902548;9,0922894
1652;"Fjerritslev";"no";0;0;0;57,0902548;9,0922894
1653;"Fjerritslev";"no";0;0;0;57,0902548;9,0922894
1654;"Fjerritslev";"no";0;0;0;57,0902548;9,0922894
1655;"Fjerritslev";"no";0;0;0;57,0902548;9,0922894
1656;"Fjerritslev";"no";0;0;0;57,0902548;9,0922894
1657;"Fjerritslev";"no";0;0;0;57,0902548;9,0922894
1658;"Fjerritslev";"no";0;0;0;57,0902548;9,0922894
1659;"Fjerritslev";"no";0;0;0;57,0902548;9,0922894
1660;"Fjerritslev";"no";0;0;0;57,0902548;9,0922894
1661;"Fjerritslev";"no";0;0;0;57,0902548;9,0922894
1662;"Fjerritslev";"no";0;0;0;57,0902548;9,0922894
1663;"Fjerritslev";"no";0;0;0;57,0902548;9,0922894
1664;"Fjerritslev";"no";0;0;0;57,0902548;9,0922894
1665;"Fjerritslev";"no";0;0;0;57,0902548;9,0922894
1666;"Fjerritslev";"no";0;0;0;57,0902548;9,0922894
1667;"Fjerritslev";"no";0;0;0;57,0902548;9,0922894
1668;"Fjerritslev";"no";1;0;1;57,0902548;9,0922894
1669;"Fjerritslev";"no";0;0;0;57,0902548;9,0922894
1670;"Fjerritslev";"no";0;0;0;57,0902548;9,0922894
1671;"Fjerritslev";"no";0;0;0;57,0902548;9,0922894
1672;"Fjerritslev";"no";0;0;0;57,0902548;9,0922894
1673;"Fjerritslev";"no";0;0;0;57,0902548;9,0922894
1674;"Fjerritslev";"no";0;0;0;57,0902548;9,0922894
1675;"Fjerritslev";"no";0;0;0;57,0902548;9,0922894
1676;"Fjerritslev";"no";0;0;0;57,0902548;9,0922894
1677;"Fjerritslev";"no";0;0;0;57,0902548;9,0922894
1678;"Fjerritslev";"no";0;0;0;57,0902548;9,0922894
1679;"Fjerritslev";"no";0;0;0;57,0902548;9,0922894
1680;"Fjerritslev";"no";0;0;0;57,0902548;9,0922894
1681;"Fjerritslev";"no";0;0;0;57,0902548;9,0922894
1682;"Fjerritslev";"no";0;0;0;57,0902548;9,0922894
1683;"Fjerritslev";"no";0;0;0;57,0902548;9,0922894
1684;"Fjerritslev";"no";0;0;0;57,0902548;9,0922894
1685;"Fjerritslev";"no";0;0;0;57,0902548;9,0922894
1686;"Fjerritslev";"no";0;0;0;57,0902548;9,0922894
1687;"Fjerritslev";"no";0;0;0;57,0902548;9,0922894
1688;"Fjerritslev";"no";0;0;0;57,0902548;9,0922894
1689;"Fjerritslev";"no";0;0;0;57,0902548;9,0922894
1690;"Fjerritslev";"no";0;0;0;57,0902548;9,0922894
1691;"Fjerritslev";"no";0;0;0;57,0902548;9,0922894
1692;"Fjerritslev";"no";0;0;0;57,0902548;9,0922894
1693;"Fjerritslev";"no";0;0;0;57,0902548;9,0922894
1694;"Fjerritslev";"no";0;0;0;57,0902548;9,0922894
1695;"Fjerritslev";"no";0;0;0;57,0902548;9,0922894
1696;"Fjerritslev";"no";0;0;0;57,0902548;9,0922894
1697;"Fjerritslev";"no";0;0;0;57,0902548;9,0922894
1698;"Fjerritslev";"no";0;0;0;57,0902548;9,0922894
1699;"Fjerritslev";"no";0;0;0;57,0902548;9,0922894
1700;"Fjerritslev";"no";0;0;0;57,0902548;9,0922894
1701;"Fjerritslev";"no";0;0;0;57,0902548;9,0922894
1702;"Fjerritslev";"no";0;0;0;57,0902548;9,0922894
1703;"Fjerritslev";"no";0;0;0;57,0902548;9,0922894
1704;"Fjerritslev";"no";0;0;0;57,0902548;9,0922894
1705;"Fjerritslev";"no";0;0;0;57,0902548;9,0922894
1706;"Fjerritslev";"no";0;0;0;57,0902548;9,0922894
1707;"Fjerritslev";"no";0;0;0;57,0902548;9,0922894
1708;"Fjerritslev";"no";0;0;0;57,0902548;9,0922894
1709;"Fjerritslev";"no";0;0;0;57,0902548;9,0922894
1710;"Fjerritslev";"no";0;0;0;57,0902548;9,0922894
1711;"Fjerritslev";"no";0;0;0;57,0902548;9,0922894
1712;"Fjerritslev";"no";0;0;0;57,0902548;9,0922894
1713;"Fjerritslev";"no";0;0;0;57,0902548;9,0922894
1714;"Fjerritslev";"no";0;0;0;57,0902548;9,0922894
1715;"Fjerritslev";"no";0;0;0;57,0902548;9,0922894
1716;"Fjerritslev";"no";0;0;0;57,0902548;9,0922894
1717;"Fjerritslev";"no";0;0;0;57,0902548;9,0922894
1718;"Fjerritslev";"no";0;0;0;57,0902548;9,0922894
1719;"Fjerritslev";"no";0;0;0;57,0902548;9,0922894
1720;"Fjerritslev";"no";0;0;0;57,0902548;9,0922894
1721;"Fjerritslev";"no";0;0;0;57,0902548;9,0922894
1722;"Fjerritslev";"no";0;0;0;57,0902548;9,0922894
1723;"Fjerritslev";"no";0;0;0;57,0902548;9,0922894
1724;"Fjerritslev";"no";0;0;0;57,0902548;9,0922894
1725;"Fjerritslev";"no";0;0;0;57,0902548;9,0922894
1726;"Fjerritslev";"no";0;0;0;57,0902548;9,0922894
1727;"Fjerritslev";"no";0;0;0;57,0902548;9,0922894
1728;"Fjerritslev";"no";0;0;0;57,0902548;9,0922894
1729;"Fjerritslev";"no";0;0;0;57,0902548;9,0922894
1730;"Fjerritslev";"no";0;0;0;57,0902548;9,0922894
1731;"Fjerritslev";"no";0;0;0;57,0902548;9,0922894
1732;"Fjerritslev";"no";0;0;0;57,0902548;9,0922894
1733;"Fjerritslev";"no";0;0;0;57,0902548;9,0922894
1734;"Fjerritslev";"no";0;0;0;57,0902548;9,0922894
1735;"Fjerritslev";"no";0;0;0;57,0902548;9,0922894
1736;"Fjerritslev";"no";0;0;0;57,0902548;9,0922894
1737;"Fjerritslev";"no";0;0;0;57,0902548;9,0922894
1738;"Fjerritslev";"no";0;0;0;57,0902548;9,0922894
1739;"Fjerritslev";"no";0;0;0;57,0902548;9,0922894
1740;"Fjerritslev";"no";0;0;0;57,0902548;9,0922894
1741;"Fjerritslev";"no";0;0;0;57,0902548;9,0922894
1742;"Fjerritslev";"no";0;0;0;57,0902548;9,0922894
1743;"Fjerritslev";"no";0;0;0;57,0902548;9,0922894
1744;"Fjerritslev";"no";0;0;0;57,0902548;9,0922894
1745;"Fjerritslev";"no";0;0;0;57,0902548;9,0922894
1746;"Fjerritslev";"no";0;0;0;57,0902548;9,0922894
1747;"Fjerritslev";"no";0;0;0;57,0902548;9,0922894
1748;"Fjerritslev";"no";0;0;0;57,0902548;9,0922894
1749;"Fjerritslev";"no";0;0;0;57,0902548;9,0922894
1750;"Fjerritslev";"no";0;0;0;57,0902548;9,0922894
1751;"Fjerritslev";"no";0;0;0;57,0902548;9,0922894
1752;"Fjerritslev";"no";0;0;0;57,0902548;9,0922894
1753;"Fjerritslev";"no";0;0;0;57,0902548;9,0922894
1754;"Fjerritslev";"no";0;0;0;57,0902548;9,0922894
1755;"Fjerritslev";"no";0;0;0;57,0902548;9,0922894
1756;"Fjerritslev";"no";0;0;0;57,0902548;9,0922894
1757;"Fjerritslev";"no";0;0;0;57,0902548;9,0922894
1758;"Fjerritslev";"no";0;0;0;57,0902548;9,0922894
1759;"Fjerritslev";"no";0;0;0;57,0902548;9,0922894
1760;"Fjerritslev";"no";0;0;0;57,0902548;9,0922894
1761;"Fjerritslev";"no";0;0;0;57,0902548;9,0922894
1762;"Fjerritslev";"no";0;0;0;57,0902548;9,0922894
1763;"Fjerritslev";"no";0;0;0;57,0902548;9,0922894
1764;"Fjerritslev";"no";0;0;0;57,0902548;9,0922894
1765;"Fjerritslev";"no";0;0;0;57,0902548;9,0922894
1766;"Fjerritslev";"no";0;0;0;57,0902548;9,0922894
1767;"Fjerritslev";"no";0;0;0;57,0902548;9,0922894
1768;"Fjerritslev";"no";0;0;0;57,0902548;9,0922894
1769;"Fjerritslev";"no";0;0;0;57,0902548;9,0922894
1770;"Fjerritslev";"no";0;0;0;57,0902548;9,0922894
1771;"Fjerritslev";"no";0;0;0;57,0902548;9,0922894
1772;"Fjerritslev";"no";0;0;0;57,0902548;9,0922894
1773;"Fjerritslev";"no";0;0;0;57,0902548;9,0922894
1774;"Fjerritslev";"no";0;0;0;57,0902548;9,0922894
1775;"Fjerritslev";"no";0;0;0;57,0902548;9,0922894
1776;"Fjerritslev";"no";0;0;0;57,0902548;9,0922894
1777;"Fjerritslev";"no";0;0;0;57,0902548;9,0922894
1778;"Fjerritslev";"no";0;0;0;57,0902548;9,0922894
1779;"Fjerritslev";"no";0;0;0;57,0902548;9,0922894
1780;"Fjerritslev";"no";0;0;0;57,0902548;9,0922894
1781;"Fjerritslev";"no";0;0;0;57,0902548;9,0922894
1782;"Fjerritslev";"no";0;0;0;57,0902548;9,0922894
1783;"Fjerritslev";"no";0;0;0;57,0902548;9,0922894
1784;"Fjerritslev";"no";0;0;0;57,0902548;9,0922894
1785;"Fjerritslev";"no";0;0;0;57,0902548;9,0922894
1786;"Fjerritslev";"no";0;0;0;57,0902548;9,0922894
1787;"Fjerritslev";"no";0;0;0;57,0902548;9,0922894
1788;"Fjerritslev";"no";0;0;0;57,0902548;9,0922894
1789;"Fjerritslev";"no";0;0;0;57,0902548;9,0922894
1790;"Fjerritslev";"no";0;0;0;57,0902548;9,0922894
1791;"Fjerritslev";"no";0;0;0;57,0902548;9,0922894
1792;"Fjerritslev";"no";0;0;0;57,0902548;9,0922894
1793;"Fjerritslev";"no";0;0;0;57,0902548;9,0922894
1794;"Fjerritslev";"no";0;0;0;57,0902548;9,0922894
1795;"Fjerritslev";"no";0;0;0;57,0902548;9,0922894
1796;"Fjerritslev";"no";0;0;0;57,0902548;9,0922894
1797;"Fjerritslev";"no";0;0;0;57,0902548;9,0922894
1798;"Fjerritslev";"no";0;0;0;57,0902548;9,0922894
1799;"Fjerritslev";"no";0;0;0;57,0902548;9,0922894
1800;"Fjerritslev";"no";0;0;0;57,0902548;9,0922894
1801;"Fjerritslev";"no";0;0;0;57,0902548;9,0922894
1802;"Fjerritslev";"no";0;0;0;57,0902548;9,0922894
1803;"Fjerritslev";"no";0;0;0;57,0902548;9,0922894
1804;"Fjerritslev";"no";0;0;0;57,0902548;9,0922894
1805;"Fjerritslev";"no";0;0;0;57,0902548;9,0922894
1806;"Fjerritslev";"no";0;0;0;57,0902548;9,0922894
1807;"Fjerritslev";"no";0;0;0;57,0902548;9,0922894
1808;"Fjerritslev";"no";0;0;0;57,0902548;9,0922894
1809;"Fjerritslev";"no";0;0;0;57,0902548;9,0922894
1810;"Fjerritslev";"no";0;0;0;57,0902548;9,0922894
1811;"Fjerritslev";"no";0;0;0;57,0902548;9,0922894
1812;"Fjerritslev";"no";0;0;0;57,0902548;9,0922894
1813;"Fjerritslev";"no";0;0;0;57,0902548;9,0922894
1814;"Fjerritslev";"no";0;0;0;57,0902548;9,0922894
1815;"Fjerritslev";"no";0;0;0;57,0902548;9,0922894
1816;"Fjerritslev";"no";0;0;0;57,0902548;9,0922894
1817;"Fjerritslev";"no";0;0;0;57,0902548;9,0922894
1818;"Fjerritslev";"no";0;0;0;57,0902548;9,0922894
1819;"Fjerritslev";"no";0;0;0;57,0902548;9,0922894
1820;"Fjerritslev";"no";0;0;0;57,0902548;9,0922894
1821;"Fjerritslev";"no";0;0;0;57,0902548;9,0922894
1822;"Fjerritslev";"no";0;0;0;57,0902548;9,0922894
1823;"Fjerritslev";"no";0;0;0;57,0902548;9,0922894
1824;"Fjerritslev";"no";0;0;0;57,0902548;9,0922894
1825;"Fjerritslev";"no";0;0;0;57,0902548;9,0922894
1826;"Fjerritslev";"no";0;0;0;57,0902548;9,0922894
1827;"Fjerritslev";"no";0;0;0;57,0902548;9,0922894
1828;"Fjerritslev";"no";0;0;0;57,0902548;9,0922894
1829;"Fjerritslev";"no";0;0;0;57,0902548;9,0922894
1830;"Fjerritslev";"no";0;0;0;57,0902548;9,0922894
1831;"Fjerritslev";"no";0;0;0;57,0902548;9,0922894
1832;"Fjerritslev";"no";0;0;0;57,0902548;9,0922894
1833;"Fjerritslev";"no";0;0;0;57,0902548;9,0922894
1834;"Fjerritslev";"no";0;0;0;57,0902548;9,0922894
1835;"Fjerritslev";"no";0;0;0;57,0902548;9,0922894
1836;"Fjerritslev";"no";0;0;0;57,0902548;9,0922894
1837;"Fjerritslev";"no";0;0;0;57,0902548;9,0922894
1838;"Fjerritslev";"no";0;0;0;57,0902548;9,0922894
1839;"Fjerritslev";"no";0;0;0;57,0902548;9,0922894
1840;"Fjerritslev";"no";0;0;0;57,0902548;9,0922894
1841;"Fjerritslev";"no";0;0;0;57,0902548;9,0922894
1842;"Fjerritslev";"no";0;0;0;57,0902548;9,0922894
1843;"Fjerritslev";"no";0;0;0;57,0902548;9,0922894
1844;"Fjerritslev";"no";0;0;0;57,0902548;9,0922894
1845;"Fjerritslev";"no";0;0;0;57,0902548;9,0922894
1846;"Fjerritslev";"no";0;0;0;57,0902548;9,0922894
1847;"Fjerritslev";"no";0;0;0;57,0902548;9,0922894
1848;"Fjerritslev";"no";0;0;0;57,0902548;9,0922894
1849;"Fjerritslev";"no";0;0;0;57,0902548;9,0922894
1850;"Fjerritslev";"no";0;0;0;57,0902548;9,0922894
1851;"Fjerritslev";"no";0;0;0;57,0902548;9,0922894
1852;"Fjerritslev";"no";0;0;0;57,0902548;9,0922894
1853;"Fjerritslev";"no";0;0;0;57,0902548;9,0922894
1854;"Fjerritslev";"no";0;0;0;57,0902548;9,0922894
1855;"Fjerritslev";"no";0;0;0;57,0902548;9,0922894
1856;"Fjerritslev";"no";0;0;0;57,0902548;9,0922894
1857;"Fjerritslev";"no";0;0;0;57,0902548;9,0922894
1634;"Grenaa";"no";0;0;0;56,415555;10,878055
1635;"Grenaa";"no";1;0;1;56,415555;10,878055
1636;"Grenaa";"no";0;0;0;56,415555;10,878055
1637;"Grenaa";"no";0;0;0;56,415555;10,878055
1638;"Grenaa";"no";0;0;0;56,415555;10,878055
1639;"Grenaa";"no";0;0;0;56,415555;10,878055
1640;"Grenaa";"no";0;0;0;56,415555;10,878055
1641;"Grenaa";"no";0;0;0;56,415555;10,878055
1642;"Grenaa";"no";0;0;0;56,415555;10,878055
1643;"Grenaa";"no";0;2;2;56,415555;10,878055
1644;"Grenaa";"no";0;0;0;56,415555;10,878055
1645;"Grenaa";"no";0;0;0;56,415555;10,878055
1646;"Grenaa";"no";0;0;0;56,415555;10,878055
1647;"Grenaa";"no";0;0;0;56,415555;10,878055
1648;"Grenaa";"no";0;0;0;56,415555;10,878055
1649;"Grenaa";"no";0;0;0;56,415555;10,878055
1650;"Grenaa";"no";0;0;0;56,415555;10,878055
1651;"Grenaa";"no";0;0;0;56,415555;10,878055
1652;"Grenaa";"no";0;0;0;56,415555;10,878055
1653;"Grenaa";"no";0;0;0;56,415555;10,878055
1654;"Grenaa";"no";0;0;0;56,415555;10,878055
1655;"Grenaa";"no";0;0;0;56,415555;10,878055
1656;"Grenaa";"no";0;0;0;56,415555;10,878055
1657;"Grenaa";"no";0;0;0;56,415555;10,878055
1658;"Grenaa";"no";0;0;0;56,415555;10,878055
1659;"Grenaa";"no";0;0;0;56,415555;10,878055
1660;"Grenaa";"no";0;0;0;56,415555;10,878055
1661;"Grenaa";"no";0;0;0;56,415555;10,878055
1662;"Grenaa";"no";0;0;0;56,415555;10,878055
1663;"Grenaa";"no";0;0;0;56,415555;10,878055
1664;"Grenaa";"no";0;0;0;56,415555;10,878055
1665;"Grenaa";"no";0;0;0;56,415555;10,878055
1666;"Grenaa";"no";0;0;0;56,415555;10,878055
1667;"Grenaa";"no";0;0;0;56,415555;10,878055
1668;"Grenaa";"no";0;0;0;56,415555;10,878055
1669;"Grenaa";"no";0;0;0;56,415555;10,878055
1670;"Grenaa";"no";0;0;0;56,415555;10,878055
1671;"Grenaa";"no";0;0;0;56,415555;10,878055
1672;"Grenaa";"no";0;0;0;56,415555;10,878055
1673;"Grenaa";"no";0;0;0;56,415555;10,878055
1674;"Grenaa";"no";0;0;0;56,415555;10,878055
1675;"Grenaa";"no";1;0;1;56,415555;10,878055
1676;"Grenaa";"no";0;0;0;56,415555;10,878055
1677;"Grenaa";"no";0;0;0;56,415555;10,878055
1678;"Grenaa";"no";0;0;0;56,415555;10,878055
1679;"Grenaa";"no";0;0;0;56,415555;10,878055
1680;"Grenaa";"no";0;0;0;56,415555;10,878055
1681;"Grenaa";"no";0;0;0;56,415555;10,878055
1682;"Grenaa";"no";0;0;0;56,415555;10,878055
1683;"Grenaa";"no";0;0;0;56,415555;10,878055
1684;"Grenaa";"no";0;0;0;56,415555;10,878055
1685;"Grenaa";"no";0;0;0;56,415555;10,878055
1686;"Grenaa";"no";0;0;0;56,415555;10,878055
1687;"Grenaa";"no";1;0;1;56,415555;10,878055
1688;"Grenaa";"no";1;0;1;56,415555;10,878055
1689;"Grenaa";"no";1;0;1;56,415555;10,878055
1690;"Grenaa";"no";0;0;0;56,415555;10,878055
1691;"Grenaa";"no";0;0;0;56,415555;10,878055
1692;"Grenaa";"no";1;0;1;56,415555;10,878055
1693;"Grenaa";"no";1;0;1;56,415555;10,878055
1694;"Grenaa";"no";2;0;2;56,415555;10,878055
1695;"Grenaa";"no";0;0;0;56,415555;10,878055
1696;"Grenaa";"no";0;0;0;56,415555;10,878055
1697;"Grenaa";"no";0;0;0;56,415555;10,878055
1698;"Grenaa";"no";0;0;0;56,415555;10,878055
1699;"Grenaa";"no";0;0;0;56,415555;10,878055
1700;"Grenaa";"no";0;0;0;56,415555;10,878055
1701;"Grenaa";"no";0;0;0;56,415555;10,878055
1702;"Grenaa";"no";0;0;0;56,415555;10,878055
1703;"Grenaa";"no";0;0;0;56,415555;10,878055
1704;"Grenaa";"no";1;0;1;56,415555;10,878055
1705;"Grenaa";"no";0;0;0;56,415555;10,878055
1706;"Grenaa";"no";0;1;1;56,415555;10,878055
1707;"Grenaa";"no";0;0;0;56,415555;10,878055
1708;"Grenaa";"no";0;0;0;56,415555;10,878055
1709;"Grenaa";"no";0;0;0;56,415555;10,878055
1710;"Grenaa";"no";0;0;0;56,415555;10,878055
1711;"Grenaa";"no";0;0;0;56,415555;10,878055
1712;"Grenaa";"no";3;0;3;56,415555;10,878055
1713;"Grenaa";"no";0;0;0;56,415555;10,878055
1714;"Grenaa";"no";0;0;0;56,415555;10,878055
1715;"Grenaa";"no";0;0;0;56,415555;10,878055
1716;"Grenaa";"no";0;0;0;56,415555;10,878055
1717;"Grenaa";"no";0;0;0;56,415555;10,878055
1718;"Grenaa";"no";1;0;1;56,415555;10,878055
1719;"Grenaa";"no";0;0;0;56,415555;10,878055
1720;"Grenaa";"no";0;0;0;56,415555;10,878055
1721;"Grenaa";"no";0;0;0;56,415555;10,878055
1722;"Grenaa";"no";0;0;0;56,415555;10,878055
1723;"Grenaa";"no";0;0;0;56,415555;10,878055
1724;"Grenaa";"no";0;0;0;56,415555;10,878055
1725;"Grenaa";"no";0;0;0;56,415555;10,878055
1726;"Grenaa";"no";0;0;0;56,415555;10,878055
1727;"Grenaa";"no";0;0;0;56,415555;10,878055
1728;"Grenaa";"no";0;0;0;56,415555;10,878055
1729;"Grenaa";"no";0;0;0;56,415555;10,878055
1730;"Grenaa";"no";0;0;0;56,415555;10,878055
1731;"Grenaa";"no";0;0;0;56,415555;10,878055
1732;"Grenaa";"no";0;0;0;56,415555;10,878055
1733;"Grenaa";"no";0;0;0;56,415555;10,878055
1734;"Grenaa";"no";0;0;0;56,415555;10,878055
1735;"Grenaa";"no";0;0;0;56,415555;10,878055
1736;"Grenaa";"no";0;0;0;56,415555;10,878055
1737;"Grenaa";"no";0;0;0;56,415555;10,878055
1738;"Grenaa";"no";0;0;0;56,415555;10,878055
1739;"Grenaa";"no";0;0;0;56,415555;10,878055
1740;"Grenaa";"no";1;1;2;56,415555;10,878055
1741;"Grenaa";"no";0;0;0;56,415555;10,878055
1742;"Grenaa";"no";1;1;2;56,415555;10,878055
1743;"Grenaa";"no";1;0;1;56,415555;10,878055
1744;"Grenaa";"no";0;0;0;56,415555;10,878055
1745;"Grenaa";"no";0;0;0;56,415555;10,878055
1746;"Grenaa";"no";0;0;0;56,415555;10,878055
1747;"Grenaa";"no";0;1;1;56,415555;10,878055
1748;"Grenaa";"no";0;0;0;56,415555;10,878055
1749;"Grenaa";"no";0;0;0;56,415555;10,878055
1750;"Grenaa";"no";0;0;0;56,415555;10,878055
1751;"Grenaa";"no";0;0;0;56,415555;10,878055
1752;"Grenaa";"no";0;0;0;56,415555;10,878055
1753;"Grenaa";"no";0;0;0;56,415555;10,878055
1754;"Grenaa";"no";0;0;0;56,415555;10,878055
1755;"Grenaa";"no";0;0;0;56,415555;10,878055
1756;"Grenaa";"no";0;1;1;56,415555;10,878055
1757;"Grenaa";"no";0;0;0;56,415555;10,878055
1758;"Grenaa";"no";0;1;1;56,415555;10,878055
1759;"Grenaa";"no";0;0;0;56,415555;10,878055
1760;"Grenaa";"no";0;0;0;56,415555;10,878055
1761;"Grenaa";"no";0;0;0;56,415555;10,878055
1762;"Grenaa";"no";0;0;0;56,415555;10,878055
1763;"Grenaa";"no";0;0;0;56,415555;10,878055
1764;"Grenaa";"no";0;0;0;56,415555;10,878055
1765;"Grenaa";"no";2;2;4;56,415555;10,878055
1766;"Grenaa";"no";0;2;2;56,415555;10,878055
1767;"Grenaa";"no";1;1;2;56,415555;10,878055
1768;"Grenaa";"no";1;2;3;56,415555;10,878055
1769;"Grenaa";"no";1;2;3;56,415555;10,878055
1770;"Grenaa";"no";0;0;0;56,415555;10,878055
1771;"Grenaa";"no";0;1;1;56,415555;10,878055
1772;"Grenaa";"no";0;1;1;56,415555;10,878055
1773;"Grenaa";"no";0;1;1;56,415555;10,878055
1774;"Grenaa";"no";0;0;0;56,415555;10,878055
1775;"Grenaa";"no";1;2;3;56,415555;10,878055
1776;"Grenaa";"no";0;1;1;56,415555;10,878055
1777;"Grenaa";"no";0;0;0;56,415555;10,878055
1778;"Grenaa";"no";0;0;0;56,415555;10,878055
1779;"Grenaa";"no";0;0;0;56,415555;10,878055
1780;"Grenaa";"no";0;0;0;56,415555;10,878055
1781;"Grenaa";"no";1;0;1;56,415555;10,878055
1782;"Grenaa";"no";0;0;0;56,415555;10,878055
1783;"Grenaa";"no";0;0;0;56,415555;10,878055
1784;"Grenaa";"no";0;1;1;56,415555;10,878055
1785;"Grenaa";"no";0;0;0;56,415555;10,878055
1786;"Grenaa";"no";0;0;0;56,415555;10,878055
1787;"Grenaa";"no";0;0;0;56,415555;10,878055
1788;"Grenaa";"no";0;0;0;56,415555;10,878055
1789;"Grenaa";"no";0;0;0;56,415555;10,878055
1790;"Grenaa";"no";0;0;0;56,415555;10,878055
1791;"Grenaa";"no";0;0;0;56,415555;10,878055
1792;"Grenaa";"no";0;1;1;56,415555;10,878055
1793;"Grenaa";"no";0;1;1;56,415555;10,878055
1794;"Grenaa";"no";0;0;0;56,415555;10,878055
1795;"Grenaa";"no";0;0;0;56,415555;10,878055
1796;"Grenaa";"no";0;0;0;56,415555;10,878055
1797;"Grenaa";"no";0;0;0;56,415555;10,878055
1798;"Grenaa";"no";2;1;3;56,415555;10,878055
1799;"Grenaa";"no";0;0;0;56,415555;10,878055
1800;"Grenaa";"no";0;0;0;56,415555;10,878055
1801;"Grenaa";"no";0;0;0;56,415555;10,878055
1802;"Grenaa";"no";0;0;0;56,415555;10,878055
1803;"Grenaa";"no";1;2;3;56,415555;10,878055
1804;"Grenaa";"no";1;0;1;56,415555;10,878055
1805;"Grenaa";"no";4;3;7;56,415555;10,878055
1806;"Grenaa";"no";0;0;0;56,415555;10,878055
1807;"Grenaa";"no";1;0;1;56,415555;10,878055
1808;"Grenaa";"no";0;0;0;56,415555;10,878055
1809;"Grenaa";"no";0;0;0;56,415555;10,878055
1810;"Grenaa";"no";0;0;0;56,415555;10,878055
1811;"Grenaa";"no";0;0;0;56,415555;10,878055
1812;"Grenaa";"no";0;0;0;56,415555;10,878055
1813;"Grenaa";"no";0;0;0;56,415555;10,878055
1814;"Grenaa";"no";0;0;0;56,415555;10,878055
1815;"Grenaa";"no";0;0;0;56,415555;10,878055
1816;"Grenaa";"no";0;0;0;56,415555;10,878055
1817;"Grenaa";"no";1;0;1;56,415555;10,878055
1818;"Grenaa";"no";0;0;0;56,415555;10,878055
1819;"Grenaa";"no";0;0;0;56,415555;10,878055
1820;"Grenaa";"no";1;0;1;56,415555;10,878055
1821;"Grenaa";"no";1;0;1;56,415555;10,878055
1822;"Grenaa";"no";0;0;0;56,415555;10,878055
1823;"Grenaa";"no";0;0;0;56,415555;10,878055
1824;"Grenaa";"no";0;0;0;56,415555;10,878055
1825;"Grenaa";"no";0;0;0;56,415555;10,878055
1826;"Grenaa";"no";0;0;0;56,415555;10,878055
1827;"Grenaa";"no";0;0;0;56,415555;10,878055
1828;"Grenaa";"no";0;0;0;56,415555;10,878055
1829;"Grenaa";"no";0;0;0;56,415555;10,878055
1830;"Grenaa";"no";0;0;0;56,415555;10,878055
1831;"Grenaa";"no";0;0;0;56,415555;10,878055
1832;"Grenaa";"no";1;0;1;56,415555;10,878055
1833;"Grenaa";"no";0;0;0;56,415555;10,878055
1834;"Grenaa";"no";4;1;5;56,415555;10,878055
1835;"Grenaa";"no";1;1;2;56,415555;10,878055
1836;"Grenaa";"no";0;0;0;56,415555;10,878055
1837;"Grenaa";"no";0;0;0;56,415555;10,878055
1838;"Grenaa";"no";0;0;0;56,415555;10,878055
1839;"Grenaa";"no";0;0;0;56,415555;10,878055
1840;"Grenaa";"no";1;0;1;56,415555;10,878055
1841;"Grenaa";"no";2;0;2;56,415555;10,878055
1842;"Grenaa";"no";1;0;1;56,415555;10,878055
1843;"Grenaa";"no";0;3;3;56,415555;10,878055
1844;"Grenaa";"no";3;2;5;56,415555;10,878055
1845;"Grenaa";"no";0;2;2;56,415555;10,878055
1846;"Grenaa";"no";0;1;1;56,415555;10,878055
1847;"Grenaa";"no";4;3;7;56,415555;10,878055
1848;"Grenaa";"no";2;2;4;56,415555;10,878055
1849;"Grenaa";"no";8;8;16;56,415555;10,878055
1850;"Grenaa";"no";5;4;9;56,415555;10,878055
1851;"Grenaa";"no";3;3;6;56,415555;10,878055
1852;"Grenaa";"no";6;3;9;56,415555;10,878055
1853;"Grenaa";"no";0;3;3;56,415555;10,878055
1854;"Grenaa";"no";4;2;6;56,415555;10,878055
1855;"Grenaa";"no";4;4;8;56,415555;10,878055
1856;"Grenaa";"no";17;10;27;56,415555;10,878055
1857;"Grenaa";"no";1;0;1;56,415555;10,878055
1634;"Helnæs";"no";0;0;0;55,133333;10,033333
1635;"Helnæs";"no";4;0;4;55,133333;10,033333
1636;"Helnæs";"no";0;0;0;55,133333;10,033333
1637;"Helnæs";"no";0;0;0;55,133333;10,033333
1638;"Helnæs";"no";0;0;0;55,133333;10,033333
1639;"Helnæs";"no";0;0;0;55,133333;10,033333
1640;"Helnæs";"no";0;0;0;55,133333;10,033333
1641;"Helnæs";"no";0;0;0;55,133333;10,033333
1642;"Helnæs";"no";0;0;0;55,133333;10,033333
1643;"Helnæs";"no";0;0;0;55,133333;10,033333
1644;"Helnæs";"no";0;0;0;55,133333;10,033333
1645;"Helnæs";"no";0;0;0;55,133333;10,033333
1646;"Helnæs";"no";0;0;0;55,133333;10,033333
1647;"Helnæs";"no";0;0;0;55,133333;10,033333
1648;"Helnæs";"no";0;0;0;55,133333;10,033333
1649;"Helnæs";"no";0;0;0;55,133333;10,033333
1650;"Helnæs";"no";0;0;0;55,133333;10,033333
1651;"Helnæs";"no";0;0;0;55,133333;10,033333
1652;"Helnæs";"no";0;0;0;55,133333;10,033333
1653;"Helnæs";"no";0;0;0;55,133333;10,033333
1654;"Helnæs";"no";0;0;0;55,133333;10,033333
1655;"Helnæs";"no";0;0;0;55,133333;10,033333
1656;"Helnæs";"no";0;0;0;55,133333;10,033333
1657;"Helnæs";"no";0;0;0;55,133333;10,033333
1658;"Helnæs";"no";0;0;0;55,133333;10,033333
1659;"Helnæs";"no";0;0;0;55,133333;10,033333
1660;"Helnæs";"no";0;0;0;55,133333;10,033333
1661;"Helnæs";"no";0;0;0;55,133333;10,033333
1662;"Helnæs";"no";0;0;0;55,133333;10,033333
1663;"Helnæs";"no";0;0;0;55,133333;10,033333
1664;"Helnæs";"no";0;0;0;55,133333;10,033333
1665;"Helnæs";"no";0;0;0;55,133333;10,033333
1666;"Helnæs";"no";0;0;0;55,133333;10,033333
1667;"Helnæs";"no";0;0;0;55,133333;10,033333
1668;"Helnæs";"no";0;0;0;55,133333;10,033333
1669;"Helnæs";"no";0;0;0;55,133333;10,033333
1670;"Helnæs";"no";0;0;0;55,133333;10,033333
1671;"Helnæs";"no";0;0;0;55,133333;10,033333
1672;"Helnæs";"no";0;0;0;55,133333;10,033333
1673;"Helnæs";"no";0;0;0;55,133333;10,033333
1674;"Helnæs";"no";0;0;0;55,133333;10,033333
1675;"Helnæs";"no";0;0;0;55,133333;10,033333
1676;"Helnæs";"no";0;0;0;55,133333;10,033333
1677;"Helnæs";"no";0;0;0;55,133333;10,033333
1678;"Helnæs";"no";0;0;0;55,133333;10,033333
1679;"Helnæs";"no";0;0;0;55,133333;10,033333
1680;"Helnæs";"no";0;0;0;55,133333;10,033333
1681;"Helnæs";"no";0;0;0;55,133333;10,033333
1682;"Helnæs";"no";0;0;0;55,133333;10,033333
1683;"Helnæs";"no";0;0;0;55,133333;10,033333
1684;"Helnæs";"no";0;0;0;55,133333;10,033333
1685;"Helnæs";"no";0;0;0;55,133333;10,033333
1686;"Helnæs";"no";0;0;0;55,133333;10,033333
1687;"Helnæs";"no";0;0;0;55,133333;10,033333
1688;"Helnæs";"no";0;0;0;55,133333;10,033333
1689;"Helnæs";"no";0;0;0;55,133333;10,033333
1690;"Helnæs";"no";0;0;0;55,133333;10,033333
1691;"Helnæs";"no";0;0;0;55,133333;10,033333
1692;"Helnæs";"no";0;0;0;55,133333;10,033333
1693;"Helnæs";"no";0;0;0;55,133333;10,033333
1694;"Helnæs";"no";0;0;0;55,133333;10,033333
1695;"Helnæs";"no";0;0;0;55,133333;10,033333
1696;"Helnæs";"no";0;0;0;55,133333;10,033333
1697;"Helnæs";"no";0;0;0;55,133333;10,033333
1698;"Helnæs";"no";0;0;0;55,133333;10,033333
1699;"Helnæs";"no";0;0;0;55,133333;10,033333
1700;"Helnæs";"no";0;0;0;55,133333;10,033333
1701;"Helnæs";"no";0;0;0;55,133333;10,033333
1702;"Helnæs";"no";0;0;0;55,133333;10,033333
1703;"Helnæs";"no";0;0;0;55,133333;10,033333
1704;"Helnæs";"no";0;0;0;55,133333;10,033333
1705;"Helnæs";"no";0;0;0;55,133333;10,033333
1706;"Helnæs";"no";0;0;0;55,133333;10,033333
1707;"Helnæs";"no";0;0;0;55,133333;10,033333
1708;"Helnæs";"no";0;0;0;55,133333;10,033333
1709;"Helnæs";"no";0;0;0;55,133333;10,033333
1710;"Helnæs";"no";0;0;0;55,133333;10,033333
1711;"Helnæs";"no";0;0;0;55,133333;10,033333
1712;"Helnæs";"no";0;0;0;55,133333;10,033333
1713;"Helnæs";"no";0;0;0;55,133333;10,033333
1714;"Helnæs";"no";0;0;0;55,133333;10,033333
1715;"Helnæs";"no";0;0;0;55,133333;10,033333
1716;"Helnæs";"no";0;0;0;55,133333;10,033333
1717;"Helnæs";"no";0;0;0;55,133333;10,033333
1718;"Helnæs";"no";0;0;0;55,133333;10,033333
1719;"Helnæs";"no";0;0;0;55,133333;10,033333
1720;"Helnæs";"no";0;0;0;55,133333;10,033333
1721;"Helnæs";"no";0;0;0;55,133333;10,033333
1722;"Helnæs";"no";0;0;0;55,133333;10,033333
1723;"Helnæs";"no";0;0;0;55,133333;10,033333
1724;"Helnæs";"no";0;0;0;55,133333;10,033333
1725;"Helnæs";"no";0;0;0;55,133333;10,033333
1726;"Helnæs";"no";0;0;0;55,133333;10,033333
1727;"Helnæs";"no";0;0;0;55,133333;10,033333
1728;"Helnæs";"no";0;0;0;55,133333;10,033333
1729;"Helnæs";"no";0;0;0;55,133333;10,033333
1730;"Helnæs";"no";0;0;0;55,133333;10,033333
1731;"Helnæs";"no";0;0;0;55,133333;10,033333
1732;"Helnæs";"no";0;0;0;55,133333;10,033333
1733;"Helnæs";"no";0;0;0;55,133333;10,033333
1734;"Helnæs";"no";0;0;0;55,133333;10,033333
1735;"Helnæs";"no";0;0;0;55,133333;10,033333
1736;"Helnæs";"no";0;0;0;55,133333;10,033333
1737;"Helnæs";"no";0;0;0;55,133333;10,033333
1738;"Helnæs";"no";0;0;0;55,133333;10,033333
1739;"Helnæs";"no";0;0;0;55,133333;10,033333
1740;"Helnæs";"no";0;0;0;55,133333;10,033333
1741;"Helnæs";"no";0;0;0;55,133333;10,033333
1742;"Helnæs";"no";0;0;0;55,133333;10,033333
1743;"Helnæs";"no";0;0;0;55,133333;10,033333
1744;"Helnæs";"no";0;0;0;55,133333;10,033333
1745;"Helnæs";"no";0;0;0;55,133333;10,033333
1746;"Helnæs";"no";0;0;0;55,133333;10,033333
1747;"Helnæs";"no";0;0;0;55,133333;10,033333
1748;"Helnæs";"no";0;0;0;55,133333;10,033333
1749;"Helnæs";"no";0;0;0;55,133333;10,033333
1750;"Helnæs";"no";0;0;0;55,133333;10,033333
1751;"Helnæs";"no";0;0;0;55,133333;10,033333
1752;"Helnæs";"no";0;0;0;55,133333;10,033333
1753;"Helnæs";"no";0;0;0;55,133333;10,033333
1754;"Helnæs";"no";0;0;0;55,133333;10,033333
1755;"Helnæs";"no";0;0;0;55,133333;10,033333
1756;"Helnæs";"no";0;0;0;55,133333;10,033333
1757;"Helnæs";"no";0;0;0;55,133333;10,033333
1758;"Helnæs";"no";0;0;0;55,133333;10,033333
1759;"Helnæs";"no";0;0;0;55,133333;10,033333
1760;"Helnæs";"no";0;0;0;55,133333;10,033333
1761;"Helnæs";"no";0;0;0;55,133333;10,033333
1762;"Helnæs";"no";0;0;0;55,133333;10,033333
1763;"Helnæs";"no";0;0;0;55,133333;10,033333
1764;"Helnæs";"no";0;0;0;55,133333;10,033333
1765;"Helnæs";"no";0;0;0;55,133333;10,033333
1766;"Helnæs";"no";0;0;0;55,133333;10,033333
1767;"Helnæs";"no";0;0;0;55,133333;10,033333
1768;"Helnæs";"no";0;0;0;55,133333;10,033333
1769;"Helnæs";"no";0;0;0;55,133333;10,033333
1770;"Helnæs";"no";0;0;0;55,133333;10,033333
1771;"Helnæs";"no";0;0;0;55,133333;10,033333
1772;"Helnæs";"no";0;0;0;55,133333;10,033333
1773;"Helnæs";"no";0;0;0;55,133333;10,033333
1774;"Helnæs";"no";0;0;0;55,133333;10,033333
1775;"Helnæs";"no";0;0;0;55,133333;10,033333
1776;"Helnæs";"no";0;0;0;55,133333;10,033333
1777;"Helnæs";"no";0;0;0;55,133333;10,033333
1778;"Helnæs";"no";0;0;0;55,133333;10,033333
1779;"Helnæs";"no";0;0;0;55,133333;10,033333
1780;"Helnæs";"no";0;0;0;55,133333;10,033333
1781;"Helnæs";"no";0;0;0;55,133333;10,033333
1782;"Helnæs";"no";0;0;0;55,133333;10,033333
1783;"Helnæs";"no";0;0;0;55,133333;10,033333
1784;"Helnæs";"no";0;0;0;55,133333;10,033333
1785;"Helnæs";"no";0;0;0;55,133333;10,033333
1786;"Helnæs";"no";0;0;0;55,133333;10,033333
1787;"Helnæs";"no";0;0;0;55,133333;10,033333
1788;"Helnæs";"no";0;0;0;55,133333;10,033333
1789;"Helnæs";"no";0;0;0;55,133333;10,033333
1790;"Helnæs";"no";0;0;0;55,133333;10,033333
1791;"Helnæs";"no";0;0;0;55,133333;10,033333
1792;"Helnæs";"no";0;0;0;55,133333;10,033333
1793;"Helnæs";"no";0;0;0;55,133333;10,033333
1794;"Helnæs";"no";0;0;0;55,133333;10,033333
1795;"Helnæs";"no";0;0;0;55,133333;10,033333
1796;"Helnæs";"no";0;0;0;55,133333;10,033333
1797;"Helnæs";"no";0;0;0;55,133333;10,033333
1798;"Helnæs";"no";0;0;0;55,133333;10,033333
1799;"Helnæs";"no";0;0;0;55,133333;10,033333
1800;"Helnæs";"no";0;0;0;55,133333;10,033333
1801;"Helnæs";"no";0;0;0;55,133333;10,033333
1802;"Helnæs";"no";0;0;0;55,133333;10,033333
1803;"Helnæs";"no";0;0;0;55,133333;10,033333
1804;"Helnæs";"no";0;0;0;55,133333;10,033333
1805;"Helnæs";"no";0;0;0;55,133333;10,033333
1806;"Helnæs";"no";0;0;0;55,133333;10,033333
1807;"Helnæs";"no";0;0;0;55,133333;10,033333
1808;"Helnæs";"no";0;0;0;55,133333;10,033333
1809;"Helnæs";"no";0;0;0;55,133333;10,033333
1810;"Helnæs";"no";0;0;0;55,133333;10,033333
1811;"Helnæs";"no";0;0;0;55,133333;10,033333
1812;"Helnæs";"no";0;0;0;55,133333;10,033333
1813;"Helnæs";"no";0;0;0;55,133333;10,033333
1814;"Helnæs";"no";0;0;0;55,133333;10,033333
1815;"Helnæs";"no";0;0;0;55,133333;10,033333
1816;"Helnæs";"no";0;0;0;55,133333;10,033333
1817;"Helnæs";"no";0;0;0;55,133333;10,033333
1818;"Helnæs";"no";0;0;0;55,133333;10,033333
1819;"Helnæs";"no";0;0;0;55,133333;10,033333
1820;"Helnæs";"no";0;0;0;55,133333;10,033333
1821;"Helnæs";"no";0;0;0;55,133333;10,033333
1822;"Helnæs";"no";0;0;0;55,133333;10,033333
1823;"Helnæs";"no";0;0;0;55,133333;10,033333
1824;"Helnæs";"no";0;0;0;55,133333;10,033333
1825;"Helnæs";"no";0;0;0;55,133333;10,033333
1826;"Helnæs";"no";0;0;0;55,133333;10,033333
1827;"Helnæs";"no";0;0;0;55,133333;10,033333
1828;"Helnæs";"no";0;0;0;55,133333;10,033333
1829;"Helnæs";"no";0;0;0;55,133333;10,033333
1830;"Helnæs";"no";0;0;0;55,133333;10,033333
1831;"Helnæs";"no";0;0;0;55,133333;10,033333
1832;"Helnæs";"no";0;0;0;55,133333;10,033333
1833;"Helnæs";"no";0;0;0;55,133333;10,033333
1834;"Helnæs";"no";0;0;0;55,133333;10,033333
1835;"Helnæs";"no";0;0;0;55,133333;10,033333
1836;"Helnæs";"no";0;0;0;55,133333;10,033333
1837;"Helnæs";"no";0;0;0;55,133333;10,033333
1838;"Helnæs";"no";0;0;0;55,133333;10,033333
1839;"Helnæs";"no";0;0;0;55,133333;10,033333
1840;"Helnæs";"no";0;0;0;55,133333;10,033333
1841;"Helnæs";"no";0;0;0;55,133333;10,033333
1842;"Helnæs";"no";0;0;0;55,133333;10,033333
1843;"Helnæs";"no";0;0;0;55,133333;10,033333
1844;"Helnæs";"no";0;0;0;55,133333;10,033333
1845;"Helnæs";"no";0;0;0;55,133333;10,033333
1846;"Helnæs";"no";0;0;0;55,133333;10,033333
1847;"Helnæs";"no";0;0;0;55,133333;10,033333
1848;"Helnæs";"no";0;0;0;55,133333;10,033333
1849;"Helnæs";"no";0;0;0;55,133333;10,033333
1850;"Helnæs";"no";0;0;0;55,133333;10,033333
1851;"Helnæs";"no";0;0;0;55,133333;10,033333
1852;"Helnæs";"no";0;0;0;55,133333;10,033333
1853;"Helnæs";"no";0;0;0;55,133333;10,033333
1854;"Helnæs";"no";0;0;0;55,133333;10,033333
1855;"Helnæs";"no";0;0;0;55,133333;10,033333
1856;"Helnæs";"no";0;0;0;55,133333;10,033333
1857;"Helnæs";"no";0;0;0;55,133333;10,033333
1634;"Hirtsholmene";"no";0;0;0;57,490555;10,612222
1635;"Hirtsholmene";"no";1;0;1;57,490555;10,612222
1636;"Hirtsholmene";"no";0;0;0;57,490555;10,612222
1637;"Hirtsholmene";"no";0;0;0;57,490555;10,612222
1638;"Hirtsholmene";"no";0;0;0;57,490555;10,612222
1639;"Hirtsholmene";"no";0;0;0;57,490555;10,612222
1640;"Hirtsholmene";"no";0;0;0;57,490555;10,612222
1641;"Hirtsholmene";"no";0;0;0;57,490555;10,612222
1642;"Hirtsholmene";"no";0;0;0;57,490555;10,612222
1643;"Hirtsholmene";"no";0;0;0;57,490555;10,612222
1644;"Hirtsholmene";"no";0;0;0;57,490555;10,612222
1645;"Hirtsholmene";"no";0;0;0;57,490555;10,612222
1646;"Hirtsholmene";"no";0;0;0;57,490555;10,612222
1647;"Hirtsholmene";"no";0;0;0;57,490555;10,612222
1648;"Hirtsholmene";"no";0;0;0;57,490555;10,612222
1649;"Hirtsholmene";"no";0;0;0;57,490555;10,612222
1650;"Hirtsholmene";"no";0;0;0;57,490555;10,612222
1651;"Hirtsholmene";"no";0;0;0;57,490555;10,612222
1652;"Hirtsholmene";"no";0;0;0;57,490555;10,612222
1653;"Hirtsholmene";"no";0;0;0;57,490555;10,612222
1654;"Hirtsholmene";"no";0;0;0;57,490555;10,612222
1655;"Hirtsholmene";"no";0;0;0;57,490555;10,612222
1656;"Hirtsholmene";"no";0;0;0;57,490555;10,612222
1657;"Hirtsholmene";"no";0;0;0;57,490555;10,612222
1658;"Hirtsholmene";"no";0;0;0;57,490555;10,612222
1659;"Hirtsholmene";"no";0;0;0;57,490555;10,612222
1660;"Hirtsholmene";"no";0;0;0;57,490555;10,612222
1661;"Hirtsholmene";"no";0;0;0;57,490555;10,612222
1662;"Hirtsholmene";"no";0;0;0;57,490555;10,612222
1663;"Hirtsholmene";"no";0;0;0;57,490555;10,612222
1664;"Hirtsholmene";"no";0;0;0;57,490555;10,612222
1665;"Hirtsholmene";"no";0;0;0;57,490555;10,612222
1666;"Hirtsholmene";"no";0;0;0;57,490555;10,612222
1667;"Hirtsholmene";"no";0;0;0;57,490555;10,612222
1668;"Hirtsholmene";"no";0;0;0;57,490555;10,612222
1669;"Hirtsholmene";"no";0;0;0;57,490555;10,612222
1670;"Hirtsholmene";"no";0;0;0;57,490555;10,612222
1671;"Hirtsholmene";"no";0;0;0;57,490555;10,612222
1672;"Hirtsholmene";"no";0;0;0;57,490555;10,612222
1673;"Hirtsholmene";"no";0;0;0;57,490555;10,612222
1674;"Hirtsholmene";"no";0;0;0;57,490555;10,612222
1675;"Hirtsholmene";"no";0;0;0;57,490555;10,612222
1676;"Hirtsholmene";"no";0;0;0;57,490555;10,612222
1677;"Hirtsholmene";"no";0;0;0;57,490555;10,612222
1678;"Hirtsholmene";"no";0;0;0;57,490555;10,612222
1679;"Hirtsholmene";"no";0;0;0;57,490555;10,612222
1680;"Hirtsholmene";"no";0;0;0;57,490555;10,612222
1681;"Hirtsholmene";"no";0;0;0;57,490555;10,612222
1682;"Hirtsholmene";"no";0;0;0;57,490555;10,612222
1683;"Hirtsholmene";"no";0;0;0;57,490555;10,612222
1684;"Hirtsholmene";"no";0;0;0;57,490555;10,612222
1685;"Hirtsholmene";"no";0;0;0;57,490555;10,612222
1686;"Hirtsholmene";"no";0;0;0;57,490555;10,612222
1687;"Hirtsholmene";"no";0;0;0;57,490555;10,612222
1688;"Hirtsholmene";"no";0;0;0;57,490555;10,612222
1689;"Hirtsholmene";"no";0;0;0;57,490555;10,612222
1690;"Hirtsholmene";"no";0;0;0;57,490555;10,612222
1691;"Hirtsholmene";"no";0;0;0;57,490555;10,612222
1692;"Hirtsholmene";"no";0;0;0;57,490555;10,612222
1693;"Hirtsholmene";"no";0;0;0;57,490555;10,612222
1694;"Hirtsholmene";"no";0;0;0;57,490555;10,612222
1695;"Hirtsholmene";"no";0;0;0;57,490555;10,612222
1696;"Hirtsholmene";"no";0;0;0;57,490555;10,612222
1697;"Hirtsholmene";"no";0;0;0;57,490555;10,612222
1698;"Hirtsholmene";"no";0;0;0;57,490555;10,612222
1699;"Hirtsholmene";"no";0;0;0;57,490555;10,612222
1700;"Hirtsholmene";"no";0;0;0;57,490555;10,612222
1701;"Hirtsholmene";"no";0;0;0;57,490555;10,612222
1702;"Hirtsholmene";"no";0;0;0;57,490555;10,612222
1703;"Hirtsholmene";"no";0;0;0;57,490555;10,612222
1704;"Hirtsholmene";"no";0;0;0;57,490555;10,612222
1705;"Hirtsholmene";"no";0;0;0;57,490555;10,612222
1706;"Hirtsholmene";"no";0;0;0;57,490555;10,612222
1707;"Hirtsholmene";"no";0;0;0;57,490555;10,612222
1708;"Hirtsholmene";"no";0;0;0;57,490555;10,612222
1709;"Hirtsholmene";"no";0;0;0;57,490555;10,612222
1710;"Hirtsholmene";"no";0;0;0;57,490555;10,612222
1711;"Hirtsholmene";"no";0;0;0;57,490555;10,612222
1712;"Hirtsholmene";"no";0;0;0;57,490555;10,612222
1713;"Hirtsholmene";"no";0;0;0;57,490555;10,612222
1714;"Hirtsholmene";"no";0;0;0;57,490555;10,612222
1715;"Hirtsholmene";"no";0;0;0;57,490555;10,612222
1716;"Hirtsholmene";"no";0;0;0;57,490555;10,612222
1717;"Hirtsholmene";"no";0;0;0;57,490555;10,612222
1718;"Hirtsholmene";"no";0;0;0;57,490555;10,612222
1719;"Hirtsholmene";"no";0;0;0;57,490555;10,612222
1720;"Hirtsholmene";"no";0;0;0;57,490555;10,612222
1721;"Hirtsholmene";"no";0;0;0;57,490555;10,612222
1722;"Hirtsholmene";"no";0;0;0;57,490555;10,612222
1723;"Hirtsholmene";"no";0;0;0;57,490555;10,612222
1724;"Hirtsholmene";"no";0;0;0;57,490555;10,612222
1725;"Hirtsholmene";"no";0;0;0;57,490555;10,612222
1726;"Hirtsholmene";"no";0;0;0;57,490555;10,612222
1727;"Hirtsholmene";"no";0;0;0;57,490555;10,612222
1728;"Hirtsholmene";"no";0;0;0;57,490555;10,612222
1729;"Hirtsholmene";"no";0;0;0;57,490555;10,612222
1730;"Hirtsholmene";"no";0;0;0;57,490555;10,612222
1731;"Hirtsholmene";"no";0;0;0;57,490555;10,612222
1732;"Hirtsholmene";"no";0;0;0;57,490555;10,612222
1733;"Hirtsholmene";"no";0;0;0;57,490555;10,612222
1734;"Hirtsholmene";"no";0;0;0;57,490555;10,612222
1735;"Hirtsholmene";"no";0;0;0;57,490555;10,612222
1736;"Hirtsholmene";"no";0;0;0;57,490555;10,612222
1737;"Hirtsholmene";"no";0;0;0;57,490555;10,612222
1738;"Hirtsholmene";"no";0;0;0;57,490555;10,612222
1739;"Hirtsholmene";"no";0;0;0;57,490555;10,612222
1740;"Hirtsholmene";"no";0;0;0;57,490555;10,612222
1741;"Hirtsholmene";"no";0;0;0;57,490555;10,612222
1742;"Hirtsholmene";"no";0;0;0;57,490555;10,612222
1743;"Hirtsholmene";"no";0;0;0;57,490555;10,612222
1744;"Hirtsholmene";"no";0;0;0;57,490555;10,612222
1745;"Hirtsholmene";"no";0;0;0;57,490555;10,612222
1746;"Hirtsholmene";"no";0;0;0;57,490555;10,612222
1747;"Hirtsholmene";"no";0;0;0;57,490555;10,612222
1748;"Hirtsholmene";"no";0;0;0;57,490555;10,612222
1749;"Hirtsholmene";"no";0;0;0;57,490555;10,612222
1750;"Hirtsholmene";"no";0;0;0;57,490555;10,612222
1751;"Hirtsholmene";"no";0;0;0;57,490555;10,612222
1752;"Hirtsholmene";"no";0;0;0;57,490555;10,612222
1753;"Hirtsholmene";"no";0;0;0;57,490555;10,612222
1754;"Hirtsholmene";"no";0;0;0;57,490555;10,612222
1755;"Hirtsholmene";"no";0;0;0;57,490555;10,612222
1756;"Hirtsholmene";"no";0;0;0;57,490555;10,612222
1757;"Hirtsholmene";"no";0;0;0;57,490555;10,612222
1758;"Hirtsholmene";"no";0;0;0;57,490555;10,612222
1759;"Hirtsholmene";"no";0;0;0;57,490555;10,612222
1760;"Hirtsholmene";"no";0;0;0;57,490555;10,612222
1761;"Hirtsholmene";"no";0;0;0;57,490555;10,612222
1762;"Hirtsholmene";"no";0;0;0;57,490555;10,612222
1763;"Hirtsholmene";"no";0;0;0;57,490555;10,612222
1764;"Hirtsholmene";"no";0;0;0;57,490555;10,612222
1765;"Hirtsholmene";"no";0;0;0;57,490555;10,612222
1766;"Hirtsholmene";"no";0;0;0;57,490555;10,612222
1767;"Hirtsholmene";"no";0;0;0;57,490555;10,612222
1768;"Hirtsholmene";"no";0;0;0;57,490555;10,612222
1769;"Hirtsholmene";"no";0;0;0;57,490555;10,612222
1770;"Hirtsholmene";"no";0;0;0;57,490555;10,612222
1771;"Hirtsholmene";"no";0;0;0;57,490555;10,612222
1772;"Hirtsholmene";"no";0;0;0;57,490555;10,612222
1773;"Hirtsholmene";"no";0;0;0;57,490555;10,612222
1774;"Hirtsholmene";"no";0;0;0;57,490555;10,612222
1775;"Hirtsholmene";"no";0;0;0;57,490555;10,612222
1776;"Hirtsholmene";"no";0;0;0;57,490555;10,612222
1777;"Hirtsholmene";"no";0;0;0;57,490555;10,612222
1778;"Hirtsholmene";"no";0;0;0;57,490555;10,612222
1779;"Hirtsholmene";"no";0;0;0;57,490555;10,612222
1780;"Hirtsholmene";"no";0;0;0;57,490555;10,612222
1781;"Hirtsholmene";"no";0;0;0;57,490555;10,612222
1782;"Hirtsholmene";"no";0;0;0;57,490555;10,612222
1783;"Hirtsholmene";"no";0;0;0;57,490555;10,612222
1784;"Hirtsholmene";"no";0;0;0;57,490555;10,612222
1785;"Hirtsholmene";"no";0;0;0;57,490555;10,612222
1786;"Hirtsholmene";"no";0;0;0;57,490555;10,612222
1787;"Hirtsholmene";"no";0;0;0;57,490555;10,612222
1788;"Hirtsholmene";"no";0;0;0;57,490555;10,612222
1789;"Hirtsholmene";"no";0;0;0;57,490555;10,612222
1790;"Hirtsholmene";"no";0;0;0;57,490555;10,612222
1791;"Hirtsholmene";"no";0;0;0;57,490555;10,612222
1792;"Hirtsholmene";"no";0;0;0;57,490555;10,612222
1793;"Hirtsholmene";"no";0;0;0;57,490555;10,612222
1794;"Hirtsholmene";"no";0;0;0;57,490555;10,612222
1795;"Hirtsholmene";"no";0;0;0;57,490555;10,612222
1796;"Hirtsholmene";"no";0;0;0;57,490555;10,612222
1797;"Hirtsholmene";"no";0;0;0;57,490555;10,612222
1798;"Hirtsholmene";"no";0;0;0;57,490555;10,612222
1799;"Hirtsholmene";"no";0;0;0;57,490555;10,612222
1800;"Hirtsholmene";"no";0;0;0;57,490555;10,612222
1801;"Hirtsholmene";"no";0;0;0;57,490555;10,612222
1802;"Hirtsholmene";"no";0;0;0;57,490555;10,612222
1803;"Hirtsholmene";"no";0;0;0;57,490555;10,612222
1804;"Hirtsholmene";"no";0;0;0;57,490555;10,612222
1805;"Hirtsholmene";"no";0;0;0;57,490555;10,612222
1806;"Hirtsholmene";"no";0;0;0;57,490555;10,612222
1807;"Hirtsholmene";"no";0;0;0;57,490555;10,612222
1808;"Hirtsholmene";"no";0;0;0;57,490555;10,612222
1809;"Hirtsholmene";"no";0;0;0;57,490555;10,612222
1810;"Hirtsholmene";"no";0;0;0;57,490555;10,612222
1811;"Hirtsholmene";"no";0;0;0;57,490555;10,612222
1812;"Hirtsholmene";"no";0;0;0;57,490555;10,612222
1813;"Hirtsholmene";"no";0;0;0;57,490555;10,612222
1814;"Hirtsholmene";"no";0;0;0;57,490555;10,612222
1815;"Hirtsholmene";"no";0;0;0;57,490555;10,612222
1816;"Hirtsholmene";"no";0;0;0;57,490555;10,612222
1817;"Hirtsholmene";"no";0;0;0;57,490555;10,612222
1818;"Hirtsholmene";"no";0;0;0;57,490555;10,612222
1819;"Hirtsholmene";"no";0;0;0;57,490555;10,612222
1820;"Hirtsholmene";"no";0;0;0;57,490555;10,612222
1821;"Hirtsholmene";"no";0;0;0;57,490555;10,612222
1822;"Hirtsholmene";"no";0;0;0;57,490555;10,612222
1823;"Hirtsholmene";"no";0;0;0;57,490555;10,612222
1824;"Hirtsholmene";"no";0;0;0;57,490555;10,612222
1825;"Hirtsholmene";"no";0;0;0;57,490555;10,612222
1826;"Hirtsholmene";"no";0;0;0;57,490555;10,612222
1827;"Hirtsholmene";"no";0;0;0;57,490555;10,612222
1828;"Hirtsholmene";"no";0;0;0;57,490555;10,612222
1829;"Hirtsholmene";"no";0;0;0;57,490555;10,612222
1830;"Hirtsholmene";"no";0;0;0;57,490555;10,612222
1831;"Hirtsholmene";"no";0;0;0;57,490555;10,612222
1832;"Hirtsholmene";"no";0;0;0;57,490555;10,612222
1833;"Hirtsholmene";"no";0;0;0;57,490555;10,612222
1834;"Hirtsholmene";"no";0;0;0;57,490555;10,612222
1835;"Hirtsholmene";"no";0;0;0;57,490555;10,612222
1836;"Hirtsholmene";"no";0;0;0;57,490555;10,612222
1837;"Hirtsholmene";"no";0;0;0;57,490555;10,612222
1838;"Hirtsholmene";"no";0;0;0;57,490555;10,612222
1839;"Hirtsholmene";"no";0;0;0;57,490555;10,612222
1840;"Hirtsholmene";"no";0;0;0;57,490555;10,612222
1841;"Hirtsholmene";"no";0;0;0;57,490555;10,612222
1842;"Hirtsholmene";"no";0;0;0;57,490555;10,612222
1843;"Hirtsholmene";"no";0;0;0;57,490555;10,612222
1844;"Hirtsholmene";"no";0;0;0;57,490555;10,612222
1845;"Hirtsholmene";"no";0;0;0;57,490555;10,612222
1846;"Hirtsholmene";"no";0;0;0;57,490555;10,612222
1847;"Hirtsholmene";"no";0;0;0;57,490555;10,612222
1848;"Hirtsholmene";"no";0;0;0;57,490555;10,612222
1849;"Hirtsholmene";"no";0;0;0;57,490555;10,612222
1850;"Hirtsholmene";"no";0;0;0;57,490555;10,612222
1851;"Hirtsholmene";"no";0;0;0;57,490555;10,612222
1852;"Hirtsholmene";"no";0;0;0;57,490555;10,612222
1853;"Hirtsholmene";"no";0;0;0;57,490555;10,612222
1854;"Hirtsholmene";"no";0;0;0;57,490555;10,612222
1855;"Hirtsholmene";"no";0;0;0;57,490555;10,612222
1856;"Hirtsholmene";"no";0;0;0;57,490555;10,612222
1857;"Hirtsholmene";"no";0;0;0;57,490555;10,612222
1634;"Holbæk";"no";0;1;1;55,716666;11,716666
1635;"Holbæk";"no";3;1;4;55,716666;11,716666
1636;"Holbæk";"no";2;1;3;55,716666;11,716666
1637;"Holbæk";"no";2;5;7;55,716666;11,716666
1638;"Holbæk";"no";1;1;2;55,716666;11,716666
1639;"Holbæk";"no";4;1;5;55,716666;11,716666
1640;"Holbæk";"no";2;3;5;55,716666;11,716666
1641;"Holbæk";"no";4;1;5;55,716666;11,716666
1642;"Holbæk";"no";1;2;3;55,716666;11,716666
1643;"Holbæk";"no";1;13;14;55,716666;11,716666
1644;"Holbæk";"no";2;1;3;55,716666;11,716666
1645;"Holbæk";"no";0;1;1;55,716666;11,716666
1646;"Holbæk";"no";3;3;6;55,716666;11,716666
1647;"Holbæk";"no";3;3;6;55,716666;11,716666
1648;"Holbæk";"no";4;6;10;55,716666;11,716666
1649;"Holbæk";"no";1;3;4;55,716666;11,716666
1650;"Holbæk";"no";1;3;4;55,716666;11,716666
1651;"Holbæk";"no";2;8;10;55,716666;11,716666
1652;"Holbæk";"no";1;1;2;55,716666;11,716666
1653;"Holbæk";"no";0;4;4;55,716666;11,716666
1654;"Holbæk";"no";1;2;3;55,716666;11,716666
1655;"Holbæk";"no";0;1;1;55,716666;11,716666
1656;"Holbæk";"no";0;2;2;55,716666;11,716666
1657;"Holbæk";"no";1;1;2;55,716666;11,716666
1658;"Holbæk";"no";0;1;1;55,716666;11,716666
1659;"Holbæk";"no";0;0;0;55,716666;11,716666
1660;"Holbæk";"no";0;0;0;55,716666;11,716666
1661;"Holbæk";"no";1;0;1;55,716666;11,716666
1662;"Holbæk";"no";1;1;2;55,716666;11,716666
1663;"Holbæk";"no";0;7;7;55,716666;11,716666
1664;"Holbæk";"no";2;7;9;55,716666;11,716666
1665;"Holbæk";"no";5;3;8;55,716666;11,716666
1666;"Holbæk";"no";2;1;3;55,716666;11,716666
1667;"Holbæk";"no";2;1;3;55,716666;11,716666
1668;"Holbæk";"no";2;5;7;55,716666;11,716666
1669;"Holbæk";"no";0;6;6;55,716666;11,716666
1670;"Holbæk";"no";3;9;12;55,716666;11,716666
1671;"Holbæk";"no";1;2;3;55,716666;11,716666
1672;"Holbæk";"no";0;5;5;55,716666;11,716666
1673;"Holbæk";"no";0;3;3;55,716666;11,716666
1674;"Holbæk";"no";2;13;15;55,716666;11,716666
1675;"Holbæk";"no";0;7;7;55,716666;11,716666
1676;"Holbæk";"no";0;2;2;55,716666;11,716666
1677;"Holbæk";"no";0;0;0;55,716666;11,716666
1678;"Holbæk";"no";1;1;2;55,716666;11,716666
1679;"Holbæk";"no";1;2;3;55,716666;11,716666
1680;"Holbæk";"no";0;0;0;55,716666;11,716666
1681;"Holbæk";"no";0;2;2;55,716666;11,716666
1682;"Holbæk";"no";0;6;6;55,716666;11,716666
1683;"Holbæk";"no";0;1;1;55,716666;11,716666
1684;"Holbæk";"no";0;0;0;55,716666;11,716666
1685;"Holbæk";"no";0;0;0;55,716666;11,716666
1686;"Holbæk";"no";1;1;2;55,716666;11,716666
1687;"Holbæk";"no";0;1;1;55,716666;11,716666
1688;"Holbæk";"no";0;2;2;55,716666;11,716666
1689;"Holbæk";"no";0;4;4;55,716666;11,716666
1690;"Holbæk";"no";0;1;1;55,716666;11,716666
1691;"Holbæk";"no";0;1;1;55,716666;11,716666
1692;"Holbæk";"no";0;4;4;55,716666;11,716666
1693;"Holbæk";"no";0;3;3;55,716666;11,716666
1694;"Holbæk";"no";0;4;4;55,716666;11,716666
1695;"Holbæk";"no";0;6;6;55,716666;11,716666
1696;"Holbæk";"no";1;6;7;55,716666;11,716666
1697;"Holbæk";"no";0;2;2;55,716666;11,716666
1698;"Holbæk";"no";0;3;3;55,716666;11,716666
1699;"Holbæk";"no";0;7;7;55,716666;11,716666
1700;"Holbæk";"no";0;1;1;55,716666;11,716666
1701;"Holbæk";"no";0;1;1;55,716666;11,716666
1702;"Holbæk";"no";0;0;0;55,716666;11,716666
1703;"Holbæk";"no";0;0;0;55,716666;11,716666
1704;"Holbæk";"no";0;1;1;55,716666;11,716666
1705;"Holbæk";"no";0;4;4;55,716666;11,716666
1706;"Holbæk";"no";0;6;6;55,716666;11,716666
1707;"Holbæk";"no";0;1;1;55,716666;11,716666
1708;"Holbæk";"no";0;2;2;55,716666;11,716666
1709;"Holbæk";"no";0;3;3;55,716666;11,716666
1710;"Holbæk";"no";0;3;3;55,716666;11,716666
1711;"Holbæk";"no";0;1;1;55,716666;11,716666
1712;"Holbæk";"no";1;0;1;55,716666;11,716666
1713;"Holbæk";"no";0;2;2;55,716666;11,716666
1714;"Holbæk";"no";0;0;0;55,716666;11,716666
1715;"Holbæk";"no";0;0;0;55,716666;11,716666
1716;"Holbæk";"no";0;0;0;55,716666;11,716666
1717;"Holbæk";"no";0;1;1;55,716666;11,716666
1718;"Holbæk";"no";0;0;0;55,716666;11,716666
1719;"Holbæk";"no";0;0;0;55,716666;11,716666
1720;"Holbæk";"no";0;0;0;55,716666;11,716666
1721;"Holbæk";"no";0;0;0;55,716666;11,716666
1722;"Holbæk";"no";0;0;0;55,716666;11,716666
1723;"Holbæk";"no";0;0;0;55,716666;11,716666
1724;"Holbæk";"no";0;1;1;55,716666;11,716666
1725;"Holbæk";"no";0;0;0;55,716666;11,716666
1726;"Holbæk";"no";0;2;2;55,716666;11,716666
1727;"Holbæk";"no";0;0;0;55,716666;11,716666
1728;"Holbæk";"no";0;0;0;55,716666;11,716666
1729;"Holbæk";"no";0;1;1;55,716666;11,716666
1730;"Holbæk";"no";0;0;0;55,716666;11,716666
1731;"Holbæk";"no";0;1;1;55,716666;11,716666
1732;"Holbæk";"no";0;1;1;55,716666;11,716666
1733;"Holbæk";"no";0;1;1;55,716666;11,716666
1734;"Holbæk";"no";0;2;2;55,716666;11,716666
1735;"Holbæk";"no";0;2;2;55,716666;11,716666
1736;"Holbæk";"no";0;1;1;55,716666;11,716666
1737;"Holbæk";"no";0;4;4;55,716666;11,716666
1738;"Holbæk";"no";1;5;6;55,716666;11,716666
1739;"Holbæk";"no";0;3;3;55,716666;11,716666
1740;"Holbæk";"no";0;6;6;55,716666;11,716666
1741;"Holbæk";"no";0;5;5;55,716666;11,716666
1742;"Holbæk";"no";0;3;3;55,716666;11,716666
1743;"Holbæk";"no";0;4;4;55,716666;11,716666
1744;"Holbæk";"no";0;1;1;55,716666;11,716666
1745;"Holbæk";"no";0;1;1;55,716666;11,716666
1746;"Holbæk";"no";0;1;1;55,716666;11,716666
1747;"Holbæk";"no";0;0;0;55,716666;11,716666
1748;"Holbæk";"no";0;0;0;55,716666;11,716666
1749;"Holbæk";"no";0;2;2;55,716666;11,716666
1750;"Holbæk";"no";0;4;4;55,716666;11,716666
1751;"Holbæk";"no";0;3;3;55,716666;11,716666
1752;"Holbæk";"no";0;2;2;55,716666;11,716666
1753;"Holbæk";"no";0;0;0;55,716666;11,716666
1754;"Holbæk";"no";0;0;0;55,716666;11,716666
1755;"Holbæk";"no";0;1;1;55,716666;11,716666
1756;"Holbæk";"no";0;2;2;55,716666;11,716666
1757;"Holbæk";"no";0;0;0;55,716666;11,716666
1758;"Holbæk";"no";0;0;0;55,716666;11,716666
1759;"Holbæk";"no";0;0;0;55,716666;11,716666
1760;"Holbæk";"no";0;0;0;55,716666;11,716666
1761;"Holbæk";"no";0;0;0;55,716666;11,716666
1762;"Holbæk";"no";0;0;0;55,716666;11,716666
1763;"Holbæk";"no";0;0;0;55,716666;11,716666
1764;"Holbæk";"no";0;0;0;55,716666;11,716666
1765;"Holbæk";"no";0;0;0;55,716666;11,716666
1766;"Holbæk";"no";0;0;0;55,716666;11,716666
1767;"Holbæk";"no";0;0;0;55,716666;11,716666
1768;"Holbæk";"no";0;0;0;55,716666;11,716666
1769;"Holbæk";"no";0;0;0;55,716666;11,716666
1770;"Holbæk";"no";0;0;0;55,716666;11,716666
1771;"Holbæk";"no";0;0;0;55,716666;11,716666
1772;"Holbæk";"no";0;0;0;55,716666;11,716666
1773;"Holbæk";"no";0;0;0;55,716666;11,716666
1774;"Holbæk";"no";0;2;2;55,716666;11,716666
1775;"Holbæk";"no";0;3;3;55,716666;11,716666
1776;"Holbæk";"no";0;0;0;55,716666;11,716666
1777;"Holbæk";"no";0;0;0;55,716666;11,716666
1778;"Holbæk";"no";0;0;0;55,716666;11,716666
1779;"Holbæk";"no";0;0;0;55,716666;11,716666
1780;"Holbæk";"no";0;1;1;55,716666;11,716666
1781;"Holbæk";"no";0;1;1;55,716666;11,716666
1782;"Holbæk";"no";0;0;0;55,716666;11,716666
1783;"Holbæk";"no";0;0;0;55,716666;11,716666
1784;"Holbæk";"no";0;0;0;55,716666;11,716666
1785;"Holbæk";"no";0;0;0;55,716666;11,716666
1786;"Holbæk";"no";0;2;2;55,716666;11,716666
1787;"Holbæk";"no";0;0;0;55,716666;11,716666
1788;"Holbæk";"no";0;0;0;55,716666;11,716666
1789;"Holbæk";"no";0;0;0;55,716666;11,716666
1790;"Holbæk";"no";0;1;1;55,716666;11,716666
1791;"Holbæk";"no";0;1;1;55,716666;11,716666
1792;"Holbæk";"no";0;2;2;55,716666;11,716666
1793;"Holbæk";"no";0;2;2;55,716666;11,716666
1794;"Holbæk";"no";0;3;3;55,716666;11,716666
1795;"Holbæk";"no";0;2;2;55,716666;11,716666
1796;"Holbæk";"no";0;1;1;55,716666;11,716666
1797;"Holbæk";"no";0;0;0;55,716666;11,716666
1798;"Holbæk";"no";0;0;0;55,716666;11,716666
1799;"Holbæk";"no";0;0;0;55,716666;11,716666
1800;"Holbæk";"no";0;0;0;55,716666;11,716666
1801;"Holbæk";"no";0;1;1;55,716666;11,716666
1802;"Holbæk";"no";0;0;0;55,716666;11,716666
1803;"Holbæk";"no";0;0;0;55,716666;11,716666
1804;"Holbæk";"no";0;1;1;55,716666;11,716666
1805;"Holbæk";"no";0;0;0;55,716666;11,716666
1806;"Holbæk";"no";0;0;0;55,716666;11,716666
1807;"Holbæk";"no";0;3;3;55,716666;11,716666
1808;"Holbæk";"no";0;0;0;55,716666;11,716666
1809;"Holbæk";"no";0;0;0;55,716666;11,716666
1810;"Holbæk";"no";0;0;0;55,716666;11,716666
1811;"Holbæk";"no";0;0;0;55,716666;11,716666
1812;"Holbæk";"no";0;4;4;55,716666;11,716666
1813;"Holbæk";"no";0;0;0;55,716666;11,716666
1814;"Holbæk";"no";0;0;0;55,716666;11,716666
1815;"Holbæk";"no";0;0;0;55,716666;11,716666
1816;"Holbæk";"no";0;0;0;55,716666;11,716666
1817;"Holbæk";"no";0;1;1;55,716666;11,716666
1818;"Holbæk";"no";0;4;4;55,716666;11,716666
1819;"Holbæk";"no";0;0;0;55,716666;11,716666
1820;"Holbæk";"no";0;0;0;55,716666;11,716666
1821;"Holbæk";"no";0;7;7;55,716666;11,716666
1822;"Holbæk";"no";0;0;0;55,716666;11,716666
1823;"Holbæk";"no";0;9;9;55,716666;11,716666
1824;"Holbæk";"no";0;1;1;55,716666;11,716666
1825;"Holbæk";"no";0;4;4;55,716666;11,716666
1826;"Holbæk";"no";0;1;1;55,716666;11,716666
1827;"Holbæk";"no";0;2;2;55,716666;11,716666
1828;"Holbæk";"no";0;2;2;55,716666;11,716666
1829;"Holbæk";"no";0;2;2;55,716666;11,716666
1830;"Holbæk";"no";0;2;2;55,716666;11,716666
1831;"Holbæk";"no";0;4;4;55,716666;11,716666
1832;"Holbæk";"no";0;5;5;55,716666;11,716666
1833;"Holbæk";"no";0;0;0;55,716666;11,716666
1834;"Holbæk";"no";0;6;6;55,716666;11,716666
1835;"Holbæk";"no";2;9;11;55,716666;11,716666
1836;"Holbæk";"no";0;3;3;55,716666;11,716666
1837;"Holbæk";"no";4;4;8;55,716666;11,716666
1838;"Holbæk";"no";7;10;17;55,716666;11,716666
1839;"Holbæk";"no";9;6;15;55,716666;11,716666
1840;"Holbæk";"no";5;4;9;55,716666;11,716666
1841;"Holbæk";"no";9;6;15;55,716666;11,716666
1842;"Holbæk";"no";13;18;31;55,716666;11,716666
1843;"Holbæk";"no";7;7;14;55,716666;11,716666
1844;"Holbæk";"no";5;10;15;55,716666;11,716666
1845;"Holbæk";"no";6;6;12;55,716666;11,716666
1846;"Holbæk";"no";6;9;15;55,716666;11,716666
1847;"Holbæk";"no";10;13;23;55,716666;11,716666
1848;"Holbæk";"no";0;8;8;55,716666;11,716666
1849;"Holbæk";"no";8;27;35;55,716666;11,716666
1850;"Holbæk";"no";12;28;40;55,716666;11,716666
1851;"Holbæk";"no";7;20;27;55,716666;11,716666
1852;"Holbæk";"no";5;14;19;55,716666;11,716666
1853;"Holbæk";"no";10;15;25;55,716666;11,716666
1854;"Holbæk";"no";13;12;25;55,716666;11,716666
1855;"Holbæk";"no";14;16;30;55,716666;11,716666
1856;"Holbæk";"no";16;22;38;55,716666;11,716666
1857;"Holbæk";"no";0;0;0;55,716666;11,716666
1634;"Jylland";"no";0;0;0;56;9,25
1635;"Jylland";"no";3;2;5;56;9,25
1636;"Jylland";"no";0;0;0;56;9,25
1637;"Jylland";"no";0;0;0;56;9,25
1638;"Jylland";"no";0;0;0;56;9,25
1639;"Jylland";"no";0;0;0;56;9,25
1640;"Jylland";"no";0;0;0;56;9,25
1641;"Jylland";"no";0;0;0;56;9,25
1642;"Jylland";"no";1;0;1;56;9,25
1643;"Jylland";"no";0;1;1;56;9,25
1644;"Jylland";"no";0;0;0;56;9,25
1645;"Jylland";"no";0;0;0;56;9,25
1646;"Jylland";"no";2;2;4;56;9,25
1647;"Jylland";"no";0;1;1;56;9,25
1648;"Jylland";"no";0;0;0;56;9,25
1649;"Jylland";"no";0;0;0;56;9,25
1650;"Jylland";"no";0;1;1;56;9,25
1651;"Jylland";"no";0;0;0;56;9,25
1652;"Jylland";"no";0;0;0;56;9,25
1653;"Jylland";"no";0;0;0;56;9,25
1654;"Jylland";"no";0;0;0;56;9,25
1655;"Jylland";"no";0;0;0;56;9,25
1656;"Jylland";"no";0;0;0;56;9,25
1657;"Jylland";"no";0;0;0;56;9,25
1658;"Jylland";"no";0;0;0;56;9,25
1659;"Jylland";"no";0;0;0;56;9,25
1660;"Jylland";"no";0;0;0;56;9,25
1661;"Jylland";"no";0;0;0;56;9,25
1662;"Jylland";"no";0;0;0;56;9,25
1663;"Jylland";"no";2;2;4;56;9,25
1664;"Jylland";"no";0;1;1;56;9,25
1665;"Jylland";"no";0;0;0;56;9,25
1666;"Jylland";"no";0;0;0;56;9,25
1667;"Jylland";"no";0;1;1;56;9,25
1668;"Jylland";"no";0;0;0;56;9,25
1669;"Jylland";"no";0;0;0;56;9,25
1670;"Jylland";"no";0;1;1;56;9,25
1671;"Jylland";"no";0;1;1;56;9,25
1672;"Jylland";"no";0;0;0;56;9,25
1673;"Jylland";"no";0;0;0;56;9,25
1674;"Jylland";"no";0;0;0;56;9,25
1675;"Jylland";"no";0;0;0;56;9,25
1676;"Jylland";"no";0;0;0;56;9,25
1677;"Jylland";"no";0;0;0;56;9,25
1678;"Jylland";"no";0;0;0;56;9,25
1679;"Jylland";"no";2;1;3;56;9,25
1680;"Jylland";"no";0;0;0;56;9,25
1681;"Jylland";"no";0;0;0;56;9,25
1682;"Jylland";"no";0;0;0;56;9,25
1683;"Jylland";"no";0;0;0;56;9,25
1684;"Jylland";"no";0;0;0;56;9,25
1685;"Jylland";"no";0;0;0;56;9,25
1686;"Jylland";"no";0;0;0;56;9,25
1687;"Jylland";"no";0;0;0;56;9,25
1688;"Jylland";"no";0;0;0;56;9,25
1689;"Jylland";"no";0;0;0;56;9,25
1690;"Jylland";"no";0;0;0;56;9,25
1691;"Jylland";"no";0;0;0;56;9,25
1692;"Jylland";"no";0;0;0;56;9,25
1693;"Jylland";"no";0;0;0;56;9,25
1694;"Jylland";"no";0;0;0;56;9,25
1695;"Jylland";"no";0;0;0;56;9,25
1696;"Jylland";"no";0;0;0;56;9,25
1697;"Jylland";"no";0;0;0;56;9,25
1698;"Jylland";"no";0;0;0;56;9,25
1699;"Jylland";"no";0;0;0;56;9,25
1700;"Jylland";"no";0;0;0;56;9,25
1701;"Jylland";"no";0;0;0;56;9,25
1702;"Jylland";"no";0;0;0;56;9,25
1703;"Jylland";"no";0;0;0;56;9,25
1704;"Jylland";"no";1;0;1;56;9,25
1705;"Jylland";"no";0;0;0;56;9,25
1706;"Jylland";"no";0;0;0;56;9,25
1707;"Jylland";"no";0;0;0;56;9,25
1708;"Jylland";"no";0;0;0;56;9,25
1709;"Jylland";"no";0;0;0;56;9,25
1710;"Jylland";"no";0;0;0;56;9,25
1711;"Jylland";"no";0;0;0;56;9,25
1712;"Jylland";"no";0;1;1;56;9,25
1713;"Jylland";"no";0;0;0;56;9,25
1714;"Jylland";"no";0;0;0;56;9,25
1715;"Jylland";"no";0;0;0;56;9,25
1716;"Jylland";"no";0;0;0;56;9,25
1717;"Jylland";"no";0;0;0;56;9,25
1718;"Jylland";"no";0;0;0;56;9,25
1719;"Jylland";"no";0;0;0;56;9,25
1720;"Jylland";"no";0;0;0;56;9,25
1721;"Jylland";"no";0;0;0;56;9,25
1722;"Jylland";"no";0;0;0;56;9,25
1723;"Jylland";"no";0;0;0;56;9,25
1724;"Jylland";"no";0;0;0;56;9,25
1725;"Jylland";"no";0;0;0;56;9,25
1726;"Jylland";"no";0;0;0;56;9,25
1727;"Jylland";"no";0;0;0;56;9,25
1728;"Jylland";"no";0;0;0;56;9,25
1729;"Jylland";"no";0;0;0;56;9,25
1730;"Jylland";"no";0;0;0;56;9,25
1731;"Jylland";"no";0;0;0;56;9,25
1732;"Jylland";"no";0;0;0;56;9,25
1733;"Jylland";"no";0;0;0;56;9,25
1734;"Jylland";"no";0;0;0;56;9,25
1735;"Jylland";"no";0;0;0;56;9,25
1736;"Jylland";"no";0;0;0;56;9,25
1737;"Jylland";"no";0;0;0;56;9,25
1738;"Jylland";"no";0;0;0;56;9,25
1739;"Jylland";"no";0;0;0;56;9,25
1740;"Jylland";"no";0;1;1;56;9,25
1741;"Jylland";"no";0;0;0;56;9,25
1742;"Jylland";"no";0;0;0;56;9,25
1743;"Jylland";"no";0;0;0;56;9,25
1744;"Jylland";"no";0;0;0;56;9,25
1745;"Jylland";"no";0;0;0;56;9,25
1746;"Jylland";"no";0;0;0;56;9,25
1747;"Jylland";"no";0;1;1;56;9,25
1748;"Jylland";"no";0;0;0;56;9,25
1749;"Jylland";"no";0;0;0;56;9,25
1750;"Jylland";"no";0;0;0;56;9,25
1751;"Jylland";"no";0;0;0;56;9,25
1752;"Jylland";"no";0;0;0;56;9,25
1753;"Jylland";"no";0;0;0;56;9,25
1754;"Jylland";"no";0;0;0;56;9,25
1755;"Jylland";"no";0;0;0;56;9,25
1756;"Jylland";"no";0;0;0;56;9,25
1757;"Jylland";"no";0;0;0;56;9,25
1758;"Jylland";"no";0;0;0;56;9,25
1759;"Jylland";"no";0;1;1;56;9,25
1760;"Jylland";"no";0;0;0;56;9,25
1761;"Jylland";"no";0;0;0;56;9,25
1762;"Jylland";"no";0;0;0;56;9,25
1763;"Jylland";"no";0;0;0;56;9,25
1764;"Jylland";"no";0;0;0;56;9,25
1765;"Jylland";"no";0;1;1;56;9,25
1766;"Jylland";"no";0;0;0;56;9,25
1767;"Jylland";"no";0;0;0;56;9,25
1768;"Jylland";"no";0;0;0;56;9,25
1769;"Jylland";"no";0;0;0;56;9,25
1770;"Jylland";"no";0;0;0;56;9,25
1771;"Jylland";"no";0;0;0;56;9,25
1772;"Jylland";"no";0;0;0;56;9,25
1773;"Jylland";"no";0;0;0;56;9,25
1774;"Jylland";"no";0;0;0;56;9,25
1775;"Jylland";"no";0;1;1;56;9,25
1776;"Jylland";"no";0;0;0;56;9,25
1777;"Jylland";"no";0;0;0;56;9,25
1778;"Jylland";"no";0;0;0;56;9,25
1779;"Jylland";"no";0;0;0;56;9,25
1780;"Jylland";"no";0;0;0;56;9,25
1781;"Jylland";"no";0;0;0;56;9,25
1782;"Jylland";"no";0;0;0;56;9,25
1783;"Jylland";"no";0;0;0;56;9,25
1784;"Jylland";"no";0;0;0;56;9,25
1785;"Jylland";"no";0;0;0;56;9,25
1786;"Jylland";"no";0;0;0;56;9,25
1787;"Jylland";"no";0;0;0;56;9,25
1788;"Jylland";"no";0;0;0;56;9,25
1789;"Jylland";"no";0;0;0;56;9,25
1790;"Jylland";"no";0;0;0;56;9,25
1791;"Jylland";"no";0;0;0;56;9,25
1792;"Jylland";"no";0;0;0;56;9,25
1793;"Jylland";"no";0;0;0;56;9,25
1794;"Jylland";"no";0;0;0;56;9,25
1795;"Jylland";"no";0;1;1;56;9,25
1796;"Jylland";"no";0;1;1;56;9,25
1797;"Jylland";"no";0;0;0;56;9,25
1798;"Jylland";"no";0;0;0;56;9,25
1799;"Jylland";"no";0;0;0;56;9,25
1800;"Jylland";"no";0;1;1;56;9,25
1801;"Jylland";"no";0;0;0;56;9,25
1802;"Jylland";"no";0;0;0;56;9,25
1803;"Jylland";"no";0;0;0;56;9,25
1804;"Jylland";"no";0;2;2;56;9,25
1805;"Jylland";"no";0;0;0;56;9,25
1806;"Jylland";"no";0;0;0;56;9,25
1807;"Jylland";"no";0;0;0;56;9,25
1808;"Jylland";"no";0;0;0;56;9,25
1809;"Jylland";"no";0;0;0;56;9,25
1810;"Jylland";"no";0;0;0;56;9,25
1811;"Jylland";"no";0;0;0;56;9,25
1812;"Jylland";"no";0;0;0;56;9,25
1813;"Jylland";"no";0;0;0;56;9,25
1814;"Jylland";"no";0;0;0;56;9,25
1815;"Jylland";"no";0;0;0;56;9,25
1816;"Jylland";"no";0;0;0;56;9,25
1817;"Jylland";"no";0;0;0;56;9,25
1818;"Jylland";"no";0;0;0;56;9,25
1819;"Jylland";"no";0;0;0;56;9,25
1820;"Jylland";"no";0;0;0;56;9,25
1821;"Jylland";"no";0;0;0;56;9,25
1822;"Jylland";"no";0;0;0;56;9,25
1823;"Jylland";"no";0;1;1;56;9,25
1824;"Jylland";"no";0;0;0;56;9,25
1825;"Jylland";"no";0;0;0;56;9,25
1826;"Jylland";"no";0;0;0;56;9,25
1827;"Jylland";"no";0;0;0;56;9,25
1828;"Jylland";"no";0;0;0;56;9,25
1829;"Jylland";"no";0;0;0;56;9,25
1830;"Jylland";"no";0;0;0;56;9,25
1831;"Jylland";"no";0;0;0;56;9,25
1832;"Jylland";"no";0;1;1;56;9,25
1833;"Jylland";"no";0;0;0;56;9,25
1834;"Jylland";"no";0;0;0;56;9,25
1835;"Jylland";"no";0;0;0;56;9,25
1836;"Jylland";"no";0;0;0;56;9,25
1837;"Jylland";"no";0;1;1;56;9,25
1838;"Jylland";"no";0;0;0;56;9,25
1839;"Jylland";"no";0;0;0;56;9,25
1840;"Jylland";"no";0;0;0;56;9,25
1841;"Jylland";"no";0;0;0;56;9,25
1842;"Jylland";"no";0;0;0;56;9,25
1843;"Jylland";"no";0;2;2;56;9,25
1844;"Jylland";"no";0;0;0;56;9,25
1845;"Jylland";"no";0;0;0;56;9,25
1846;"Jylland";"no";0;0;0;56;9,25
1847;"Jylland";"no";0;1;1;56;9,25
1848;"Jylland";"no";0;0;0;56;9,25
1849;"Jylland";"no";0;0;0;56;9,25
1850;"Jylland";"no";0;1;1;56;9,25
1851;"Jylland";"no";0;3;3;56;9,25
1852;"Jylland";"no";0;4;4;56;9,25
1853;"Jylland";"no";0;1;1;56;9,25
1854;"Jylland";"no";0;0;0;56;9,25
1855;"Jylland";"no";0;0;0;56;9,25
1856;"Jylland";"no";0;1;1;56;9,25
1857;"Jylland";"no";0;0;0;56;9,25
1634;"Kalundborg";"no";0;0;0;55,683333;11,1
1635;"Kalundborg";"no";1;0;1;55,683333;11,1
1636;"Kalundborg";"no";0;0;0;55,683333;11,1
1637;"Kalundborg";"no";1;0;1;55,683333;11,1
1638;"Kalundborg";"no";1;1;2;55,683333;11,1
1639;"Kalundborg";"no";0;0;0;55,683333;11,1
1640;"Kalundborg";"no";0;0;0;55,683333;11,1
1641;"Kalundborg";"no";0;0;0;55,683333;11,1
1642;"Kalundborg";"no";0;0;0;55,683333;11,1
1643;"Kalundborg";"no";0;0;0;55,683333;11,1
1644;"Kalundborg";"no";0;0;0;55,683333;11,1
1645;"Kalundborg";"no";0;1;1;55,683333;11,1
1646;"Kalundborg";"no";0;0;0;55,683333;11,1
1647;"Kalundborg";"no";1;1;2;55,683333;11,1
1648;"Kalundborg";"no";0;0;0;55,683333;11,1
1649;"Kalundborg";"no";0;0;0;55,683333;11,1
1650;"Kalundborg";"no";0;0;0;55,683333;11,1
1651;"Kalundborg";"no";0;1;1;55,683333;11,1
1652;"Kalundborg";"no";0;0;0;55,683333;11,1
1653;"Kalundborg";"no";0;0;0;55,683333;11,1
1654;"Kalundborg";"no";0;0;0;55,683333;11,1
1655;"Kalundborg";"no";0;2;2;55,683333;11,1
1656;"Kalundborg";"no";0;0;0;55,683333;11,1
1657;"Kalundborg";"no";0;2;2;55,683333;11,1
1658;"Kalundborg";"no";0;0;0;55,683333;11,1
1659;"Kalundborg";"no";0;0;0;55,683333;11,1
1660;"Kalundborg";"no";0;0;0;55,683333;11,1
1661;"Kalundborg";"no";1;0;1;55,683333;11,1
1662;"Kalundborg";"no";0;0;0;55,683333;11,1
1663;"Kalundborg";"no";0;1;1;55,683333;11,1
1664;"Kalundborg";"no";0;2;2;55,683333;11,1
1665;"Kalundborg";"no";1;1;2;55,683333;11,1
1666;"Kalundborg";"no";0;0;0;55,683333;11,1
1667;"Kalundborg";"no";0;0;0;55,683333;11,1
1668;"Kalundborg";"no";0;1;1;55,683333;11,1
1669;"Kalundborg";"no";0;1;1;55,683333;11,1
1670;"Kalundborg";"no";0;1;1;55,683333;11,1
1671;"Kalundborg";"no";0;1;1;55,683333;11,1
1672;"Kalundborg";"no";0;2;2;55,683333;11,1
1673;"Kalundborg";"no";0;1;1;55,683333;11,1
1674;"Kalundborg";"no";1;2;3;55,683333;11,1
1675;"Kalundborg";"no";1;0;1;55,683333;11,1
1676;"Kalundborg";"no";0;0;0;55,683333;11,1
1677;"Kalundborg";"no";1;0;1;55,683333;11,1
1678;"Kalundborg";"no";0;0;0;55,683333;11,1
1679;"Kalundborg";"no";1;0;1;55,683333;11,1
1680;"Kalundborg";"no";0;3;3;55,683333;11,1
1681;"Kalundborg";"no";0;0;0;55,683333;11,1
1682;"Kalundborg";"no";0;0;0;55,683333;11,1
1683;"Kalundborg";"no";0;0;0;55,683333;11,1
1684;"Kalundborg";"no";0;0;0;55,683333;11,1
1685;"Kalundborg";"no";0;0;0;55,683333;11,1
1686;"Kalundborg";"no";0;0;0;55,683333;11,1
1687;"Kalundborg";"no";0;0;0;55,683333;11,1
1688;"Kalundborg";"no";0;0;0;55,683333;11,1
1689;"Kalundborg";"no";0;0;0;55,683333;11,1
1690;"Kalundborg";"no";0;0;0;55,683333;11,1
1691;"Kalundborg";"no";0;0;0;55,683333;11,1
1692;"Kalundborg";"no";0;0;0;55,683333;11,1
1693;"Kalundborg";"no";0;3;3;55,683333;11,1
1694;"Kalundborg";"no";1;1;2;55,683333;11,1
1695;"Kalundborg";"no";0;0;0;55,683333;11,1
1696;"Kalundborg";"no";1;0;1;55,683333;11,1
1697;"Kalundborg";"no";1;1;2;55,683333;11,1
1698;"Kalundborg";"no";0;0;0;55,683333;11,1
1699;"Kalundborg";"no";0;0;0;55,683333;11,1
1700;"Kalundborg";"no";0;0;0;55,683333;11,1
1701;"Kalundborg";"no";0;0;0;55,683333;11,1
1702;"Kalundborg";"no";0;0;0;55,683333;11,1
1703;"Kalundborg";"no";0;0;0;55,683333;11,1
1704;"Kalundborg";"no";0;0;0;55,683333;11,1
1705;"Kalundborg";"no";0;0;0;55,683333;11,1
1706;"Kalundborg";"no";0;0;0;55,683333;11,1
1707;"Kalundborg";"no";0;0;0;55,683333;11,1
1708;"Kalundborg";"no";0;2;2;55,683333;11,1
1709;"Kalundborg";"no";0;2;2;55,683333;11,1
1710;"Kalundborg";"no";0;0;0;55,683333;11,1
1711;"Kalundborg";"no";0;0;0;55,683333;11,1
1712;"Kalundborg";"no";1;0;1;55,683333;11,1
1713;"Kalundborg";"no";0;0;0;55,683333;11,1
1714;"Kalundborg";"no";0;0;0;55,683333;11,1
1715;"Kalundborg";"no";0;1;1;55,683333;11,1
1716;"Kalundborg";"no";0;0;0;55,683333;11,1
1717;"Kalundborg";"no";0;0;0;55,683333;11,1
1718;"Kalundborg";"no";0;0;0;55,683333;11,1
1719;"Kalundborg";"no";0;0;0;55,683333;11,1
1720;"Kalundborg";"no";0;1;1;55,683333;11,1
1721;"Kalundborg";"no";0;0;0;55,683333;11,1
1722;"Kalundborg";"no";0;0;0;55,683333;11,1
1723;"Kalundborg";"no";0;0;0;55,683333;11,1
1724;"Kalundborg";"no";0;0;0;55,683333;11,1
1725;"Kalundborg";"no";0;0;0;55,683333;11,1
1726;"Kalundborg";"no";0;0;0;55,683333;11,1
1727;"Kalundborg";"no";0;0;0;55,683333;11,1
1728;"Kalundborg";"no";0;0;0;55,683333;11,1
1729;"Kalundborg";"no";0;0;0;55,683333;11,1
1730;"Kalundborg";"no";0;0;0;55,683333;11,1
1731;"Kalundborg";"no";0;0;0;55,683333;11,1
1732;"Kalundborg";"no";0;0;0;55,683333;11,1
1733;"Kalundborg";"no";0;0;0;55,683333;11,1
1734;"Kalundborg";"no";0;0;0;55,683333;11,1
1735;"Kalundborg";"no";0;0;0;55,683333;11,1
1736;"Kalundborg";"no";0;0;0;55,683333;11,1
1737;"Kalundborg";"no";0;0;0;55,683333;11,1
1738;"Kalundborg";"no";0;0;0;55,683333;11,1
1739;"Kalundborg";"no";0;0;0;55,683333;11,1
1740;"Kalundborg";"no";0;0;0;55,683333;11,1
1741;"Kalundborg";"no";0;0;0;55,683333;11,1
1742;"Kalundborg";"no";0;0;0;55,683333;11,1
1743;"Kalundborg";"no";0;1;1;55,683333;11,1
1744;"Kalundborg";"no";0;0;0;55,683333;11,1
1745;"Kalundborg";"no";1;1;2;55,683333;11,1
1746;"Kalundborg";"no";0;0;0;55,683333;11,1
1747;"Kalundborg";"no";0;0;0;55,683333;11,1
1748;"Kalundborg";"no";0;0;0;55,683333;11,1
1749;"Kalundborg";"no";0;0;0;55,683333;11,1
1750;"Kalundborg";"no";0;0;0;55,683333;11,1
1751;"Kalundborg";"no";0;0;0;55,683333;11,1
1752;"Kalundborg";"no";0;1;1;55,683333;11,1
1753;"Kalundborg";"no";0;1;1;55,683333;11,1
1754;"Kalundborg";"no";0;1;1;55,683333;11,1
1755;"Kalundborg";"no";0;0;0;55,683333;11,1
1756;"Kalundborg";"no";0;0;0;55,683333;11,1
1757;"Kalundborg";"no";0;0;0;55,683333;11,1
1758;"Kalundborg";"no";0;2;2;55,683333;11,1
1759;"Kalundborg";"no";0;1;1;55,683333;11,1
1760;"Kalundborg";"no";0;0;0;55,683333;11,1
1761;"Kalundborg";"no";1;0;1;55,683333;11,1
1762;"Kalundborg";"no";0;0;0;55,683333;11,1
1763;"Kalundborg";"no";0;0;0;55,683333;11,1
1764;"Kalundborg";"no";0;0;0;55,683333;11,1
1765;"Kalundborg";"no";0;0;0;55,683333;11,1
1766;"Kalundborg";"no";0;1;1;55,683333;11,1
1767;"Kalundborg";"no";0;0;0;55,683333;11,1
1768;"Kalundborg";"no";0;0;0;55,683333;11,1
1769;"Kalundborg";"no";0;1;1;55,683333;11,1
1770;"Kalundborg";"no";0;0;0;55,683333;11,1
1771;"Kalundborg";"no";0;0;0;55,683333;11,1
1772;"Kalundborg";"no";0;0;0;55,683333;11,1
1773;"Kalundborg";"no";0;0;0;55,683333;11,1
1774;"Kalundborg";"no";0;0;0;55,683333;11,1
1775;"Kalundborg";"no";0;1;1;55,683333;11,1
1776;"Kalundborg";"no";1;0;1;55,683333;11,1
1777;"Kalundborg";"no";0;0;0;55,683333;11,1
1778;"Kalundborg";"no";0;0;0;55,683333;11,1
1779;"Kalundborg";"no";0;0;0;55,683333;11,1
1780;"Kalundborg";"no";0;1;1;55,683333;11,1
1781;"Kalundborg";"no";0;0;0;55,683333;11,1
1782;"Kalundborg";"no";0;0;0;55,683333;11,1
1783;"Kalundborg";"no";0;0;0;55,683333;11,1
1784;"Kalundborg";"no";1;1;2;55,683333;11,1
1785;"Kalundborg";"no";0;0;0;55,683333;11,1
1786;"Kalundborg";"no";0;1;1;55,683333;11,1
1787;"Kalundborg";"no";1;0;1;55,683333;11,1
1788;"Kalundborg";"no";0;0;0;55,683333;11,1
1789;"Kalundborg";"no";1;0;1;55,683333;11,1
1790;"Kalundborg";"no";0;0;0;55,683333;11,1
1791;"Kalundborg";"no";2;1;3;55,683333;11,1
1792;"Kalundborg";"no";0;0;0;55,683333;11,1
1793;"Kalundborg";"no";0;1;1;55,683333;11,1
1794;"Kalundborg";"no";1;1;2;55,683333;11,1
1795;"Kalundborg";"no";1;2;3;55,683333;11,1
1796;"Kalundborg";"no";0;0;0;55,683333;11,1
1797;"Kalundborg";"no";0;1;1;55,683333;11,1
1798;"Kalundborg";"no";1;1;2;55,683333;11,1
1799;"Kalundborg";"no";3;2;5;55,683333;11,1
1800;"Kalundborg";"no";1;0;1;55,683333;11,1
1801;"Kalundborg";"no";1;1;2;55,683333;11,1
1802;"Kalundborg";"no";0;0;0;55,683333;11,1
1803;"Kalundborg";"no";1;2;3;55,683333;11,1
1804;"Kalundborg";"no";0;0;0;55,683333;11,1
1805;"Kalundborg";"no";0;1;1;55,683333;11,1
1806;"Kalundborg";"no";0;0;0;55,683333;11,1
1807;"Kalundborg";"no";2;1;3;55,683333;11,1
1808;"Kalundborg";"no";0;0;0;55,683333;11,1
1809;"Kalundborg";"no";0;2;2;55,683333;11,1
1810;"Kalundborg";"no";0;1;1;55,683333;11,1
1811;"Kalundborg";"no";0;0;0;55,683333;11,1
1812;"Kalundborg";"no";0;0;0;55,683333;11,1
1813;"Kalundborg";"no";0;0;0;55,683333;11,1
1814;"Kalundborg";"no";0;3;3;55,683333;11,1
1815;"Kalundborg";"no";2;0;2;55,683333;11,1
1816;"Kalundborg";"no";0;5;5;55,683333;11,1
1817;"Kalundborg";"no";0;4;4;55,683333;11,1
1818;"Kalundborg";"no";0;3;3;55,683333;11,1
1819;"Kalundborg";"no";1;1;2;55,683333;11,1
1820;"Kalundborg";"no";0;8;8;55,683333;11,1
1821;"Kalundborg";"no";2;11;13;55,683333;11,1
1822;"Kalundborg";"no";1;5;6;55,683333;11,1
1823;"Kalundborg";"no";2;4;6;55,683333;11,1
1824;"Kalundborg";"no";0;3;3;55,683333;11,1
1825;"Kalundborg";"no";0;8;8;55,683333;11,1
1826;"Kalundborg";"no";3;6;9;55,683333;11,1
1827;"Kalundborg";"no";1;3;4;55,683333;11,1
1828;"Kalundborg";"no";3;8;11;55,683333;11,1
1829;"Kalundborg";"no";1;5;6;55,683333;11,1
1830;"Kalundborg";"no";1;7;8;55,683333;11,1
1831;"Kalundborg";"no";0;4;4;55,683333;11,1
1832;"Kalundborg";"no";0;3;3;55,683333;11,1
1833;"Kalundborg";"no";4;4;8;55,683333;11,1
1834;"Kalundborg";"no";7;10;17;55,683333;11,1
1835;"Kalundborg";"no";4;7;11;55,683333;11,1
1836;"Kalundborg";"no";1;5;6;55,683333;11,1
1837;"Kalundborg";"no";3;11;14;55,683333;11,1
1838;"Kalundborg";"no";3;11;14;55,683333;11,1
1839;"Kalundborg";"no";3;3;6;55,683333;11,1
1840;"Kalundborg";"no";4;4;8;55,683333;11,1
1841;"Kalundborg";"no";8;7;15;55,683333;11,1
1842;"Kalundborg";"no";4;10;14;55,683333;11,1
1843;"Kalundborg";"no";0;9;9;55,683333;11,1
1844;"Kalundborg";"no";1;5;6;55,683333;11,1
1845;"Kalundborg";"no";6;8;14;55,683333;11,1
1846;"Kalundborg";"no";6;8;14;55,683333;11,1
1847;"Kalundborg";"no";3;9;12;55,683333;11,1
1848;"Kalundborg";"no";2;11;13;55,683333;11,1
1849;"Kalundborg";"no";4;12;16;55,683333;11,1
1850;"Kalundborg";"no";5;18;23;55,683333;11,1
1851;"Kalundborg";"no";8;12;20;55,683333;11,1
1852;"Kalundborg";"no";4;6;10;55,683333;11,1
1853;"Kalundborg";"no";2;8;10;55,683333;11,1
1854;"Kalundborg";"no";3;8;11;55,683333;11,1
1855;"Kalundborg";"no";9;6;15;55,683333;11,1
1856;"Kalundborg";"no";7;4;11;55,683333;11,1
1857;"Kalundborg";"no";1;2;3;55,683333;11,1
1634;"Kolding";"no";0;0;0;55,490277;9,471944
1635;"Kolding";"no";3;0;3;55,490277;9,471944
1636;"Kolding";"no";1;0;1;55,490277;9,471944
1637;"Kolding";"no";0;0;0;55,490277;9,471944
1638;"Kolding";"no";4;0;4;55,490277;9,471944
1639;"Kolding";"no";1;0;1;55,490277;9,471944
1640;"Kolding";"no";3;0;3;55,490277;9,471944
1641;"Kolding";"no";5;0;5;55,490277;9,471944
1642;"Kolding";"no";1;2;3;55,490277;9,471944
1643;"Kolding";"no";3;0;3;55,490277;9,471944
1644;"Kolding";"no";2;0;2;55,490277;9,471944
1645;"Kolding";"no";0;0;0;55,490277;9,471944
1646;"Kolding";"no";0;0;0;55,490277;9,471944
1647;"Kolding";"no";0;0;0;55,490277;9,471944
1648;"Kolding";"no";0;0;0;55,490277;9,471944
1649;"Kolding";"no";0;0;0;55,490277;9,471944
1650;"Kolding";"no";0;0;0;55,490277;9,471944
1651;"Kolding";"no";0;0;0;55,490277;9,471944
1652;"Kolding";"no";0;0;0;55,490277;9,471944
1653;"Kolding";"no";0;0;0;55,490277;9,471944
1654;"Kolding";"no";0;0;0;55,490277;9,471944
1655;"Kolding";"no";0;0;0;55,490277;9,471944
1656;"Kolding";"no";0;0;0;55,490277;9,471944
1657;"Kolding";"no";0;0;0;55,490277;9,471944
1658;"Kolding";"no";0;0;0;55,490277;9,471944
1659;"Kolding";"no";0;0;0;55,490277;9,471944
1660;"Kolding";"no";0;0;0;55,490277;9,471944
1661;"Kolding";"no";0;0;0;55,490277;9,471944
1662;"Kolding";"no";0;0;0;55,490277;9,471944
1663;"Kolding";"no";0;0;0;55,490277;9,471944
1664;"Kolding";"no";0;0;0;55,490277;9,471944
1665;"Kolding";"no";0;0;0;55,490277;9,471944
1666;"Kolding";"no";0;0;0;55,490277;9,471944
1667;"Kolding";"no";0;0;0;55,490277;9,471944
1668;"Kolding";"no";0;0;0;55,490277;9,471944
1669;"Kolding";"no";0;0;0;55,490277;9,471944
1670;"Kolding";"no";0;0;0;55,490277;9,471944
1671;"Kolding";"no";0;0;0;55,490277;9,471944
1672;"Kolding";"no";0;0;0;55,490277;9,471944
1673;"Kolding";"no";0;0;0;55,490277;9,471944
1674;"Kolding";"no";0;0;0;55,490277;9,471944
1675;"Kolding";"no";0;0;0;55,490277;9,471944
1676;"Kolding";"no";0;0;0;55,490277;9,471944
1677;"Kolding";"no";0;0;0;55,490277;9,471944
1678;"Kolding";"no";0;0;0;55,490277;9,471944
1679;"Kolding";"no";0;0;0;55,490277;9,471944
1680;"Kolding";"no";1;0;1;55,490277;9,471944
1681;"Kolding";"no";0;0;0;55,490277;9,471944
1682;"Kolding";"no";0;0;0;55,490277;9,471944
1683;"Kolding";"no";0;0;0;55,490277;9,471944
1684;"Kolding";"no";0;0;0;55,490277;9,471944
1685;"Kolding";"no";0;0;0;55,490277;9,471944
1686;"Kolding";"no";0;0;0;55,490277;9,471944
1687;"Kolding";"no";0;0;0;55,490277;9,471944
1688;"Kolding";"no";0;0;0;55,490277;9,471944
1689;"Kolding";"no";0;0;0;55,490277;9,471944
1690;"Kolding";"no";0;0;0;55,490277;9,471944
1691;"Kolding";"no";0;0;0;55,490277;9,471944
1692;"Kolding";"no";0;0;0;55,490277;9,471944
1693;"Kolding";"no";0;0;0;55,490277;9,471944
1694;"Kolding";"no";0;0;0;55,490277;9,471944
1695;"Kolding";"no";0;0;0;55,490277;9,471944
1696;"Kolding";"no";0;0;0;55,490277;9,471944
1697;"Kolding";"no";0;0;0;55,490277;9,471944
1698;"Kolding";"no";0;0;0;55,490277;9,471944
1699;"Kolding";"no";0;0;0;55,490277;9,471944
1700;"Kolding";"no";0;0;0;55,490277;9,471944
1701;"Kolding";"no";0;0;0;55,490277;9,471944
1702;"Kolding";"no";0;0;0;55,490277;9,471944
1703;"Kolding";"no";0;0;0;55,490277;9,471944
1704;"Kolding";"no";0;0;0;55,490277;9,471944
1705;"Kolding";"no";0;0;0;55,490277;9,471944
1706;"Kolding";"no";0;0;0;55,490277;9,471944
1707;"Kolding";"no";0;0;0;55,490277;9,471944
1708;"Kolding";"no";0;0;0;55,490277;9,471944
1709;"Kolding";"no";0;0;0;55,490277;9,471944
1710;"Kolding";"no";0;0;0;55,490277;9,471944
1711;"Kolding";"no";0;0;0;55,490277;9,471944
1712;"Kolding";"no";0;0;0;55,490277;9,471944
1713;"Kolding";"no";0;0;0;55,490277;9,471944
1714;"Kolding";"no";0;0;0;55,490277;9,471944
1715;"Kolding";"no";0;0;0;55,490277;9,471944
1716;"Kolding";"no";0;0;0;55,490277;9,471944
1717;"Kolding";"no";0;0;0;55,490277;9,471944
1718;"Kolding";"no";0;0;0;55,490277;9,471944
1719;"Kolding";"no";0;0;0;55,490277;9,471944
1720;"Kolding";"no";0;0;0;55,490277;9,471944
1721;"Kolding";"no";0;0;0;55,490277;9,471944
1722;"Kolding";"no";0;0;0;55,490277;9,471944
1723;"Kolding";"no";0;0;0;55,490277;9,471944
1724;"Kolding";"no";0;0;0;55,490277;9,471944
1725;"Kolding";"no";0;0;0;55,490277;9,471944
1726;"Kolding";"no";0;0;0;55,490277;9,471944
1727;"Kolding";"no";0;0;0;55,490277;9,471944
1728;"Kolding";"no";0;0;0;55,490277;9,471944
1729;"Kolding";"no";0;0;0;55,490277;9,471944
1730;"Kolding";"no";0;0;0;55,490277;9,471944
1731;"Kolding";"no";0;0;0;55,490277;9,471944
1732;"Kolding";"no";0;0;0;55,490277;9,471944
1733;"Kolding";"no";0;0;0;55,490277;9,471944
1734;"Kolding";"no";0;0;0;55,490277;9,471944
1735;"Kolding";"no";0;0;0;55,490277;9,471944
1736;"Kolding";"no";0;0;0;55,490277;9,471944
1737;"Kolding";"no";0;0;0;55,490277;9,471944
1738;"Kolding";"no";0;0;0;55,490277;9,471944
1739;"Kolding";"no";0;0;0;55,490277;9,471944
1740;"Kolding";"no";0;0;0;55,490277;9,471944
1741;"Kolding";"no";0;0;0;55,490277;9,471944
1742;"Kolding";"no";0;0;0;55,490277;9,471944
1743;"Kolding";"no";0;0;0;55,490277;9,471944
1744;"Kolding";"no";0;0;0;55,490277;9,471944
1745;"Kolding";"no";0;0;0;55,490277;9,471944
1746;"Kolding";"no";0;0;0;55,490277;9,471944
1747;"Kolding";"no";0;0;0;55,490277;9,471944
1748;"Kolding";"no";0;0;0;55,490277;9,471944
1749;"Kolding";"no";0;0;0;55,490277;9,471944
1750;"Kolding";"no";0;0;0;55,490277;9,471944
1751;"Kolding";"no";0;0;0;55,490277;9,471944
1752;"Kolding";"no";0;0;0;55,490277;9,471944
1753;"Kolding";"no";0;0;0;55,490277;9,471944
1754;"Kolding";"no";0;0;0;55,490277;9,471944
1755;"Kolding";"no";0;0;0;55,490277;9,471944
1756;"Kolding";"no";0;0;0;55,490277;9,471944
1757;"Kolding";"no";0;0;0;55,490277;9,471944
1758;"Kolding";"no";0;0;0;55,490277;9,471944
1759;"Kolding";"no";0;0;0;55,490277;9,471944
1760;"Kolding";"no";0;0;0;55,490277;9,471944
1761;"Kolding";"no";0;0;0;55,490277;9,471944
1762;"Kolding";"no";0;0;0;55,490277;9,471944
1763;"Kolding";"no";0;0;0;55,490277;9,471944
1764;"Kolding";"no";0;0;0;55,490277;9,471944
1765;"Kolding";"no";0;0;0;55,490277;9,471944
1766;"Kolding";"no";0;0;0;55,490277;9,471944
1767;"Kolding";"no";0;0;0;55,490277;9,471944
1768;"Kolding";"no";0;0;0;55,490277;9,471944
1769;"Kolding";"no";0;0;0;55,490277;9,471944
1770;"Kolding";"no";0;0;0;55,490277;9,471944
1771;"Kolding";"no";0;0;0;55,490277;9,471944
1772;"Kolding";"no";0;0;0;55,490277;9,471944
1773;"Kolding";"no";0;2;2;55,490277;9,471944
1774;"Kolding";"no";0;0;0;55,490277;9,471944
1775;"Kolding";"no";0;0;0;55,490277;9,471944
1776;"Kolding";"no";0;0;0;55,490277;9,471944
1777;"Kolding";"no";0;0;0;55,490277;9,471944
1778;"Kolding";"no";0;0;0;55,490277;9,471944
1779;"Kolding";"no";0;0;0;55,490277;9,471944
1780;"Kolding";"no";0;0;0;55,490277;9,471944
1781;"Kolding";"no";0;0;0;55,490277;9,471944
1782;"Kolding";"no";0;0;0;55,490277;9,471944
1783;"Kolding";"no";0;0;0;55,490277;9,471944
1784;"Kolding";"no";0;1;1;55,490277;9,471944
1785;"Kolding";"no";0;0;0;55,490277;9,471944
1786;"Kolding";"no";0;0;0;55,490277;9,471944
1787;"Kolding";"no";0;0;0;55,490277;9,471944
1788;"Kolding";"no";0;0;0;55,490277;9,471944
1789;"Kolding";"no";0;0;0;55,490277;9,471944
1790;"Kolding";"no";0;0;0;55,490277;9,471944
1791;"Kolding";"no";0;0;0;55,490277;9,471944
1792;"Kolding";"no";0;0;0;55,490277;9,471944
1793;"Kolding";"no";0;0;0;55,490277;9,471944
1794;"Kolding";"no";0;0;0;55,490277;9,471944
1795;"Kolding";"no";0;0;0;55,490277;9,471944
1796;"Kolding";"no";0;0;0;55,490277;9,471944
1797;"Kolding";"no";0;0;0;55,490277;9,471944
1798;"Kolding";"no";0;0;0;55,490277;9,471944
1799;"Kolding";"no";0;0;0;55,490277;9,471944
1800;"Kolding";"no";0;1;1;55,490277;9,471944
1801;"Kolding";"no";0;0;0;55,490277;9,471944
1802;"Kolding";"no";0;1;1;55,490277;9,471944
1803;"Kolding";"no";0;0;0;55,490277;9,471944
1804;"Kolding";"no";0;1;1;55,490277;9,471944
1805;"Kolding";"no";0;0;0;55,490277;9,471944
1806;"Kolding";"no";0;0;0;55,490277;9,471944
1807;"Kolding";"no";2;0;2;55,490277;9,471944
1808;"Kolding";"no";0;0;0;55,490277;9,471944
1809;"Kolding";"no";0;0;0;55,490277;9,471944
1810;"Kolding";"no";0;0;0;55,490277;9,471944
1811;"Kolding";"no";0;0;0;55,490277;9,471944
1812;"Kolding";"no";0;0;0;55,490277;9,471944
1813;"Kolding";"no";0;0;0;55,490277;9,471944
1814;"Kolding";"no";0;0;0;55,490277;9,471944
1815;"Kolding";"no";0;0;0;55,490277;9,471944
1816;"Kolding";"no";0;0;0;55,490277;9,471944
1817;"Kolding";"no";0;0;0;55,490277;9,471944
1818;"Kolding";"no";0;0;0;55,490277;9,471944
1819;"Kolding";"no";0;0;0;55,490277;9,471944
1820;"Kolding";"no";0;0;0;55,490277;9,471944
1821;"Kolding";"no";0;0;0;55,490277;9,471944
1822;"Kolding";"no";0;1;1;55,490277;9,471944
1823;"Kolding";"no";0;0;0;55,490277;9,471944
1824;"Kolding";"no";0;0;0;55,490277;9,471944
1825;"Kolding";"no";0;0;0;55,490277;9,471944
1826;"Kolding";"no";0;0;0;55,490277;9,471944
1827;"Kolding";"no";0;0;0;55,490277;9,471944
1828;"Kolding";"no";0;0;0;55,490277;9,471944
1829;"Kolding";"no";0;0;0;55,490277;9,471944
1830;"Kolding";"no";0;0;0;55,490277;9,471944
1831;"Kolding";"no";0;0;0;55,490277;9,471944
1832;"Kolding";"no";0;0;0;55,490277;9,471944
1833;"Kolding";"no";0;0;0;55,490277;9,471944
1834;"Kolding";"no";0;1;1;55,490277;9,471944
1835;"Kolding";"no";0;0;0;55,490277;9,471944
1836;"Kolding";"no";0;0;0;55,490277;9,471944
1837;"Kolding";"no";0;0;0;55,490277;9,471944
1838;"Kolding";"no";0;0;0;55,490277;9,471944
1839;"Kolding";"no";0;0;0;55,490277;9,471944
1840;"Kolding";"no";0;0;0;55,490277;9,471944
1841;"Kolding";"no";1;0;1;55,490277;9,471944
1842;"Kolding";"no";0;0;0;55,490277;9,471944
1843;"Kolding";"no";0;0;0;55,490277;9,471944
1844;"Kolding";"no";2;0;2;55,490277;9,471944
1845;"Kolding";"no";2;1;3;55,490277;9,471944
1846;"Kolding";"no";0;0;0;55,490277;9,471944
1847;"Kolding";"no";0;0;0;55,490277;9,471944
1848;"Kolding";"no";0;0;0;55,490277;9,471944
1849;"Kolding";"no";0;0;0;55,490277;9,471944
1850;"Kolding";"no";1;0;1;55,490277;9,471944
1851;"Kolding";"no";1;1;2;55,490277;9,471944
1852;"Kolding";"no";1;0;1;55,490277;9,471944
1853;"Kolding";"no";0;0;0;55,490277;9,471944
1854;"Kolding";"no";1;0;1;55,490277;9,471944
1855;"Kolding";"no";2;1;3;55,490277;9,471944
1856;"Kolding";"no";0;0;0;55,490277;9,471944
1857;"Kolding";"no";0;0;0;55,490277;9,471944
1634;"Læsø";"no";0;0;0;57,26094;10,995557
1635;"Læsø";"no";1;0;1;57,26094;10,995557
1636;"Læsø";"no";0;0;0;57,26094;10,995557
1637;"Læsø";"no";0;0;0;57,26094;10,995557
1638;"Læsø";"no";0;0;0;57,26094;10,995557
1639;"Læsø";"no";0;0;0;57,26094;10,995557
1640;"Læsø";"no";0;0;0;57,26094;10,995557
1641;"Læsø";"no";0;0;0;57,26094;10,995557
1642;"Læsø";"no";0;0;0;57,26094;10,995557
1643;"Læsø";"no";0;0;0;57,26094;10,995557
1644;"Læsø";"no";0;0;0;57,26094;10,995557
1645;"Læsø";"no";0;0;0;57,26094;10,995557
1646;"Læsø";"no";0;0;0;57,26094;10,995557
1647;"Læsø";"no";0;0;0;57,26094;10,995557
1648;"Læsø";"no";0;0;0;57,26094;10,995557
1649;"Læsø";"no";0;0;0;57,26094;10,995557
1650;"Læsø";"no";0;0;0;57,26094;10,995557
1651;"Læsø";"no";0;1;1;57,26094;10,995557
1652;"Læsø";"no";0;0;0;57,26094;10,995557
1653;"Læsø";"no";0;0;0;57,26094;10,995557
1654;"Læsø";"no";0;0;0;57,26094;10,995557
1655;"Læsø";"no";0;0;0;57,26094;10,995557
1656;"Læsø";"no";0;0;0;57,26094;10,995557
1657;"Læsø";"no";0;0;0;57,26094;10,995557
1658;"Læsø";"no";0;0;0;57,26094;10,995557
1659;"Læsø";"no";0;0;0;57,26094;10,995557
1660;"Læsø";"no";0;0;0;57,26094;10,995557
1661;"Læsø";"no";0;0;0;57,26094;10,995557
1662;"Læsø";"no";0;0;0;57,26094;10,995557
1663;"Læsø";"no";0;0;0;57,26094;10,995557
1664;"Læsø";"no";0;0;0;57,26094;10,995557
1665;"Læsø";"no";0;0;0;57,26094;10,995557
1666;"Læsø";"no";0;0;0;57,26094;10,995557
1667;"Læsø";"no";0;0;0;57,26094;10,995557
1668;"Læsø";"no";0;0;0;57,26094;10,995557
1669;"Læsø";"no";0;0;0;57,26094;10,995557
1670;"Læsø";"no";0;0;0;57,26094;10,995557
1671;"Læsø";"no";0;0;0;57,26094;10,995557
1672;"Læsø";"no";1;1;2;57,26094;10,995557
1673;"Læsø";"no";0;0;0;57,26094;10,995557
1674;"Læsø";"no";0;0;0;57,26094;10,995557
1675;"Læsø";"no";0;0;0;57,26094;10,995557
1676;"Læsø";"no";0;0;0;57,26094;10,995557
1677;"Læsø";"no";0;0;0;57,26094;10,995557
1678;"Læsø";"no";0;0;0;57,26094;10,995557
1679;"Læsø";"no";4;3;7;57,26094;10,995557
1680;"Læsø";"no";0;0;0;57,26094;10,995557
1681;"Læsø";"no";0;0;0;57,26094;10,995557
1682;"Læsø";"no";0;0;0;57,26094;10,995557
1683;"Læsø";"no";0;0;0;57,26094;10,995557
1684;"Læsø";"no";0;0;0;57,26094;10,995557
1685;"Læsø";"no";2;0;2;57,26094;10,995557
1686;"Læsø";"no";0;0;0;57,26094;10,995557
1687;"Læsø";"no";0;0;0;57,26094;10,995557
1688;"Læsø";"no";1;0;1;57,26094;10,995557
1689;"Læsø";"no";0;0;0;57,26094;10,995557
1690;"Læsø";"no";0;0;0;57,26094;10,995557
1691;"Læsø";"no";0;0;0;57,26094;10,995557
1692;"Læsø";"no";1;0;1;57,26094;10,995557
1693;"Læsø";"no";0;0;0;57,26094;10,995557
1694;"Læsø";"no";0;0;0;57,26094;10,995557
1695;"Læsø";"no";0;0;0;57,26094;10,995557
1696;"Læsø";"no";0;0;0;57,26094;10,995557
1697;"Læsø";"no";0;0;0;57,26094;10,995557
1698;"Læsø";"no";0;0;0;57,26094;10,995557
1699;"Læsø";"no";0;0;0;57,26094;10,995557
1700;"Læsø";"no";0;0;0;57,26094;10,995557
1701;"Læsø";"no";0;0;0;57,26094;10,995557
1702;"Læsø";"no";0;0;0;57,26094;10,995557
1703;"Læsø";"no";0;0;0;57,26094;10,995557
1704;"Læsø";"no";0;1;1;57,26094;10,995557
1705;"Læsø";"no";0;0;0;57,26094;10,995557
1706;"Læsø";"no";0;0;0;57,26094;10,995557
1707;"Læsø";"no";0;0;0;57,26094;10,995557
1708;"Læsø";"no";0;0;0;57,26094;10,995557
1709;"Læsø";"no";0;0;0;57,26094;10,995557
1710;"Læsø";"no";0;0;0;57,26094;10,995557
1711;"Læsø";"no";0;0;0;57,26094;10,995557
1712;"Læsø";"no";0;0;0;57,26094;10,995557
1713;"Læsø";"no";0;0;0;57,26094;10,995557
1714;"Læsø";"no";0;0;0;57,26094;10,995557
1715;"Læsø";"no";0;0;0;57,26094;10,995557
1716;"Læsø";"no";0;0;0;57,26094;10,995557
1717;"Læsø";"no";0;0;0;57,26094;10,995557
1718;"Læsø";"no";0;0;0;57,26094;10,995557
1719;"Læsø";"no";0;0;0;57,26094;10,995557
1720;"Læsø";"no";0;0;0;57,26094;10,995557
1721;"Læsø";"no";0;0;0;57,26094;10,995557
1722;"Læsø";"no";0;0;0;57,26094;10,995557
1723;"Læsø";"no";0;0;0;57,26094;10,995557
1724;"Læsø";"no";0;0;0;57,26094;10,995557
1725;"Læsø";"no";0;0;0;57,26094;10,995557
1726;"Læsø";"no";0;0;0;57,26094;10,995557
1727;"Læsø";"no";0;0;0;57,26094;10,995557
1728;"Læsø";"no";0;0;0;57,26094;10,995557
1729;"Læsø";"no";0;0;0;57,26094;10,995557
1730;"Læsø";"no";0;0;0;57,26094;10,995557
1731;"Læsø";"no";0;0;0;57,26094;10,995557
1732;"Læsø";"no";0;0;0;57,26094;10,995557
1733;"Læsø";"no";0;0;0;57,26094;10,995557
1734;"Læsø";"no";0;0;0;57,26094;10,995557
1735;"Læsø";"no";0;0;0;57,26094;10,995557
1736;"Læsø";"no";0;0;0;57,26094;10,995557
1737;"Læsø";"no";0;0;0;57,26094;10,995557
1738;"Læsø";"no";0;0;0;57,26094;10,995557
1739;"Læsø";"no";0;0;0;57,26094;10,995557
1740;"Læsø";"no";0;0;0;57,26094;10,995557
1741;"Læsø";"no";0;1;1;57,26094;10,995557
1742;"Læsø";"no";1;0;1;57,26094;10,995557
1743;"Læsø";"no";0;0;0;57,26094;10,995557
1744;"Læsø";"no";0;0;0;57,26094;10,995557
1745;"Læsø";"no";0;0;0;57,26094;10,995557
1746;"Læsø";"no";0;0;0;57,26094;10,995557
1747;"Læsø";"no";0;0;0;57,26094;10,995557
1748;"Læsø";"no";0;0;0;57,26094;10,995557
1749;"Læsø";"no";0;0;0;57,26094;10,995557
1750;"Læsø";"no";0;0;0;57,26094;10,995557
1751;"Læsø";"no";0;0;0;57,26094;10,995557
1752;"Læsø";"no";0;0;0;57,26094;10,995557
1753;"Læsø";"no";0;0;0;57,26094;10,995557
1754;"Læsø";"no";0;0;0;57,26094;10,995557
1755;"Læsø";"no";0;0;0;57,26094;10,995557
1756;"Læsø";"no";0;0;0;57,26094;10,995557
1757;"Læsø";"no";0;0;0;57,26094;10,995557
1758;"Læsø";"no";0;0;0;57,26094;10,995557
1759;"Læsø";"no";0;0;0;57,26094;10,995557
1760;"Læsø";"no";0;0;0;57,26094;10,995557
1761;"Læsø";"no";0;0;0;57,26094;10,995557
1762;"Læsø";"no";1;0;1;57,26094;10,995557
1763;"Læsø";"no";0;0;0;57,26094;10,995557
1764;"Læsø";"no";1;0;1;57,26094;10,995557
1765;"Læsø";"no";0;0;0;57,26094;10,995557
1766;"Læsø";"no";0;0;0;57,26094;10,995557
1767;"Læsø";"no";0;0;0;57,26094;10,995557
1768;"Læsø";"no";2;0;2;57,26094;10,995557
1769;"Læsø";"no";0;0;0;57,26094;10,995557
1770;"Læsø";"no";0;0;0;57,26094;10,995557
1771;"Læsø";"no";0;0;0;57,26094;10,995557
1772;"Læsø";"no";0;0;0;57,26094;10,995557
1773;"Læsø";"no";0;0;0;57,26094;10,995557
1774;"Læsø";"no";0;0;0;57,26094;10,995557
1775;"Læsø";"no";0;0;0;57,26094;10,995557
1776;"Læsø";"no";0;0;0;57,26094;10,995557
1777;"Læsø";"no";0;0;0;57,26094;10,995557
1778;"Læsø";"no";0;0;0;57,26094;10,995557
1779;"Læsø";"no";0;0;0;57,26094;10,995557
1780;"Læsø";"no";0;0;0;57,26094;10,995557
1781;"Læsø";"no";2;0;2;57,26094;10,995557
1782;"Læsø";"no";0;0;0;57,26094;10,995557
1783;"Læsø";"no";0;0;0;57,26094;10,995557
1784;"Læsø";"no";0;0;0;57,26094;10,995557
1785;"Læsø";"no";0;0;0;57,26094;10,995557
1786;"Læsø";"no";0;0;0;57,26094;10,995557
1787;"Læsø";"no";0;0;0;57,26094;10,995557
1788;"Læsø";"no";0;0;0;57,26094;10,995557
1789;"Læsø";"no";0;0;0;57,26094;10,995557
1790;"Læsø";"no";0;0;0;57,26094;10,995557
1791;"Læsø";"no";1;0;1;57,26094;10,995557
1792;"Læsø";"no";0;0;0;57,26094;10,995557
1793;"Læsø";"no";0;0;0;57,26094;10,995557
1794;"Læsø";"no";0;0;0;57,26094;10,995557
1795;"Læsø";"no";0;0;0;57,26094;10,995557
1796;"Læsø";"no";0;0;0;57,26094;10,995557
1797;"Læsø";"no";0;0;0;57,26094;10,995557
1798;"Læsø";"no";3;0;3;57,26094;10,995557
1799;"Læsø";"no";0;0;0;57,26094;10,995557
1800;"Læsø";"no";0;0;0;57,26094;10,995557
1801;"Læsø";"no";0;0;0;57,26094;10,995557
1802;"Læsø";"no";0;0;0;57,26094;10,995557
1803;"Læsø";"no";4;0;4;57,26094;10,995557
1804;"Læsø";"no";4;0;4;57,26094;10,995557
1805;"Læsø";"no";0;0;0;57,26094;10,995557
1806;"Læsø";"no";0;0;0;57,26094;10,995557
1807;"Læsø";"no";0;0;0;57,26094;10,995557
1808;"Læsø";"no";0;0;0;57,26094;10,995557
1809;"Læsø";"no";0;0;0;57,26094;10,995557
1810;"Læsø";"no";0;0;0;57,26094;10,995557
1811;"Læsø";"no";0;0;0;57,26094;10,995557
1812;"Læsø";"no";0;0;0;57,26094;10,995557
1813;"Læsø";"no";0;0;0;57,26094;10,995557
1814;"Læsø";"no";0;0;0;57,26094;10,995557
1815;"Læsø";"no";1;0;1;57,26094;10,995557
1816;"Læsø";"no";0;0;0;57,26094;10,995557
1817;"Læsø";"no";0;0;0;57,26094;10,995557
1818;"Læsø";"no";0;0;0;57,26094;10,995557
1819;"Læsø";"no";0;0;0;57,26094;10,995557
1820;"Læsø";"no";0;0;0;57,26094;10,995557
1821;"Læsø";"no";0;0;0;57,26094;10,995557
1822;"Læsø";"no";0;0;0;57,26094;10,995557
1823;"Læsø";"no";0;0;0;57,26094;10,995557
1824;"Læsø";"no";0;0;0;57,26094;10,995557
1825;"Læsø";"no";0;0;0;57,26094;10,995557
1826;"Læsø";"no";0;0;0;57,26094;10,995557
1827;"Læsø";"no";0;0;0;57,26094;10,995557
1828;"Læsø";"no";0;0;0;57,26094;10,995557
1829;"Læsø";"no";0;0;0;57,26094;10,995557
1830;"Læsø";"no";0;0;0;57,26094;10,995557
1831;"Læsø";"no";3;0;3;57,26094;10,995557
1832;"Læsø";"no";0;0;0;57,26094;10,995557
1833;"Læsø";"no";0;0;0;57,26094;10,995557
1834;"Læsø";"no";0;0;0;57,26094;10,995557
1835;"Læsø";"no";0;0;0;57,26094;10,995557
1836;"Læsø";"no";1;0;1;57,26094;10,995557
1837;"Læsø";"no";0;0;0;57,26094;10,995557
1838;"Læsø";"no";0;0;0;57,26094;10,995557
1839;"Læsø";"no";0;0;0;57,26094;10,995557
1840;"Læsø";"no";0;0;0;57,26094;10,995557
1841;"Læsø";"no";0;0;0;57,26094;10,995557
1842;"Læsø";"no";5;0;5;57,26094;10,995557
1843;"Læsø";"no";1;0;1;57,26094;10,995557
1844;"Læsø";"no";10;0;10;57,26094;10,995557
1845;"Læsø";"no";4;0;4;57,26094;10,995557
1846;"Læsø";"no";5;0;5;57,26094;10,995557
1847;"Læsø";"no";3;0;3;57,26094;10,995557
1848;"Læsø";"no";2;0;2;57,26094;10,995557
1849;"Læsø";"no";3;0;3;57,26094;10,995557
1850;"Læsø";"no";4;0;4;57,26094;10,995557
1851;"Læsø";"no";1;0;1;57,26094;10,995557
1852;"Læsø";"no";1;0;1;57,26094;10,995557
1853;"Læsø";"no";3;0;3;57,26094;10,995557
1854;"Læsø";"no";15;0;15;57,26094;10,995557
1855;"Læsø";"no";2;0;2;57,26094;10,995557
1856;"Læsø";"no";9;1;10;57,26094;10,995557
1857;"Læsø";"no";0;0;0;57,26094;10,995557
1634;"Løgtebro";"no";0;0;0;56,766666;8,266666
1635;"Løgtebro";"no";8;0;8;56,766666;8,266666
1636;"Løgtebro";"no";0;0;0;56,766666;8,266666
1637;"Løgtebro";"no";0;0;0;56,766666;8,266666
1638;"Løgtebro";"no";0;0;0;56,766666;8,266666
1639;"Løgtebro";"no";0;0;0;56,766666;8,266666
1640;"Løgtebro";"no";0;0;0;56,766666;8,266666
1641;"Løgtebro";"no";0;0;0;56,766666;8,266666
1642;"Løgtebro";"no";0;0;0;56,766666;8,266666
1643;"Løgtebro";"no";1;0;1;56,766666;8,266666
1644;"Løgtebro";"no";0;0;0;56,766666;8,266666
1645;"Løgtebro";"no";0;0;0;56,766666;8,266666
1646;"Løgtebro";"no";0;0;0;56,766666;8,266666
1647;"Løgtebro";"no";0;0;0;56,766666;8,266666
1648;"Løgtebro";"no";0;0;0;56,766666;8,266666
1649;"Løgtebro";"no";0;0;0;56,766666;8,266666
1650;"Løgtebro";"no";0;0;0;56,766666;8,266666
1651;"Løgtebro";"no";0;0;0;56,766666;8,266666
1652;"Løgtebro";"no";0;0;0;56,766666;8,266666
1653;"Løgtebro";"no";0;0;0;56,766666;8,266666
1654;"Løgtebro";"no";0;0;0;56,766666;8,266666
1655;"Løgtebro";"no";0;0;0;56,766666;8,266666
1656;"Løgtebro";"no";0;0;0;56,766666;8,266666
1657;"Løgtebro";"no";0;0;0;56,766666;8,266666
1658;"Løgtebro";"no";0;0;0;56,766666;8,266666
1659;"Løgtebro";"no";0;0;0;56,766666;8,266666
1660;"Løgtebro";"no";0;0;0;56,766666;8,266666
1661;"Løgtebro";"no";0;0;0;56,766666;8,266666
1662;"Løgtebro";"no";0;0;0;56,766666;8,266666
1663;"Løgtebro";"no";0;0;0;56,766666;8,266666
1664;"Løgtebro";"no";0;0;0;56,766666;8,266666
1665;"Løgtebro";"no";0;0;0;56,766666;8,266666
1666;"Løgtebro";"no";0;0;0;56,766666;8,266666
1667;"Løgtebro";"no";0;0;0;56,766666;8,266666
1668;"Løgtebro";"no";0;0;0;56,766666;8,266666
1669;"Løgtebro";"no";0;0;0;56,766666;8,266666
1670;"Løgtebro";"no";0;0;0;56,766666;8,266666
1671;"Løgtebro";"no";0;0;0;56,766666;8,266666
1672;"Løgtebro";"no";0;0;0;56,766666;8,266666
1673;"Løgtebro";"no";0;0;0;56,766666;8,266666
1674;"Løgtebro";"no";0;0;0;56,766666;8,266666
1675;"Løgtebro";"no";0;0;0;56,766666;8,266666
1676;"Løgtebro";"no";0;0;0;56,766666;8,266666
1677;"Løgtebro";"no";0;0;0;56,766666;8,266666
1678;"Løgtebro";"no";0;0;0;56,766666;8,266666
1679;"Løgtebro";"no";0;0;0;56,766666;8,266666
1680;"Løgtebro";"no";0;0;0;56,766666;8,266666
1681;"Løgtebro";"no";0;0;0;56,766666;8,266666
1682;"Løgtebro";"no";0;0;0;56,766666;8,266666
1683;"Løgtebro";"no";0;0;0;56,766666;8,266666
1684;"Løgtebro";"no";0;0;0;56,766666;8,266666
1685;"Løgtebro";"no";0;0;0;56,766666;8,266666
1686;"Løgtebro";"no";0;0;0;56,766666;8,266666
1687;"Løgtebro";"no";0;0;0;56,766666;8,266666
1688;"Løgtebro";"no";0;0;0;56,766666;8,266666
1689;"Løgtebro";"no";0;0;0;56,766666;8,266666
1690;"Løgtebro";"no";0;0;0;56,766666;8,266666
1691;"Løgtebro";"no";0;0;0;56,766666;8,266666
1692;"Løgtebro";"no";0;0;0;56,766666;8,266666
1693;"Løgtebro";"no";0;0;0;56,766666;8,266666
1694;"Løgtebro";"no";0;0;0;56,766666;8,266666
1695;"Løgtebro";"no";0;0;0;56,766666;8,266666
1696;"Løgtebro";"no";0;0;0;56,766666;8,266666
1697;"Løgtebro";"no";0;0;0;56,766666;8,266666
1698;"Løgtebro";"no";0;0;0;56,766666;8,266666
1699;"Løgtebro";"no";0;0;0;56,766666;8,266666
1700;"Løgtebro";"no";0;0;0;56,766666;8,266666
1701;"Løgtebro";"no";0;0;0;56,766666;8,266666
1702;"Løgtebro";"no";0;0;0;56,766666;8,266666
1703;"Løgtebro";"no";0;0;0;56,766666;8,266666
1704;"Løgtebro";"no";0;0;0;56,766666;8,266666
1705;"Løgtebro";"no";0;0;0;56,766666;8,266666
1706;"Løgtebro";"no";0;0;0;56,766666;8,266666
1707;"Løgtebro";"no";0;0;0;56,766666;8,266666
1708;"Løgtebro";"no";0;0;0;56,766666;8,266666
1709;"Løgtebro";"no";0;0;0;56,766666;8,266666
1710;"Løgtebro";"no";0;0;0;56,766666;8,266666
1711;"Løgtebro";"no";0;0;0;56,766666;8,266666
1712;"Løgtebro";"no";0;0;0;56,766666;8,266666
1713;"Løgtebro";"no";0;0;0;56,766666;8,266666
1714;"Løgtebro";"no";0;0;0;56,766666;8,266666
1715;"Løgtebro";"no";0;0;0;56,766666;8,266666
1716;"Løgtebro";"no";0;0;0;56,766666;8,266666
1717;"Løgtebro";"no";0;0;0;56,766666;8,266666
1718;"Løgtebro";"no";0;0;0;56,766666;8,266666
1719;"Løgtebro";"no";0;0;0;56,766666;8,266666
1720;"Løgtebro";"no";0;0;0;56,766666;8,266666
1721;"Løgtebro";"no";0;0;0;56,766666;8,266666
1722;"Løgtebro";"no";0;0;0;56,766666;8,266666
1723;"Løgtebro";"no";0;0;0;56,766666;8,266666
1724;"Løgtebro";"no";0;0;0;56,766666;8,266666
1725;"Løgtebro";"no";0;0;0;56,766666;8,266666
1726;"Løgtebro";"no";0;0;0;56,766666;8,266666
1727;"Løgtebro";"no";0;0;0;56,766666;8,266666
1728;"Løgtebro";"no";0;0;0;56,766666;8,266666
1729;"Løgtebro";"no";0;0;0;56,766666;8,266666
1730;"Løgtebro";"no";0;0;0;56,766666;8,266666
1731;"Løgtebro";"no";0;0;0;56,766666;8,266666
1732;"Løgtebro";"no";0;0;0;56,766666;8,266666
1733;"Løgtebro";"no";0;0;0;56,766666;8,266666
1734;"Løgtebro";"no";0;0;0;56,766666;8,266666
1735;"Løgtebro";"no";0;0;0;56,766666;8,266666
1736;"Løgtebro";"no";0;0;0;56,766666;8,266666
1737;"Løgtebro";"no";0;0;0;56,766666;8,266666
1738;"Løgtebro";"no";0;0;0;56,766666;8,266666
1739;"Løgtebro";"no";0;0;0;56,766666;8,266666
1740;"Løgtebro";"no";0;0;0;56,766666;8,266666
1741;"Løgtebro";"no";0;0;0;56,766666;8,266666
1742;"Løgtebro";"no";0;0;0;56,766666;8,266666
1743;"Løgtebro";"no";0;0;0;56,766666;8,266666
1744;"Løgtebro";"no";0;0;0;56,766666;8,266666
1745;"Løgtebro";"no";0;0;0;56,766666;8,266666
1746;"Løgtebro";"no";0;0;0;56,766666;8,266666
1747;"Løgtebro";"no";0;0;0;56,766666;8,266666
1748;"Løgtebro";"no";0;0;0;56,766666;8,266666
1749;"Løgtebro";"no";0;0;0;56,766666;8,266666
1750;"Løgtebro";"no";0;0;0;56,766666;8,266666
1751;"Løgtebro";"no";0;0;0;56,766666;8,266666
1752;"Løgtebro";"no";0;0;0;56,766666;8,266666
1753;"Løgtebro";"no";0;0;0;56,766666;8,266666
1754;"Løgtebro";"no";0;0;0;56,766666;8,266666
1755;"Løgtebro";"no";0;0;0;56,766666;8,266666
1756;"Løgtebro";"no";0;0;0;56,766666;8,266666
1757;"Løgtebro";"no";0;0;0;56,766666;8,266666
1758;"Løgtebro";"no";0;0;0;56,766666;8,266666
1759;"Løgtebro";"no";0;0;0;56,766666;8,266666
1760;"Løgtebro";"no";0;0;0;56,766666;8,266666
1761;"Løgtebro";"no";0;0;0;56,766666;8,266666
1762;"Løgtebro";"no";0;0;0;56,766666;8,266666
1763;"Løgtebro";"no";0;0;0;56,766666;8,266666
1764;"Løgtebro";"no";0;0;0;56,766666;8,266666
1765;"Løgtebro";"no";0;0;0;56,766666;8,266666
1766;"Løgtebro";"no";0;0;0;56,766666;8,266666
1767;"Løgtebro";"no";0;0;0;56,766666;8,266666
1768;"Løgtebro";"no";0;0;0;56,766666;8,266666
1769;"Løgtebro";"no";0;0;0;56,766666;8,266666
1770;"Løgtebro";"no";0;0;0;56,766666;8,266666
1771;"Løgtebro";"no";0;0;0;56,766666;8,266666
1772;"Løgtebro";"no";0;0;0;56,766666;8,266666
1773;"Løgtebro";"no";0;0;0;56,766666;8,266666
1774;"Løgtebro";"no";0;0;0;56,766666;8,266666
1775;"Løgtebro";"no";0;0;0;56,766666;8,266666
1776;"Løgtebro";"no";0;0;0;56,766666;8,266666
1777;"Løgtebro";"no";0;0;0;56,766666;8,266666
1778;"Løgtebro";"no";0;0;0;56,766666;8,266666
1779;"Løgtebro";"no";0;0;0;56,766666;8,266666
1780;"Løgtebro";"no";0;0;0;56,766666;8,266666
1781;"Løgtebro";"no";0;0;0;56,766666;8,266666
1782;"Løgtebro";"no";0;0;0;56,766666;8,266666
1783;"Løgtebro";"no";0;0;0;56,766666;8,266666
1784;"Løgtebro";"no";0;0;0;56,766666;8,266666
1785;"Løgtebro";"no";0;0;0;56,766666;8,266666
1786;"Løgtebro";"no";0;0;0;56,766666;8,266666
1787;"Løgtebro";"no";0;0;0;56,766666;8,266666
1788;"Løgtebro";"no";0;0;0;56,766666;8,266666
1789;"Løgtebro";"no";0;0;0;56,766666;8,266666
1790;"Løgtebro";"no";0;0;0;56,766666;8,266666
1791;"Løgtebro";"no";0;0;0;56,766666;8,266666
1792;"Løgtebro";"no";0;0;0;56,766666;8,266666
1793;"Løgtebro";"no";0;0;0;56,766666;8,266666
1794;"Løgtebro";"no";0;0;0;56,766666;8,266666
1795;"Løgtebro";"no";0;0;0;56,766666;8,266666
1796;"Løgtebro";"no";0;0;0;56,766666;8,266666
1797;"Løgtebro";"no";0;0;0;56,766666;8,266666
1798;"Løgtebro";"no";0;0;0;56,766666;8,266666
1799;"Løgtebro";"no";0;0;0;56,766666;8,266666
1800;"Løgtebro";"no";0;0;0;56,766666;8,266666
1801;"Løgtebro";"no";0;0;0;56,766666;8,266666
1802;"Løgtebro";"no";0;0;0;56,766666;8,266666
1803;"Løgtebro";"no";0;0;0;56,766666;8,266666
1804;"Løgtebro";"no";0;0;0;56,766666;8,266666
1805;"Løgtebro";"no";0;0;0;56,766666;8,266666
1806;"Løgtebro";"no";0;0;0;56,766666;8,266666
1807;"Løgtebro";"no";0;0;0;56,766666;8,266666
1808;"Løgtebro";"no";0;0;0;56,766666;8,266666
1809;"Løgtebro";"no";0;0;0;56,766666;8,266666
1810;"Løgtebro";"no";0;0;0;56,766666;8,266666
1811;"Løgtebro";"no";0;0;0;56,766666;8,266666
1812;"Løgtebro";"no";0;0;0;56,766666;8,266666
1813;"Løgtebro";"no";0;0;0;56,766666;8,266666
1814;"Løgtebro";"no";0;0;0;56,766666;8,266666
1815;"Løgtebro";"no";0;0;0;56,766666;8,266666
1816;"Løgtebro";"no";0;0;0;56,766666;8,266666
1817;"Løgtebro";"no";0;0;0;56,766666;8,266666
1818;"Løgtebro";"no";0;0;0;56,766666;8,266666
1819;"Løgtebro";"no";0;0;0;56,766666;8,266666
1820;"Løgtebro";"no";0;0;0;56,766666;8,266666
1821;"Løgtebro";"no";0;0;0;56,766666;8,266666
1822;"Løgtebro";"no";0;0;0;56,766666;8,266666
1823;"Løgtebro";"no";0;0;0;56,766666;8,266666
1824;"Løgtebro";"no";0;0;0;56,766666;8,266666
1825;"Løgtebro";"no";0;0;0;56,766666;8,266666
1826;"Løgtebro";"no";0;0;0;56,766666;8,266666
1827;"Løgtebro";"no";0;0;0;56,766666;8,266666
1828;"Løgtebro";"no";0;0;0;56,766666;8,266666
1829;"Løgtebro";"no";0;0;0;56,766666;8,266666
1830;"Løgtebro";"no";0;0;0;56,766666;8,266666
1831;"Løgtebro";"no";0;0;0;56,766666;8,266666
1832;"Løgtebro";"no";0;0;0;56,766666;8,266666
1833;"Løgtebro";"no";0;0;0;56,766666;8,266666
1834;"Løgtebro";"no";0;0;0;56,766666;8,266666
1835;"Løgtebro";"no";0;0;0;56,766666;8,266666
1836;"Løgtebro";"no";0;0;0;56,766666;8,266666
1837;"Løgtebro";"no";0;0;0;56,766666;8,266666
1838;"Løgtebro";"no";0;0;0;56,766666;8,266666
1839;"Løgtebro";"no";0;0;0;56,766666;8,266666
1840;"Løgtebro";"no";0;0;0;56,766666;8,266666
1841;"Løgtebro";"no";0;0;0;56,766666;8,266666
1842;"Løgtebro";"no";0;0;0;56,766666;8,266666
1843;"Løgtebro";"no";0;0;0;56,766666;8,266666
1844;"Løgtebro";"no";0;0;0;56,766666;8,266666
1845;"Løgtebro";"no";0;0;0;56,766666;8,266666
1846;"Løgtebro";"no";0;0;0;56,766666;8,266666
1847;"Løgtebro";"no";0;0;0;56,766666;8,266666
1848;"Løgtebro";"no";0;0;0;56,766666;8,266666
1849;"Løgtebro";"no";0;0;0;56,766666;8,266666
1850;"Løgtebro";"no";0;0;0;56,766666;8,266666
1851;"Løgtebro";"no";0;0;0;56,766666;8,266666
1852;"Løgtebro";"no";0;0;0;56,766666;8,266666
1853;"Løgtebro";"no";0;0;0;56,766666;8,266666
1854;"Løgtebro";"no";0;0;0;56,766666;8,266666
1855;"Løgtebro";"no";0;0;0;56,766666;8,266666
1856;"Løgtebro";"no";0;0;0;56,766666;8,266666
1857;"Løgtebro";"no";0;0;0;56,766666;8,266666
1634;"Mariager";"no";0;0;0;56,651812;9,980455
1635;"Mariager";"no";1;0;1;56,651812;9,980455
1636;"Mariager";"no";2;0;2;56,651812;9,980455
1637;"Mariager";"no";2;0;2;56,651812;9,980455
1638;"Mariager";"no";8;0;8;56,651812;9,980455
1639;"Mariager";"no";8;0;8;56,651812;9,980455
1640;"Mariager";"no";6;0;6;56,651812;9,980455
1641;"Mariager";"no";11;0;11;56,651812;9,980455
1642;"Mariager";"no";11;2;13;56,651812;9,980455
1643;"Mariager";"no";4;2;6;56,651812;9,980455
1644;"Mariager";"no";0;0;0;56,651812;9,980455
1645;"Mariager";"no";1;0;1;56,651812;9,980455
1646;"Mariager";"no";0;0;0;56,651812;9,980455
1647;"Mariager";"no";3;0;3;56,651812;9,980455
1648;"Mariager";"no";0;0;0;56,651812;9,980455
1649;"Mariager";"no";0;0;0;56,651812;9,980455
1650;"Mariager";"no";1;1;2;56,651812;9,980455
1651;"Mariager";"no";0;0;0;56,651812;9,980455
1652;"Mariager";"no";0;0;0;56,651812;9,980455
1653;"Mariager";"no";0;1;1;56,651812;9,980455
1654;"Mariager";"no";0;0;0;56,651812;9,980455
1655;"Mariager";"no";0;0;0;56,651812;9,980455
1656;"Mariager";"no";0;0;0;56,651812;9,980455
1657;"Mariager";"no";0;0;0;56,651812;9,980455
1658;"Mariager";"no";0;0;0;56,651812;9,980455
1659;"Mariager";"no";0;0;0;56,651812;9,980455
1660;"Mariager";"no";0;0;0;56,651812;9,980455
1661;"Mariager";"no";0;0;0;56,651812;9,980455
1662;"Mariager";"no";0;1;1;56,651812;9,980455
1663;"Mariager";"no";0;0;0;56,651812;9,980455
1664;"Mariager";"no";0;1;1;56,651812;9,980455
1665;"Mariager";"no";0;0;0;56,651812;9,980455
1666;"Mariager";"no";0;0;0;56,651812;9,980455
1667;"Mariager";"no";0;0;0;56,651812;9,980455
1668;"Mariager";"no";0;0;0;56,651812;9,980455
1669;"Mariager";"no";0;0;0;56,651812;9,980455
1670;"Mariager";"no";0;0;0;56,651812;9,980455
1671;"Mariager";"no";0;0;0;56,651812;9,980455
1672;"Mariager";"no";0;1;1;56,651812;9,980455
1673;"Mariager";"no";0;0;0;56,651812;9,980455
1674;"Mariager";"no";0;0;0;56,651812;9,980455
1675;"Mariager";"no";0;0;0;56,651812;9,980455
1676;"Mariager";"no";0;0;0;56,651812;9,980455
1677;"Mariager";"no";0;0;0;56,651812;9,980455
1678;"Mariager";"no";0;0;0;56,651812;9,980455
1679;"Mariager";"no";1;0;1;56,651812;9,980455
1680;"Mariager";"no";0;0;0;56,651812;9,980455
1681;"Mariager";"no";0;0;0;56,651812;9,980455
1682;"Mariager";"no";0;0;0;56,651812;9,980455
1683;"Mariager";"no";0;0;0;56,651812;9,980455
1684;"Mariager";"no";0;0;0;56,651812;9,980455
1685;"Mariager";"no";0;0;0;56,651812;9,980455
1686;"Mariager";"no";0;0;0;56,651812;9,980455
1687;"Mariager";"no";0;0;0;56,651812;9,980455
1688;"Mariager";"no";0;0;0;56,651812;9,980455
1689;"Mariager";"no";0;1;1;56,651812;9,980455
1690;"Mariager";"no";1;0;1;56,651812;9,980455
1691;"Mariager";"no";0;0;0;56,651812;9,980455
1692;"Mariager";"no";0;0;0;56,651812;9,980455
1693;"Mariager";"no";0;0;0;56,651812;9,980455
1694;"Mariager";"no";0;0;0;56,651812;9,980455
1695;"Mariager";"no";0;0;0;56,651812;9,980455
1696;"Mariager";"no";0;0;0;56,651812;9,980455
1697;"Mariager";"no";0;0;0;56,651812;9,980455
1698;"Mariager";"no";0;0;0;56,651812;9,980455
1699;"Mariager";"no";0;0;0;56,651812;9,980455
1700;"Mariager";"no";0;0;0;56,651812;9,980455
1701;"Mariager";"no";0;0;0;56,651812;9,980455
1702;"Mariager";"no";0;0;0;56,651812;9,980455
1703;"Mariager";"no";0;1;1;56,651812;9,980455
1704;"Mariager";"no";0;0;0;56,651812;9,980455
1705;"Mariager";"no";0;0;0;56,651812;9,980455
1706;"Mariager";"no";0;0;0;56,651812;9,980455
1707;"Mariager";"no";0;0;0;56,651812;9,980455
1708;"Mariager";"no";0;0;0;56,651812;9,980455
1709;"Mariager";"no";0;0;0;56,651812;9,980455
1710;"Mariager";"no";0;0;0;56,651812;9,980455
1711;"Mariager";"no";0;0;0;56,651812;9,980455
1712;"Mariager";"no";0;0;0;56,651812;9,980455
1713;"Mariager";"no";0;0;0;56,651812;9,980455
1714;"Mariager";"no";0;0;0;56,651812;9,980455
1715;"Mariager";"no";0;0;0;56,651812;9,980455
1716;"Mariager";"no";0;0;0;56,651812;9,980455
1717;"Mariager";"no";0;0;0;56,651812;9,980455
1718;"Mariager";"no";0;0;0;56,651812;9,980455
1719;"Mariager";"no";0;0;0;56,651812;9,980455
1720;"Mariager";"no";0;0;0;56,651812;9,980455
1721;"Mariager";"no";0;0;0;56,651812;9,980455
1722;"Mariager";"no";0;0;0;56,651812;9,980455
1723;"Mariager";"no";0;0;0;56,651812;9,980455
1724;"Mariager";"no";0;0;0;56,651812;9,980455
1725;"Mariager";"no";0;0;0;56,651812;9,980455
1726;"Mariager";"no";0;0;0;56,651812;9,980455
1727;"Mariager";"no";0;0;0;56,651812;9,980455
1728;"Mariager";"no";0;0;0;56,651812;9,980455
1729;"Mariager";"no";0;0;0;56,651812;9,980455
1730;"Mariager";"no";0;1;1;56,651812;9,980455
1731;"Mariager";"no";0;0;0;56,651812;9,980455
1732;"Mariager";"no";0;0;0;56,651812;9,980455
1733;"Mariager";"no";0;0;0;56,651812;9,980455
1734;"Mariager";"no";0;0;0;56,651812;9,980455
1735;"Mariager";"no";0;0;0;56,651812;9,980455
1736;"Mariager";"no";0;0;0;56,651812;9,980455
1737;"Mariager";"no";0;0;0;56,651812;9,980455
1738;"Mariager";"no";0;0;0;56,651812;9,980455
1739;"Mariager";"no";0;0;0;56,651812;9,980455
1740;"Mariager";"no";0;0;0;56,651812;9,980455
1741;"Mariager";"no";0;0;0;56,651812;9,980455
1742;"Mariager";"no";0;0;0;56,651812;9,980455
1743;"Mariager";"no";0;0;0;56,651812;9,980455
1744;"Mariager";"no";0;0;0;56,651812;9,980455
1745;"Mariager";"no";0;0;0;56,651812;9,980455
1746;"Mariager";"no";0;0;0;56,651812;9,980455
1747;"Mariager";"no";0;0;0;56,651812;9,980455
1748;"Mariager";"no";0;0;0;56,651812;9,980455
1749;"Mariager";"no";0;0;0;56,651812;9,980455
1750;"Mariager";"no";0;0;0;56,651812;9,980455
1751;"Mariager";"no";0;0;0;56,651812;9,980455
1752;"Mariager";"no";0;0;0;56,651812;9,980455
1753;"Mariager";"no";0;0;0;56,651812;9,980455
1754;"Mariager";"no";0;0;0;56,651812;9,980455
1755;"Mariager";"no";0;0;0;56,651812;9,980455
1756;"Mariager";"no";0;0;0;56,651812;9,980455
1757;"Mariager";"no";0;0;0;56,651812;9,980455
1758;"Mariager";"no";0;0;0;56,651812;9,980455
1759;"Mariager";"no";0;0;0;56,651812;9,980455
1760;"Mariager";"no";0;1;1;56,651812;9,980455
1761;"Mariager";"no";0;0;0;56,651812;9,980455
1762;"Mariager";"no";0;0;0;56,651812;9,980455
1763;"Mariager";"no";0;0;0;56,651812;9,980455
1764;"Mariager";"no";0;0;0;56,651812;9,980455
1765;"Mariager";"no";0;0;0;56,651812;9,980455
1766;"Mariager";"no";0;1;1;56,651812;9,980455
1767;"Mariager";"no";0;0;0;56,651812;9,980455
1768;"Mariager";"no";0;1;1;56,651812;9,980455
1769;"Mariager";"no";0;0;0;56,651812;9,980455
1770;"Mariager";"no";0;0;0;56,651812;9,980455
1771;"Mariager";"no";0;0;0;56,651812;9,980455
1772;"Mariager";"no";0;0;0;56,651812;9,980455
1773;"Mariager";"no";0;0;0;56,651812;9,980455
1774;"Mariager";"no";0;0;0;56,651812;9,980455
1775;"Mariager";"no";0;0;0;56,651812;9,980455
1776;"Mariager";"no";0;0;0;56,651812;9,980455
1777;"Mariager";"no";0;0;0;56,651812;9,980455
1778;"Mariager";"no";0;0;0;56,651812;9,980455
1779;"Mariager";"no";0;0;0;56,651812;9,980455
1780;"Mariager";"no";0;0;0;56,651812;9,980455
1781;"Mariager";"no";0;0;0;56,651812;9,980455
1782;"Mariager";"no";0;0;0;56,651812;9,980455
1783;"Mariager";"no";0;0;0;56,651812;9,980455
1784;"Mariager";"no";0;0;0;56,651812;9,980455
1785;"Mariager";"no";0;0;0;56,651812;9,980455
1786;"Mariager";"no";0;0;0;56,651812;9,980455
1787;"Mariager";"no";0;1;1;56,651812;9,980455
1788;"Mariager";"no";0;0;0;56,651812;9,980455
1789;"Mariager";"no";0;0;0;56,651812;9,980455
1790;"Mariager";"no";0;0;0;56,651812;9,980455
1791;"Mariager";"no";0;0;0;56,651812;9,980455
1792;"Mariager";"no";0;0;0;56,651812;9,980455
1793;"Mariager";"no";0;0;0;56,651812;9,980455
1794;"Mariager";"no";0;0;0;56,651812;9,980455
1795;"Mariager";"no";0;0;0;56,651812;9,980455
1796;"Mariager";"no";0;0;0;56,651812;9,980455
1797;"Mariager";"no";0;0;0;56,651812;9,980455
1798;"Mariager";"no";0;0;0;56,651812;9,980455
1799;"Mariager";"no";2;1;3;56,651812;9,980455
1800;"Mariager";"no";57;9;66;56,651812;9,980455
1801;"Mariager";"no";16;1;17;56,651812;9,980455
1802;"Mariager";"no";5;0;5;56,651812;9,980455
1803;"Mariager";"no";6;1;7;56,651812;9,980455
1804;"Mariager";"no";45;27;72;56,651812;9,980455
1805;"Mariager";"no";50;34;84;56,651812;9,980455
1806;"Mariager";"no";18;0;18;56,651812;9,980455
1807;"Mariager";"no";0;1;1;56,651812;9,980455
1808;"Mariager";"no";0;0;0;56,651812;9,980455
1809;"Mariager";"no";0;0;0;56,651812;9,980455
1810;"Mariager";"no";0;0;0;56,651812;9,980455
1811;"Mariager";"no";0;0;0;56,651812;9,980455
1812;"Mariager";"no";0;0;0;56,651812;9,980455
1813;"Mariager";"no";0;0;0;56,651812;9,980455
1814;"Mariager";"no";0;0;0;56,651812;9,980455
1815;"Mariager";"no";0;0;0;56,651812;9,980455
1816;"Mariager";"no";1;0;1;56,651812;9,980455
1817;"Mariager";"no";2;0;2;56,651812;9,980455
1818;"Mariager";"no";0;0;0;56,651812;9,980455
1819;"Mariager";"no";0;0;0;56,651812;9,980455
1820;"Mariager";"no";0;0;0;56,651812;9,980455
1821;"Mariager";"no";0;0;0;56,651812;9,980455
1822;"Mariager";"no";0;0;0;56,651812;9,980455
1823;"Mariager";"no";0;0;0;56,651812;9,980455
1824;"Mariager";"no";2;0;2;56,651812;9,980455
1825;"Mariager";"no";1;0;1;56,651812;9,980455
1826;"Mariager";"no";1;0;1;56,651812;9,980455
1827;"Mariager";"no";1;0;1;56,651812;9,980455
1828;"Mariager";"no";0;0;0;56,651812;9,980455
1829;"Mariager";"no";0;1;1;56,651812;9,980455
1830;"Mariager";"no";0;0;0;56,651812;9,980455
1831;"Mariager";"no";1;0;1;56,651812;9,980455
1832;"Mariager";"no";0;1;1;56,651812;9,980455
1833;"Mariager";"no";1;0;1;56,651812;9,980455
1834;"Mariager";"no";4;1;5;56,651812;9,980455
1835;"Mariager";"no";1;0;1;56,651812;9,980455
1836;"Mariager";"no";0;0;0;56,651812;9,980455
1837;"Mariager";"no";0;0;0;56,651812;9,980455
1838;"Mariager";"no";0;0;0;56,651812;9,980455
1839;"Mariager";"no";0;0;0;56,651812;9,980455
1840;"Mariager";"no";0;0;0;56,651812;9,980455
1841;"Mariager";"no";0;0;0;56,651812;9,980455
1842;"Mariager";"no";1;0;1;56,651812;9,980455
1843;"Mariager";"no";2;1;3;56,651812;9,980455
1844;"Mariager";"no";2;0;2;56,651812;9,980455
1845;"Mariager";"no";0;1;1;56,651812;9,980455
1846;"Mariager";"no";1;0;1;56,651812;9,980455
1847;"Mariager";"no";0;0;0;56,651812;9,980455
1848;"Mariager";"no";0;0;0;56,651812;9,980455
1849;"Mariager";"no";1;0;1;56,651812;9,980455
1850;"Mariager";"no";1;0;1;56,651812;9,980455
1851;"Mariager";"no";0;2;2;56,651812;9,980455
1852;"Mariager";"no";1;1;2;56,651812;9,980455
1853;"Mariager";"no";3;2;5;56,651812;9,980455
1854;"Mariager";"no";3;1;4;56,651812;9,980455
1855;"Mariager";"no";3;3;6;56,651812;9,980455
1856;"Mariager";"no";11;1;12;56,651812;9,980455
1857;"Mariager";"no";0;0;0;56,651812;9,980455
1634;"Nakskov";"no";0;0;0;54,833333;11,15
1635;"Nakskov";"no";4;0;4;54,833333;11,15
1636;"Nakskov";"no";4;0;4;54,833333;11,15
1637;"Nakskov";"no";6;0;6;54,833333;11,15
1638;"Nakskov";"no";2;0;2;54,833333;11,15
1639;"Nakskov";"no";0;0;0;54,833333;11,15
1640;"Nakskov";"no";0;0;0;54,833333;11,15
1641;"Nakskov";"no";1;0;1;54,833333;11,15
1642;"Nakskov";"no";3;0;3;54,833333;11,15
1643;"Nakskov";"no";0;0;0;54,833333;11,15
1644;"Nakskov";"no";0;0;0;54,833333;11,15
1645;"Nakskov";"no";1;0;1;54,833333;11,15
1646;"Nakskov";"no";0;0;0;54,833333;11,15
1647;"Nakskov";"no";0;0;0;54,833333;11,15
1648;"Nakskov";"no";0;0;0;54,833333;11,15
1649;"Nakskov";"no";0;0;0;54,833333;11,15
1650;"Nakskov";"no";0;0;0;54,833333;11,15
1651;"Nakskov";"no";0;0;0;54,833333;11,15
1652;"Nakskov";"no";0;0;0;54,833333;11,15
1653;"Nakskov";"no";0;0;0;54,833333;11,15
1654;"Nakskov";"no";2;0;2;54,833333;11,15
1655;"Nakskov";"no";0;0;0;54,833333;11,15
1656;"Nakskov";"no";0;0;0;54,833333;11,15
1657;"Nakskov";"no";0;0;0;54,833333;11,15
1658;"Nakskov";"no";0;0;0;54,833333;11,15
1659;"Nakskov";"no";0;0;0;54,833333;11,15
1660;"Nakskov";"no";0;0;0;54,833333;11,15
1661;"Nakskov";"no";0;0;0;54,833333;11,15
1662;"Nakskov";"no";0;0;0;54,833333;11,15
1663;"Nakskov";"no";0;0;0;54,833333;11,15
1664;"Nakskov";"no";0;0;0;54,833333;11,15
1665;"Nakskov";"no";0;0;0;54,833333;11,15
1666;"Nakskov";"no";1;0;1;54,833333;11,15
1667;"Nakskov";"no";0;0;0;54,833333;11,15
1668;"Nakskov";"no";0;0;0;54,833333;11,15
1669;"Nakskov";"no";0;0;0;54,833333;11,15
1670;"Nakskov";"no";0;0;0;54,833333;11,15
1671;"Nakskov";"no";0;0;0;54,833333;11,15
1672;"Nakskov";"no";0;1;1;54,833333;11,15
1673;"Nakskov";"no";1;0;1;54,833333;11,15
1674;"Nakskov";"no";0;0;0;54,833333;11,15
1675;"Nakskov";"no";1;0;1;54,833333;11,15
1676;"Nakskov";"no";0;0;0;54,833333;11,15
1677;"Nakskov";"no";2;1;3;54,833333;11,15
1678;"Nakskov";"no";3;1;4;54,833333;11,15
1679;"Nakskov";"no";2;1;3;54,833333;11,15
1680;"Nakskov";"no";0;1;1;54,833333;11,15
1681;"Nakskov";"no";0;2;2;54,833333;11,15
1682;"Nakskov";"no";0;0;0;54,833333;11,15
1683;"Nakskov";"no";0;0;0;54,833333;11,15
1684;"Nakskov";"no";0;0;0;54,833333;11,15
1685;"Nakskov";"no";0;1;1;54,833333;11,15
1686;"Nakskov";"no";0;1;1;54,833333;11,15
1687;"Nakskov";"no";0;0;0;54,833333;11,15
1688;"Nakskov";"no";0;0;0;54,833333;11,15
1689;"Nakskov";"no";0;0;0;54,833333;11,15
1690;"Nakskov";"no";0;0;0;54,833333;11,15
1691;"Nakskov";"no";0;1;1;54,833333;11,15
1692;"Nakskov";"no";0;1;1;54,833333;11,15
1693;"Nakskov";"no";1;0;1;54,833333;11,15
1694;"Nakskov";"no";3;1;4;54,833333;11,15
1695;"Nakskov";"no";1;0;1;54,833333;11,15
1696;"Nakskov";"no";0;0;0;54,833333;11,15
1697;"Nakskov";"no";0;0;0;54,833333;11,15
1698;"Nakskov";"no";0;0;0;54,833333;11,15
1699;"Nakskov";"no";0;0;0;54,833333;11,15
1700;"Nakskov";"no";0;0;0;54,833333;11,15
1701;"Nakskov";"no";0;1;1;54,833333;11,15
1702;"Nakskov";"no";2;1;3;54,833333;11,15
1703;"Nakskov";"no";0;0;0;54,833333;11,15
1704;"Nakskov";"no";1;0;1;54,833333;11,15
1705;"Nakskov";"no";0;0;0;54,833333;11,15
1706;"Nakskov";"no";0;0;0;54,833333;11,15
1707;"Nakskov";"no";0;0;0;54,833333;11,15
1708;"Nakskov";"no";0;0;0;54,833333;11,15
1709;"Nakskov";"no";0;1;1;54,833333;11,15
1710;"Nakskov";"no";0;0;0;54,833333;11,15
1711;"Nakskov";"no";0;0;0;54,833333;11,15
1712;"Nakskov";"no";1;0;1;54,833333;11,15
1713;"Nakskov";"no";1;0;1;54,833333;11,15
1714;"Nakskov";"no";0;1;1;54,833333;11,15
1715;"Nakskov";"no";0;0;0;54,833333;11,15
1716;"Nakskov";"no";0;0;0;54,833333;11,15
1717;"Nakskov";"no";0;0;0;54,833333;11,15
1718;"Nakskov";"no";0;0;0;54,833333;11,15
1719;"Nakskov";"no";0;0;0;54,833333;11,15
1720;"Nakskov";"no";0;1;1;54,833333;11,15
1721;"Nakskov";"no";0;1;1;54,833333;11,15
1722;"Nakskov";"no";0;0;0;54,833333;11,15
1723;"Nakskov";"no";0;0;0;54,833333;11,15
1724;"Nakskov";"no";1;0;1;54,833333;11,15
1725;"Nakskov";"no";0;0;0;54,833333;11,15
1726;"Nakskov";"no";0;0;0;54,833333;11,15
1727;"Nakskov";"no";0;0;0;54,833333;11,15
1728;"Nakskov";"no";0;0;0;54,833333;11,15
1729;"Nakskov";"no";1;0;1;54,833333;11,15
1730;"Nakskov";"no";0;0;0;54,833333;11,15
1731;"Nakskov";"no";0;1;1;54,833333;11,15
1732;"Nakskov";"no";1;2;3;54,833333;11,15
1733;"Nakskov";"no";0;0;0;54,833333;11,15
1734;"Nakskov";"no";0;0;0;54,833333;11,15
1735;"Nakskov";"no";0;0;0;54,833333;11,15
1736;"Nakskov";"no";0;1;1;54,833333;11,15
1737;"Nakskov";"no";0;1;1;54,833333;11,15
1738;"Nakskov";"no";0;0;0;54,833333;11,15
1739;"Nakskov";"no";0;0;0;54,833333;11,15
1740;"Nakskov";"no";0;0;0;54,833333;11,15
1741;"Nakskov";"no";0;0;0;54,833333;11,15
1742;"Nakskov";"no";1;0;1;54,833333;11,15
1743;"Nakskov";"no";0;0;0;54,833333;11,15
1744;"Nakskov";"no";0;1;1;54,833333;11,15
1745;"Nakskov";"no";0;1;1;54,833333;11,15
1746;"Nakskov";"no";0;1;1;54,833333;11,15
1747;"Nakskov";"no";0;1;1;54,833333;11,15
1748;"Nakskov";"no";0;2;2;54,833333;11,15
1749;"Nakskov";"no";0;0;0;54,833333;11,15
1750;"Nakskov";"no";0;1;1;54,833333;11,15
1751;"Nakskov";"no";0;1;1;54,833333;11,15
1752;"Nakskov";"no";1;0;1;54,833333;11,15
1753;"Nakskov";"no";0;0;0;54,833333;11,15
1754;"Nakskov";"no";0;0;0;54,833333;11,15
1755;"Nakskov";"no";0;1;1;54,833333;11,15
1756;"Nakskov";"no";1;0;1;54,833333;11,15
1757;"Nakskov";"no";0;0;0;54,833333;11,15
1758;"Nakskov";"no";0;1;1;54,833333;11,15
1759;"Nakskov";"no";0;0;0;54,833333;11,15
1760;"Nakskov";"no";0;0;0;54,833333;11,15
1761;"Nakskov";"no";0;0;0;54,833333;11,15
1762;"Nakskov";"no";1;0;1;54,833333;11,15
1763;"Nakskov";"no";0;0;0;54,833333;11,15
1764;"Nakskov";"no";0;1;1;54,833333;11,15
1765;"Nakskov";"no";0;0;0;54,833333;11,15
1766;"Nakskov";"no";0;1;1;54,833333;11,15
1767;"Nakskov";"no";0;0;0;54,833333;11,15
1768;"Nakskov";"no";0;1;1;54,833333;11,15
1769;"Nakskov";"no";0;0;0;54,833333;11,15
1770;"Nakskov";"no";1;0;1;54,833333;11,15
1771;"Nakskov";"no";0;1;1;54,833333;11,15
1772;"Nakskov";"no";0;0;0;54,833333;11,15
1773;"Nakskov";"no";0;0;0;54,833333;11,15
1774;"Nakskov";"no";0;0;0;54,833333;11,15
1775;"Nakskov";"no";0;0;0;54,833333;11,15
1776;"Nakskov";"no";0;0;0;54,833333;11,15
1777;"Nakskov";"no";0;0;0;54,833333;11,15
1778;"Nakskov";"no";0;1;1;54,833333;11,15
1779;"Nakskov";"no";0;0;0;54,833333;11,15
1780;"Nakskov";"no";0;0;0;54,833333;11,15
1781;"Nakskov";"no";0;0;0;54,833333;11,15
1782;"Nakskov";"no";0;0;0;54,833333;11,15
1783;"Nakskov";"no";0;0;0;54,833333;11,15
1784;"Nakskov";"no";0;0;0;54,833333;11,15
1785;"Nakskov";"no";0;0;0;54,833333;11,15
1786;"Nakskov";"no";0;0;0;54,833333;11,15
1787;"Nakskov";"no";0;1;1;54,833333;11,15
1788;"Nakskov";"no";1;0;1;54,833333;11,15
1789;"Nakskov";"no";0;0;0;54,833333;11,15
1790;"Nakskov";"no";1;2;3;54,833333;11,15
1791;"Nakskov";"no";0;2;2;54,833333;11,15
1792;"Nakskov";"no";0;0;0;54,833333;11,15
1793;"Nakskov";"no";0;0;0;54,833333;11,15
1794;"Nakskov";"no";0;0;0;54,833333;11,15
1795;"Nakskov";"no";0;0;0;54,833333;11,15
1796;"Nakskov";"no";1;0;1;54,833333;11,15
1797;"Nakskov";"no";0;0;0;54,833333;11,15
1798;"Nakskov";"no";1;0;1;54,833333;11,15
1799;"Nakskov";"no";0;0;0;54,833333;11,15
1800;"Nakskov";"no";0;1;1;54,833333;11,15
1801;"Nakskov";"no";8;1;9;54,833333;11,15
1802;"Nakskov";"no";0;0;0;54,833333;11,15
1803;"Nakskov";"no";0;2;2;54,833333;11,15
1804;"Nakskov";"no";0;0;0;54,833333;11,15
1805;"Nakskov";"no";0;0;0;54,833333;11,15
1806;"Nakskov";"no";0;1;1;54,833333;11,15
1807;"Nakskov";"no";0;0;0;54,833333;11,15
1808;"Nakskov";"no";0;0;0;54,833333;11,15
1809;"Nakskov";"no";0;0;0;54,833333;11,15
1810;"Nakskov";"no";0;0;0;54,833333;11,15
1811;"Nakskov";"no";0;0;0;54,833333;11,15
1812;"Nakskov";"no";0;0;0;54,833333;11,15
1813;"Nakskov";"no";0;0;0;54,833333;11,15
1814;"Nakskov";"no";0;0;0;54,833333;11,15
1815;"Nakskov";"no";1;1;2;54,833333;11,15
1816;"Nakskov";"no";1;0;1;54,833333;11,15
1817;"Nakskov";"no";0;0;0;54,833333;11,15
1818;"Nakskov";"no";2;4;6;54,833333;11,15
1819;"Nakskov";"no";0;0;0;54,833333;11,15
1820;"Nakskov";"no";0;3;3;54,833333;11,15
1821;"Nakskov";"no";0;0;0;54,833333;11,15
1822;"Nakskov";"no";1;0;1;54,833333;11,15
1823;"Nakskov";"no";1;0;1;54,833333;11,15
1824;"Nakskov";"no";1;1;2;54,833333;11,15
1825;"Nakskov";"no";3;0;3;54,833333;11,15
1826;"Nakskov";"no";3;1;4;54,833333;11,15
1827;"Nakskov";"no";1;0;1;54,833333;11,15
1828;"Nakskov";"no";1;2;3;54,833333;11,15
1829;"Nakskov";"no";2;1;3;54,833333;11,15
1830;"Nakskov";"no";2;0;2;54,833333;11,15
1831;"Nakskov";"no";1;0;1;54,833333;11,15
1832;"Nakskov";"no";2;0;2;54,833333;11,15
1833;"Nakskov";"no";2;1;3;54,833333;11,15
1834;"Nakskov";"no";3;1;4;54,833333;11,15
1835;"Nakskov";"no";3;1;4;54,833333;11,15
1836;"Nakskov";"no";0;1;1;54,833333;11,15
1837;"Nakskov";"no";1;0;1;54,833333;11,15
1838;"Nakskov";"no";2;2;4;54,833333;11,15
1839;"Nakskov";"no";3;1;4;54,833333;11,15
1840;"Nakskov";"no";2;1;3;54,833333;11,15
1841;"Nakskov";"no";1;0;1;54,833333;11,15
1842;"Nakskov";"no";0;0;0;54,833333;11,15
1843;"Nakskov";"no";0;0;0;54,833333;11,15
1844;"Nakskov";"no";2;0;2;54,833333;11,15
1845;"Nakskov";"no";0;0;0;54,833333;11,15
1846;"Nakskov";"no";1;0;1;54,833333;11,15
1847;"Nakskov";"no";2;1;3;54,833333;11,15
1848;"Nakskov";"no";1;3;4;54,833333;11,15
1849;"Nakskov";"no";0;3;3;54,833333;11,15
1850;"Nakskov";"no";1;0;1;54,833333;11,15
1851;"Nakskov";"no";0;0;0;54,833333;11,15
1852;"Nakskov";"no";1;0;1;54,833333;11,15
1853;"Nakskov";"no";0;3;3;54,833333;11,15
1854;"Nakskov";"no";0;2;2;54,833333;11,15
1855;"Nakskov";"no";2;1;3;54,833333;11,15
1856;"Nakskov";"no";1;0;1;54,833333;11,15
1857;"Nakskov";"no";0;0;0;54,833333;11,15
1634;"Nysted";"no";0;0;0;54,6641761;11,7283373
1635;"Nysted";"no";2;0;2;54,6641761;11,7283373
1636;"Nysted";"no";1;0;1;54,6641761;11,7283373
1637;"Nysted";"no";3;0;3;54,6641761;11,7283373
1638;"Nysted";"no";6;2;8;54,6641761;11,7283373
1639;"Nysted";"no";4;0;4;54,6641761;11,7283373
1640;"Nysted";"no";3;0;3;54,6641761;11,7283373
1641;"Nysted";"no";4;0;4;54,6641761;11,7283373
1642;"Nysted";"no";1;0;1;54,6641761;11,7283373
1643;"Nysted";"no";3;0;3;54,6641761;11,7283373
1644;"Nysted";"no";2;0;2;54,6641761;11,7283373
1645;"Nysted";"no";0;0;0;54,6641761;11,7283373
1646;"Nysted";"no";3;0;3;54,6641761;11,7283373
1647;"Nysted";"no";2;0;2;54,6641761;11,7283373
1648;"Nysted";"no";1;0;1;54,6641761;11,7283373
1649;"Nysted";"no";3;0;3;54,6641761;11,7283373
1650;"Nysted";"no";4;0;4;54,6641761;11,7283373
1651;"Nysted";"no";1;1;2;54,6641761;11,7283373
1652;"Nysted";"no";1;0;1;54,6641761;11,7283373
1653;"Nysted";"no";1;1;2;54,6641761;11,7283373
1654;"Nysted";"no";4;0;4;54,6641761;11,7283373
1655;"Nysted";"no";5;0;5;54,6641761;11,7283373
1656;"Nysted";"no";2;0;2;54,6641761;11,7283373
1657;"Nysted";"no";2;0;2;54,6641761;11,7283373
1658;"Nysted";"no";0;0;0;54,6641761;11,7283373
1659;"Nysted";"no";0;0;0;54,6641761;11,7283373
1660;"Nysted";"no";1;0;1;54,6641761;11,7283373
1661;"Nysted";"no";0;0;0;54,6641761;11,7283373
1662;"Nysted";"no";0;0;0;54,6641761;11,7283373
1663;"Nysted";"no";0;0;0;54,6641761;11,7283373
1664;"Nysted";"no";0;0;0;54,6641761;11,7283373
1665;"Nysted";"no";1;0;1;54,6641761;11,7283373
1666;"Nysted";"no";1;2;3;54,6641761;11,7283373
1667;"Nysted";"no";1;0;1;54,6641761;11,7283373
1668;"Nysted";"no";4;4;8;54,6641761;11,7283373
1669;"Nysted";"no";4;0;4;54,6641761;11,7283373
1670;"Nysted";"no";4;0;4;54,6641761;11,7283373
1671;"Nysted";"no";2;0;2;54,6641761;11,7283373
1672;"Nysted";"no";1;0;1;54,6641761;11,7283373
1673;"Nysted";"no";5;0;5;54,6641761;11,7283373
1674;"Nysted";"no";2;0;2;54,6641761;11,7283373
1675;"Nysted";"no";2;0;2;54,6641761;11,7283373
1676;"Nysted";"no";0;0;0;54,6641761;11,7283373
1677;"Nysted";"no";1;0;1;54,6641761;11,7283373
1678;"Nysted";"no";0;0;0;54,6641761;11,7283373
1679;"Nysted";"no";1;0;1;54,6641761;11,7283373
1680;"Nysted";"no";3;0;3;54,6641761;11,7283373
1681;"Nysted";"no";2;0;2;54,6641761;11,7283373
1682;"Nysted";"no";0;1;1;54,6641761;11,7283373
1683;"Nysted";"no";2;2;4;54,6641761;11,7283373
1684;"Nysted";"no";0;0;0;54,6641761;11,7283373
1685;"Nysted";"no";0;0;0;54,6641761;11,7283373
1686;"Nysted";"no";2;0;2;54,6641761;11,7283373
1687;"Nysted";"no";3;1;4;54,6641761;11,7283373
1688;"Nysted";"no";2;0;2;54,6641761;11,7283373
1689;"Nysted";"no";0;0;0;54,6641761;11,7283373
1690;"Nysted";"no";2;0;2;54,6641761;11,7283373
1691;"Nysted";"no";1;1;2;54,6641761;11,7283373
1692;"Nysted";"no";1;0;1;54,6641761;11,7283373
1693;"Nysted";"no";1;0;1;54,6641761;11,7283373
1694;"Nysted";"no";0;1;1;54,6641761;11,7283373
1695;"Nysted";"no";0;0;0;54,6641761;11,7283373
1696;"Nysted";"no";1;0;1;54,6641761;11,7283373
1697;"Nysted";"no";0;0;0;54,6641761;11,7283373
1698;"Nysted";"no";0;0;0;54,6641761;11,7283373
1699;"Nysted";"no";0;0;0;54,6641761;11,7283373
1700;"Nysted";"no";1;0;1;54,6641761;11,7283373
1701;"Nysted";"no";3;0;3;54,6641761;11,7283373
1702;"Nysted";"no";1;0;1;54,6641761;11,7283373
1703;"Nysted";"no";1;0;1;54,6641761;11,7283373
1704;"Nysted";"no";1;0;1;54,6641761;11,7283373
1705;"Nysted";"no";2;0;2;54,6641761;11,7283373
1706;"Nysted";"no";1;0;1;54,6641761;11,7283373
1707;"Nysted";"no";2;1;3;54,6641761;11,7283373
1708;"Nysted";"no";1;0;1;54,6641761;11,7283373
1709;"Nysted";"no";2;0;2;54,6641761;11,7283373
1710;"Nysted";"no";0;0;0;54,6641761;11,7283373
1711;"Nysted";"no";0;0;0;54,6641761;11,7283373
1712;"Nysted";"no";1;0;1;54,6641761;11,7283373
1713;"Nysted";"no";1;0;1;54,6641761;11,7283373
1714;"Nysted";"no";2;0;2;54,6641761;11,7283373
1715;"Nysted";"no";0;0;0;54,6641761;11,7283373
1716;"Nysted";"no";0;0;0;54,6641761;11,7283373
1717;"Nysted";"no";0;0;0;54,6641761;11,7283373
1718;"Nysted";"no";0;0;0;54,6641761;11,7283373
1719;"Nysted";"no";0;0;0;54,6641761;11,7283373
1720;"Nysted";"no";2;0;2;54,6641761;11,7283373
1721;"Nysted";"no";0;0;0;54,6641761;11,7283373
1722;"Nysted";"no";2;2;4;54,6641761;11,7283373
1723;"Nysted";"no";0;0;0;54,6641761;11,7283373
1724;"Nysted";"no";0;0;0;54,6641761;11,7283373
1725;"Nysted";"no";0;0;0;54,6641761;11,7283373
1726;"Nysted";"no";1;0;1;54,6641761;11,7283373
1727;"Nysted";"no";2;0;2;54,6641761;11,7283373
1728;"Nysted";"no";0;0;0;54,6641761;11,7283373
1729;"Nysted";"no";0;0;0;54,6641761;11,7283373
1730;"Nysted";"no";2;0;2;54,6641761;11,7283373
1731;"Nysted";"no";0;0;0;54,6641761;11,7283373
1732;"Nysted";"no";1;0;1;54,6641761;11,7283373
1733;"Nysted";"no";0;0;0;54,6641761;11,7283373
1734;"Nysted";"no";0;0;0;54,6641761;11,7283373
1735;"Nysted";"no";2;0;2;54,6641761;11,7283373
1736;"Nysted";"no";0;1;1;54,6641761;11,7283373
1737;"Nysted";"no";0;0;0;54,6641761;11,7283373
1738;"Nysted";"no";0;0;0;54,6641761;11,7283373
1739;"Nysted";"no";0;0;0;54,6641761;11,7283373
1740;"Nysted";"no";0;0;0;54,6641761;11,7283373
1741;"Nysted";"no";0;0;0;54,6641761;11,7283373
1742;"Nysted";"no";1;0;1;54,6641761;11,7283373
1743;"Nysted";"no";0;0;0;54,6641761;11,7283373
1744;"Nysted";"no";0;0;0;54,6641761;11,7283373
1745;"Nysted";"no";0;0;0;54,6641761;11,7283373
1746;"Nysted";"no";0;0;0;54,6641761;11,7283373
1747;"Nysted";"no";0;0;0;54,6641761;11,7283373
1748;"Nysted";"no";0;0;0;54,6641761;11,7283373
1749;"Nysted";"no";0;0;0;54,6641761;11,7283373
1750;"Nysted";"no";2;0;2;54,6641761;11,7283373
1751;"Nysted";"no";1;0;1;54,6641761;11,7283373
1752;"Nysted";"no";0;0;0;54,6641761;11,7283373
1753;"Nysted";"no";0;0;0;54,6641761;11,7283373
1754;"Nysted";"no";1;2;3;54,6641761;11,7283373
1755;"Nysted";"no";3;0;3;54,6641761;11,7283373
1756;"Nysted";"no";0;0;0;54,6641761;11,7283373
1757;"Nysted";"no";1;1;2;54,6641761;11,7283373
1758;"Nysted";"no";1;0;1;54,6641761;11,7283373
1759;"Nysted";"no";0;0;0;54,6641761;11,7283373
1760;"Nysted";"no";0;0;0;54,6641761;11,7283373
1761;"Nysted";"no";0;0;0;54,6641761;11,7283373
1762;"Nysted";"no";0;0;0;54,6641761;11,7283373
1763;"Nysted";"no";0;1;1;54,6641761;11,7283373
1764;"Nysted";"no";1;1;2;54,6641761;11,7283373
1765;"Nysted";"no";0;0;0;54,6641761;11,7283373
1766;"Nysted";"no";0;0;0;54,6641761;11,7283373
1767;"Nysted";"no";0;1;1;54,6641761;11,7283373
1768;"Nysted";"no";0;0;0;54,6641761;11,7283373
1769;"Nysted";"no";0;0;0;54,6641761;11,7283373
1770;"Nysted";"no";0;0;0;54,6641761;11,7283373
1771;"Nysted";"no";1;0;1;54,6641761;11,7283373
1772;"Nysted";"no";0;0;0;54,6641761;11,7283373
1773;"Nysted";"no";1;0;1;54,6641761;11,7283373
1774;"Nysted";"no";0;0;0;54,6641761;11,7283373
1775;"Nysted";"no";0;0;0;54,6641761;11,7283373
1776;"Nysted";"no";2;1;3;54,6641761;11,7283373
1777;"Nysted";"no";4;1;5;54,6641761;11,7283373
1778;"Nysted";"no";1;1;2;54,6641761;11,7283373
1779;"Nysted";"no";1;1;2;54,6641761;11,7283373
1780;"Nysted";"no";2;1;3;54,6641761;11,7283373
1781;"Nysted";"no";0;2;2;54,6641761;11,7283373
1782;"Nysted";"no";1;0;1;54,6641761;11,7283373
1783;"Nysted";"no";0;1;1;54,6641761;11,7283373
1784;"Nysted";"no";1;1;2;54,6641761;11,7283373
1785;"Nysted";"no";1;0;1;54,6641761;11,7283373
1786;"Nysted";"no";0;0;0;54,6641761;11,7283373
1787;"Nysted";"no";1;0;1;54,6641761;11,7283373
1788;"Nysted";"no";3;2;5;54,6641761;11,7283373
1789;"Nysted";"no";2;0;2;54,6641761;11,7283373
1790;"Nysted";"no";2;1;3;54,6641761;11,7283373
1791;"Nysted";"no";2;0;2;54,6641761;11,7283373
1792;"Nysted";"no";0;0;0;54,6641761;11,7283373
1793;"Nysted";"no";0;0;0;54,6641761;11,7283373
1794;"Nysted";"no";1;1;2;54,6641761;11,7283373
1795;"Nysted";"no";4;0;4;54,6641761;11,7283373
1796;"Nysted";"no";1;0;1;54,6641761;11,7283373
1797;"Nysted";"no";0;1;1;54,6641761;11,7283373
1798;"Nysted";"no";1;0;1;54,6641761;11,7283373
1799;"Nysted";"no";2;3;5;54,6641761;11,7283373
1800;"Nysted";"no";0;1;1;54,6641761;11,7283373
1801;"Nysted";"no";2;2;4;54,6641761;11,7283373
1802;"Nysted";"no";1;2;3;54,6641761;11,7283373
1803;"Nysted";"no";0;0;0;54,6641761;11,7283373
1804;"Nysted";"no";0;1;1;54,6641761;11,7283373
1805;"Nysted";"no";0;0;0;54,6641761;11,7283373
1806;"Nysted";"no";0;1;1;54,6641761;11,7283373
1807;"Nysted";"no";0;0;0;54,6641761;11,7283373
1808;"Nysted";"no";0;0;0;54,6641761;11,7283373
1809;"Nysted";"no";0;0;0;54,6641761;11,7283373
1810;"Nysted";"no";0;2;2;54,6641761;11,7283373
1811;"Nysted";"no";0;0;0;54,6641761;11,7283373
1812;"Nysted";"no";0;0;0;54,6641761;11,7283373
1813;"Nysted";"no";0;0;0;54,6641761;11,7283373
1814;"Nysted";"no";1;0;1;54,6641761;11,7283373
1815;"Nysted";"no";0;1;1;54,6641761;11,7283373
1816;"Nysted";"no";1;1;2;54,6641761;11,7283373
1817;"Nysted";"no";0;0;0;54,6641761;11,7283373
1818;"Nysted";"no";0;0;0;54,6641761;11,7283373
1819;"Nysted";"no";4;2;6;54,6641761;11,7283373
1820;"Nysted";"no";1;2;3;54,6641761;11,7283373
1821;"Nysted";"no";2;1;3;54,6641761;11,7283373
1822;"Nysted";"no";1;1;2;54,6641761;11,7283373
1823;"Nysted";"no";2;1;3;54,6641761;11,7283373
1824;"Nysted";"no";7;1;8;54,6641761;11,7283373
1825;"Nysted";"no";8;2;10;54,6641761;11,7283373
1826;"Nysted";"no";9;3;12;54,6641761;11,7283373
1827;"Nysted";"no";2;0;2;54,6641761;11,7283373
1828;"Nysted";"no";3;1;4;54,6641761;11,7283373
1829;"Nysted";"no";2;0;2;54,6641761;11,7283373
1830;"Nysted";"no";1;0;1;54,6641761;11,7283373
1831;"Nysted";"no";3;3;6;54,6641761;11,7283373
1832;"Nysted";"no";7;2;9;54,6641761;11,7283373
1833;"Nysted";"no";4;0;4;54,6641761;11,7283373
1834;"Nysted";"no";6;0;6;54,6641761;11,7283373
1835;"Nysted";"no";3;1;4;54,6641761;11,7283373
1836;"Nysted";"no";4;1;5;54,6641761;11,7283373
1837;"Nysted";"no";3;0;3;54,6641761;11,7283373
1838;"Nysted";"no";6;4;10;54,6641761;11,7283373
1839;"Nysted";"no";2;1;3;54,6641761;11,7283373
1840;"Nysted";"no";7;2;9;54,6641761;11,7283373
1841;"Nysted";"no";6;0;6;54,6641761;11,7283373
1842;"Nysted";"no";1;2;3;54,6641761;11,7283373
1843;"Nysted";"no";8;1;9;54,6641761;11,7283373
1844;"Nysted";"no";6;3;9;54,6641761;11,7283373
1845;"Nysted";"no";10;1;11;54,6641761;11,7283373
1846;"Nysted";"no";14;1;15;54,6641761;11,7283373
1847;"Nysted";"no";3;4;7;54,6641761;11,7283373
1848;"Nysted";"no";12;0;12;54,6641761;11,7283373
1849;"Nysted";"no";17;3;20;54,6641761;11,7283373
1850;"Nysted";"no";7;0;7;54,6641761;11,7283373
1851;"Nysted";"no";6;3;9;54,6641761;11,7283373
1852;"Nysted";"no";9;5;14;54,6641761;11,7283373
1853;"Nysted";"no";7;4;11;54,6641761;11,7283373
1854;"Nysted";"no";9;3;12;54,6641761;11,7283373
1855;"Nysted";"no";12;3;15;54,6641761;11,7283373
1856;"Nysted";"no";6;5;11;54,6641761;11,7283373
1857;"Nysted";"no";2;1;3;54,6641761;11,7283373
1634;"Næstved";"no";0;0;0;55,229722;11,760833
1635;"Næstved";"no";1;0;1;55,229722;11,760833
1636;"Næstved";"no";0;0;0;55,229722;11,760833
1637;"Næstved";"no";1;0;1;55,229722;11,760833
1638;"Næstved";"no";1;0;1;55,229722;11,760833
1639;"Næstved";"no";1;0;1;55,229722;11,760833
1640;"Næstved";"no";1;0;1;55,229722;11,760833
1641;"Næstved";"no";0;0;0;55,229722;11,760833
1642;"Næstved";"no";0;0;0;55,229722;11,760833
1643;"Næstved";"no";0;1;1;55,229722;11,760833
1644;"Næstved";"no";0;0;0;55,229722;11,760833
1645;"Næstved";"no";0;0;0;55,229722;11,760833
1646;"Næstved";"no";0;0;0;55,229722;11,760833
1647;"Næstved";"no";0;0;0;55,229722;11,760833
1648;"Næstved";"no";3;0;3;55,229722;11,760833
1649;"Næstved";"no";0;0;0;55,229722;11,760833
1650;"Næstved";"no";0;0;0;55,229722;11,760833
1651;"Næstved";"no";0;0;0;55,229722;11,760833
1652;"Næstved";"no";0;0;0;55,229722;11,760833
1653;"Næstved";"no";1;0;1;55,229722;11,760833
1654;"Næstved";"no";0;1;1;55,229722;11,760833
1655;"Næstved";"no";0;0;0;55,229722;11,760833
1656;"Næstved";"no";0;0;0;55,229722;11,760833
1657;"Næstved";"no";0;0;0;55,229722;11,760833
1658;"Næstved";"no";0;0;0;55,229722;11,760833
1659;"Næstved";"no";0;0;0;55,229722;11,760833
1660;"Næstved";"no";0;0;0;55,229722;11,760833
1661;"Næstved";"no";0;0;0;55,229722;11,760833
1662;"Næstved";"no";0;0;0;55,229722;11,760833
1663;"Næstved";"no";0;0;0;55,229722;11,760833
1664;"Næstved";"no";1;0;1;55,229722;11,760833
1665;"Næstved";"no";0;1;1;55,229722;11,760833
1666;"Næstved";"no";2;0;2;55,229722;11,760833
1667;"Næstved";"no";2;0;2;55,229722;11,760833
1668;"Næstved";"no";1;1;2;55,229722;11,760833
1669;"Næstved";"no";0;1;1;55,229722;11,760833
1670;"Næstved";"no";0;1;1;55,229722;11,760833
1671;"Næstved";"no";0;1;1;55,229722;11,760833
1672;"Næstved";"no";1;0;1;55,229722;11,760833
1673;"Næstved";"no";0;0;0;55,229722;11,760833
1674;"Næstved";"no";3;0;3;55,229722;11,760833
1675;"Næstved";"no";0;0;0;55,229722;11,760833
1676;"Næstved";"no";1;0;1;55,229722;11,760833
1677;"Næstved";"no";2;0;2;55,229722;11,760833
1678;"Næstved";"no";2;1;3;55,229722;11,760833
1679;"Næstved";"no";1;0;1;55,229722;11,760833
1680;"Næstved";"no";2;0;2;55,229722;11,760833
1681;"Næstved";"no";0;1;1;55,229722;11,760833
1682;"Næstved";"no";0;0;0;55,229722;11,760833
1683;"Næstved";"no";0;0;0;55,229722;11,760833
1684;"Næstved";"no";0;0;0;55,229722;11,760833
1685;"Næstved";"no";1;0;1;55,229722;11,760833
1686;"Næstved";"no";0;0;0;55,229722;11,760833
1687;"Næstved";"no";0;0;0;55,229722;11,760833
1688;"Næstved";"no";0;1;1;55,229722;11,760833
1689;"Næstved";"no";0;0;0;55,229722;11,760833
1690;"Næstved";"no";0;1;1;55,229722;11,760833
1691;"Næstved";"no";0;0;0;55,229722;11,760833
1692;"Næstved";"no";0;0;0;55,229722;11,760833
1693;"Næstved";"no";0;0;0;55,229722;11,760833
1694;"Næstved";"no";0;1;1;55,229722;11,760833
1695;"Næstved";"no";0;1;1;55,229722;11,760833
1696;"Næstved";"no";0;2;2;55,229722;11,760833
1697;"Næstved";"no";1;4;5;55,229722;11,760833
1698;"Næstved";"no";0;2;2;55,229722;11,760833
1699;"Næstved";"no";1;0;1;55,229722;11,760833
1700;"Næstved";"no";0;0;0;55,229722;11,760833
1701;"Næstved";"no";0;0;0;55,229722;11,760833
1702;"Næstved";"no";0;0;0;55,229722;11,760833
1703;"Næstved";"no";0;1;1;55,229722;11,760833
1704;"Næstved";"no";0;0;0;55,229722;11,760833
1705;"Næstved";"no";0;0;0;55,229722;11,760833
1706;"Næstved";"no";0;0;0;55,229722;11,760833
1707;"Næstved";"no";0;0;0;55,229722;11,760833
1708;"Næstved";"no";0;0;0;55,229722;11,760833
1709;"Næstved";"no";0;0;0;55,229722;11,760833
1710;"Næstved";"no";0;0;0;55,229722;11,760833
1711;"Næstved";"no";0;2;2;55,229722;11,760833
1712;"Næstved";"no";0;0;0;55,229722;11,760833
1713;"Næstved";"no";0;0;0;55,229722;11,760833
1714;"Næstved";"no";0;0;0;55,229722;11,760833
1715;"Næstved";"no";0;0;0;55,229722;11,760833
1716;"Næstved";"no";0;0;0;55,229722;11,760833
1717;"Næstved";"no";0;0;0;55,229722;11,760833
1718;"Næstved";"no";0;0;0;55,229722;11,760833
1719;"Næstved";"no";0;0;0;55,229722;11,760833
1720;"Næstved";"no";0;2;2;55,229722;11,760833
1721;"Næstved";"no";0;0;0;55,229722;11,760833
1722;"Næstved";"no";0;0;0;55,229722;11,760833
1723;"Næstved";"no";0;0;0;55,229722;11,760833
1724;"Næstved";"no";0;0;0;55,229722;11,760833
1725;"Næstved";"no";0;0;0;55,229722;11,760833
1726;"Næstved";"no";0;0;0;55,229722;11,760833
1727;"Næstved";"no";0;1;1;55,229722;11,760833
1728;"Næstved";"no";0;0;0;55,229722;11,760833
1729;"Næstved";"no";0;0;0;55,229722;11,760833
1730;"Næstved";"no";0;0;0;55,229722;11,760833
1731;"Næstved";"no";0;0;0;55,229722;11,760833
1732;"Næstved";"no";0;0;0;55,229722;11,760833
1733;"Næstved";"no";0;0;0;55,229722;11,760833
1734;"Næstved";"no";0;0;0;55,229722;11,760833
1735;"Næstved";"no";0;0;0;55,229722;11,760833
1736;"Næstved";"no";0;1;1;55,229722;11,760833
1737;"Næstved";"no";0;1;1;55,229722;11,760833
1738;"Næstved";"no";0;0;0;55,229722;11,760833
1739;"Næstved";"no";0;0;0;55,229722;11,760833
1740;"Næstved";"no";0;0;0;55,229722;11,760833
1741;"Næstved";"no";0;0;0;55,229722;11,760833
1742;"Næstved";"no";0;0;0;55,229722;11,760833
1743;"Næstved";"no";0;0;0;55,229722;11,760833
1744;"Næstved";"no";0;0;0;55,229722;11,760833
1745;"Næstved";"no";0;0;0;55,229722;11,760833
1746;"Næstved";"no";0;0;0;55,229722;11,760833
1747;"Næstved";"no";0;0;0;55,229722;11,760833
1748;"Næstved";"no";0;0;0;55,229722;11,760833
1749;"Næstved";"no";0;0;0;55,229722;11,760833
1750;"Næstved";"no";0;0;0;55,229722;11,760833
1751;"Næstved";"no";0;0;0;55,229722;11,760833
1752;"Næstved";"no";0;0;0;55,229722;11,760833
1753;"Næstved";"no";0;1;1;55,229722;11,760833
1754;"Næstved";"no";0;0;0;55,229722;11,760833
1755;"Næstved";"no";0;0;0;55,229722;11,760833
1756;"Næstved";"no";0;0;0;55,229722;11,760833
1757;"Næstved";"no";0;0;0;55,229722;11,760833
1758;"Næstved";"no";0;0;0;55,229722;11,760833
1759;"Næstved";"no";0;0;0;55,229722;11,760833
1760;"Næstved";"no";0;0;0;55,229722;11,760833
1761;"Næstved";"no";0;1;1;55,229722;11,760833
1762;"Næstved";"no";0;0;0;55,229722;11,760833
1763;"Næstved";"no";0;0;0;55,229722;11,760833
1764;"Næstved";"no";0;0;0;55,229722;11,760833
1765;"Næstved";"no";0;1;1;55,229722;11,760833
1766;"Næstved";"no";0;1;1;55,229722;11,760833
1767;"Næstved";"no";0;0;0;55,229722;11,760833
1768;"Næstved";"no";1;1;2;55,229722;11,760833
1769;"Næstved";"no";0;0;0;55,229722;11,760833
1770;"Næstved";"no";0;0;0;55,229722;11,760833
1771;"Næstved";"no";0;1;1;55,229722;11,760833
1772;"Næstved";"no";1;0;1;55,229722;11,760833
1773;"Næstved";"no";0;1;1;55,229722;11,760833
1774;"Næstved";"no";0;0;0;55,229722;11,760833
1775;"Næstved";"no";0;0;0;55,229722;11,760833
1776;"Næstved";"no";0;0;0;55,229722;11,760833
1777;"Næstved";"no";0;1;1;55,229722;11,760833
1778;"Næstved";"no";0;0;0;55,229722;11,760833
1779;"Næstved";"no";0;2;2;55,229722;11,760833
1780;"Næstved";"no";0;0;0;55,229722;11,760833
1781;"Næstved";"no";0;0;0;55,229722;11,760833
1782;"Næstved";"no";0;0;0;55,229722;11,760833
1783;"Næstved";"no";0;0;0;55,229722;11,760833
1784;"Næstved";"no";0;0;0;55,229722;11,760833
1785;"Næstved";"no";0;0;0;55,229722;11,760833
1786;"Næstved";"no";0;0;0;55,229722;11,760833
1787;"Næstved";"no";0;0;0;55,229722;11,760833
1788;"Næstved";"no";0;0;0;55,229722;11,760833
1789;"Næstved";"no";0;0;0;55,229722;11,760833
1790;"Næstved";"no";0;0;0;55,229722;11,760833
1791;"Næstved";"no";0;0;0;55,229722;11,760833
1792;"Næstved";"no";0;0;0;55,229722;11,760833
1793;"Næstved";"no";3;4;7;55,229722;11,760833
1794;"Næstved";"no";0;1;1;55,229722;11,760833
1795;"Næstved";"no";3;0;3;55,229722;11,760833
1796;"Næstved";"no";0;1;1;55,229722;11,760833
1797;"Næstved";"no";0;0;0;55,229722;11,760833
1798;"Næstved";"no";0;2;2;55,229722;11,760833
1799;"Næstved";"no";2;0;2;55,229722;11,760833
1800;"Næstved";"no";0;0;0;55,229722;11,760833
1801;"Næstved";"no";3;0;3;55,229722;11,760833
1802;"Næstved";"no";1;0;1;55,229722;11,760833
1803;"Næstved";"no";2;0;2;55,229722;11,760833
1804;"Næstved";"no";2;0;2;55,229722;11,760833
1805;"Næstved";"no";0;1;1;55,229722;11,760833
1806;"Næstved";"no";0;1;1;55,229722;11,760833
1807;"Næstved";"no";0;0;0;55,229722;11,760833
1808;"Næstved";"no";0;0;0;55,229722;11,760833
1809;"Næstved";"no";0;0;0;55,229722;11,760833
1810;"Næstved";"no";0;0;0;55,229722;11,760833
1811;"Næstved";"no";0;0;0;55,229722;11,760833
1812;"Næstved";"no";0;0;0;55,229722;11,760833
1813;"Næstved";"no";0;0;0;55,229722;11,760833
1814;"Næstved";"no";1;0;1;55,229722;11,760833
1815;"Næstved";"no";1;0;1;55,229722;11,760833
1816;"Næstved";"no";0;1;1;55,229722;11,760833
1817;"Næstved";"no";3;4;7;55,229722;11,760833
1818;"Næstved";"no";0;0;0;55,229722;11,760833
1819;"Næstved";"no";0;1;1;55,229722;11,760833
1820;"Næstved";"no";3;3;6;55,229722;11,760833
1821;"Næstved";"no";1;3;4;55,229722;11,760833
1822;"Næstved";"no";1;1;2;55,229722;11,760833
1823;"Næstved";"no";4;3;7;55,229722;11,760833
1824;"Næstved";"no";0;0;0;55,229722;11,760833
1825;"Næstved";"no";5;1;6;55,229722;11,760833
1826;"Næstved";"no";0;1;1;55,229722;11,760833
1827;"Næstved";"no";2;5;7;55,229722;11,760833
1828;"Næstved";"no";1;1;2;55,229722;11,760833
1829;"Næstved";"no";2;3;5;55,229722;11,760833
1830;"Næstved";"no";2;4;6;55,229722;11,760833
1831;"Næstved";"no";0;2;2;55,229722;11,760833
1832;"Næstved";"no";0;1;1;55,229722;11,760833
1833;"Næstved";"no";6;6;12;55,229722;11,760833
1834;"Næstved";"no";1;4;5;55,229722;11,760833
1835;"Næstved";"no";3;2;5;55,229722;11,760833
1836;"Næstved";"no";0;1;1;55,229722;11,760833
1837;"Næstved";"no";2;0;2;55,229722;11,760833
1838;"Næstved";"no";7;3;10;55,229722;11,760833
1839;"Næstved";"no";1;1;2;55,229722;11,760833
1840;"Næstved";"no";3;2;5;55,229722;11,760833
1841;"Næstved";"no";2;1;3;55,229722;11,760833
1842;"Næstved";"no";0;0;0;55,229722;11,760833
1843;"Næstved";"no";0;0;0;55,229722;11,760833
1844;"Næstved";"no";1;0;1;55,229722;11,760833
1845;"Næstved";"no";3;0;3;55,229722;11,760833
1846;"Næstved";"no";2;3;5;55,229722;11,760833
1847;"Næstved";"no";4;3;7;55,229722;11,760833
1848;"Næstved";"no";2;5;7;55,229722;11,760833
1849;"Næstved";"no";1;3;4;55,229722;11,760833
1850;"Næstved";"no";2;4;6;55,229722;11,760833
1851;"Næstved";"no";3;2;5;55,229722;11,760833
1852;"Næstved";"no";7;2;9;55,229722;11,760833
1853;"Næstved";"no";2;1;3;55,229722;11,760833
1854;"Næstved";"no";2;2;4;55,229722;11,760833
1855;"Næstved";"no";1;1;2;55,229722;11,760833
1856;"Næstved";"no";3;2;5;55,229722;11,760833
1857;"Næstved";"no";0;0;0;55,229722;11,760833
1634;"Rønne";"no";0;0;0;55,1;14,7
1635;"Rønne";"no";1;0;1;55,1;14,7
1636;"Rønne";"no";0;0;0;55,1;14,7
1637;"Rønne";"no";0;0;0;55,1;14,7
1638;"Rønne";"no";0;0;0;55,1;14,7
1639;"Rønne";"no";0;0;0;55,1;14,7
1640;"Rønne";"no";0;0;0;55,1;14,7
1641;"Rønne";"no";1;0;1;55,1;14,7
1642;"Rønne";"no";0;0;0;55,1;14,7
1643;"Rønne";"no";0;0;0;55,1;14,7
1644;"Rønne";"no";0;0;0;55,1;14,7
1645;"Rønne";"no";0;0;0;55,1;14,7
1646;"Rønne";"no";0;0;0;55,1;14,7
1647;"Rønne";"no";0;0;0;55,1;14,7
1648;"Rønne";"no";0;0;0;55,1;14,7
1649;"Rønne";"no";0;0;0;55,1;14,7
1650;"Rønne";"no";1;0;1;55,1;14,7
1651;"Rønne";"no";0;0;0;55,1;14,7
1652;"Rønne";"no";0;0;0;55,1;14,7
1653;"Rønne";"no";0;0;0;55,1;14,7
1654;"Rønne";"no";0;0;0;55,1;14,7
1655;"Rønne";"no";0;0;0;55,1;14,7
1656;"Rønne";"no";1;0;1;55,1;14,7
1657;"Rønne";"no";0;0;0;55,1;14,7
1658;"Rønne";"no";0;0;0;55,1;14,7
1659;"Rønne";"no";0;0;0;55,1;14,7
1660;"Rønne";"no";0;0;0;55,1;14,7
1661;"Rønne";"no";1;0;1;55,1;14,7
1662;"Rønne";"no";0;0;0;55,1;14,7
1663;"Rønne";"no";0;0;0;55,1;14,7
1664;"Rønne";"no";0;0;0;55,1;14,7
1665;"Rønne";"no";0;0;0;55,1;14,7
1666;"Rønne";"no";2;0;2;55,1;14,7
1667;"Rønne";"no";2;0;2;55,1;14,7
1668;"Rønne";"no";3;1;4;55,1;14,7
1669;"Rønne";"no";0;0;0;55,1;14,7
1670;"Rønne";"no";0;2;2;55,1;14,7
1671;"Rønne";"no";0;0;0;55,1;14,7
1672;"Rønne";"no";2;1;3;55,1;14,7
1673;"Rønne";"no";0;0;0;55,1;14,7
1674;"Rønne";"no";0;0;0;55,1;14,7
1675;"Rønne";"no";0;0;0;55,1;14,7
1676;"Rønne";"no";0;0;0;55,1;14,7
1677;"Rønne";"no";0;0;0;55,1;14,7
1678;"Rønne";"no";0;0;0;55,1;14,7
1679;"Rønne";"no";0;0;0;55,1;14,7
1680;"Rønne";"no";0;0;0;55,1;14,7
1681;"Rønne";"no";0;0;0;55,1;14,7
1682;"Rønne";"no";0;0;0;55,1;14,7
1683;"Rønne";"no";0;0;0;55,1;14,7
1684;"Rønne";"no";0;0;0;55,1;14,7
1685;"Rønne";"no";0;1;1;55,1;14,7
1686;"Rønne";"no";0;0;0;55,1;14,7
1687;"Rønne";"no";0;0;0;55,1;14,7
1688;"Rønne";"no";1;0;1;55,1;14,7
1689;"Rønne";"no";1;0;1;55,1;14,7
1690;"Rønne";"no";0;0;0;55,1;14,7
1691;"Rønne";"no";0;0;0;55,1;14,7
1692;"Rønne";"no";0;0;0;55,1;14,7
1693;"Rønne";"no";0;0;0;55,1;14,7
1694;"Rønne";"no";0;0;0;55,1;14,7
1695;"Rønne";"no";0;0;0;55,1;14,7
1696;"Rønne";"no";1;0;1;55,1;14,7
1697;"Rønne";"no";0;0;0;55,1;14,7
1698;"Rønne";"no";0;0;0;55,1;14,7
1699;"Rønne";"no";0;0;0;55,1;14,7
1700;"Rønne";"no";0;0;0;55,1;14,7
1701;"Rønne";"no";0;0;0;55,1;14,7
1702;"Rønne";"no";0;0;0;55,1;14,7
1703;"Rønne";"no";0;0;0;55,1;14,7
1704;"Rønne";"no";0;0;0;55,1;14,7
1705;"Rønne";"no";0;0;0;55,1;14,7
1706;"Rønne";"no";1;0;1;55,1;14,7
1707;"Rønne";"no";0;0;0;55,1;14,7
1708;"Rønne";"no";0;0;0;55,1;14,7
1709;"Rønne";"no";0;0;0;55,1;14,7
1710;"Rønne";"no";0;0;0;55,1;14,7
1711;"Rønne";"no";0;0;0;55,1;14,7
1712;"Rønne";"no";0;0;0;55,1;14,7
1713;"Rønne";"no";0;0;0;55,1;14,7
1714;"Rønne";"no";1;0;1;55,1;14,7
1715;"Rønne";"no";0;0;0;55,1;14,7
1716;"Rønne";"no";0;0;0;55,1;14,7
1717;"Rønne";"no";0;0;0;55,1;14,7
1718;"Rønne";"no";0;0;0;55,1;14,7
1719;"Rønne";"no";0;0;0;55,1;14,7
1720;"Rønne";"no";0;0;0;55,1;14,7
1721;"Rønne";"no";0;0;0;55,1;14,7
1722;"Rønne";"no";0;0;0;55,1;14,7
1723;"Rønne";"no";0;0;0;55,1;14,7
1724;"Rønne";"no";0;0;0;55,1;14,7
1725;"Rønne";"no";0;0;0;55,1;14,7
1726;"Rønne";"no";0;0;0;55,1;14,7
1727;"Rønne";"no";0;0;0;55,1;14,7
1728;"Rønne";"no";0;0;0;55,1;14,7
1729;"Rønne";"no";0;0;0;55,1;14,7
1730;"Rønne";"no";0;0;0;55,1;14,7
1731;"Rønne";"no";0;0;0;55,1;14,7
1732;"Rønne";"no";0;0;0;55,1;14,7
1733;"Rønne";"no";0;0;0;55,1;14,7
1734;"Rønne";"no";0;0;0;55,1;14,7
1735;"Rønne";"no";1;0;1;55,1;14,7
1736;"Rønne";"no";0;0;0;55,1;14,7
1737;"Rønne";"no";0;0;0;55,1;14,7
1738;"Rønne";"no";0;0;0;55,1;14,7
1739;"Rønne";"no";0;0;0;55,1;14,7
1740;"Rønne";"no";0;0;0;55,1;14,7
1741;"Rønne";"no";0;0;0;55,1;14,7
1742;"Rønne";"no";0;0;0;55,1;14,7
1743;"Rønne";"no";0;0;0;55,1;14,7
1744;"Rønne";"no";0;0;0;55,1;14,7
1745;"Rønne";"no";1;0;1;55,1;14,7
1746;"Rønne";"no";0;0;0;55,1;14,7
1747;"Rønne";"no";0;0;0;55,1;14,7
1748;"Rønne";"no";0;0;0;55,1;14,7
1749;"Rønne";"no";0;0;0;55,1;14,7
1750;"Rønne";"no";0;0;0;55,1;14,7
1751;"Rønne";"no";0;0;0;55,1;14,7
1752;"Rønne";"no";0;0;0;55,1;14,7
1753;"Rønne";"no";0;0;0;55,1;14,7
1754;"Rønne";"no";0;0;0;55,1;14,7
1755;"Rønne";"no";0;0;0;55,1;14,7
1756;"Rønne";"no";0;0;0;55,1;14,7
1757;"Rønne";"no";0;0;0;55,1;14,7
1758;"Rønne";"no";0;0;0;55,1;14,7
1759;"Rønne";"no";0;0;0;55,1;14,7
1760;"Rønne";"no";0;0;0;55,1;14,7
1761;"Rønne";"no";0;0;0;55,1;14,7
1762;"Rønne";"no";0;0;0;55,1;14,7
1763;"Rønne";"no";0;0;0;55,1;14,7
1764;"Rønne";"no";0;0;0;55,1;14,7
1765;"Rønne";"no";0;0;0;55,1;14,7
1766;"Rønne";"no";0;0;0;55,1;14,7
1767;"Rønne";"no";1;0;1;55,1;14,7
1768;"Rønne";"no";0;0;0;55,1;14,7
1769;"Rønne";"no";1;1;2;55,1;14,7
1770;"Rønne";"no";1;1;2;55,1;14,7
1771;"Rønne";"no";0;0;0;55,1;14,7
1772;"Rønne";"no";0;0;0;55,1;14,7
1773;"Rønne";"no";0;0;0;55,1;14,7
1774;"Rønne";"no";0;0;0;55,1;14,7
1775;"Rønne";"no";0;0;0;55,1;14,7
1776;"Rønne";"no";0;0;0;55,1;14,7
1777;"Rønne";"no";0;0;0;55,1;14,7
1778;"Rønne";"no";0;0;0;55,1;14,7
1779;"Rønne";"no";0;0;0;55,1;14,7
1780;"Rønne";"no";0;0;0;55,1;14,7
1781;"Rønne";"no";1;1;2;55,1;14,7
1782;"Rønne";"no";0;0;0;55,1;14,7
1783;"Rønne";"no";0;1;1;55,1;14,7
1784;"Rønne";"no";0;0;0;55,1;14,7
1785;"Rønne";"no";0;1;1;55,1;14,7
1786;"Rønne";"no";0;0;0;55,1;14,7
1787;"Rønne";"no";0;2;2;55,1;14,7
1788;"Rønne";"no";0;0;0;55,1;14,7
1789;"Rønne";"no";1;0;1;55,1;14,7
1790;"Rønne";"no";0;0;0;55,1;14,7
1791;"Rønne";"no";0;1;1;55,1;14,7
1792;"Rønne";"no";1;0;1;55,1;14,7
1793;"Rønne";"no";0;0;0;55,1;14,7
1794;"Rønne";"no";0;1;1;55,1;14,7
1795;"Rønne";"no";0;0;0;55,1;14,7
1796;"Rønne";"no";0;0;0;55,1;14,7
1797;"Rønne";"no";0;0;0;55,1;14,7
1798;"Rønne";"no";0;0;0;55,1;14,7
1799;"Rønne";"no";0;1;1;55,1;14,7
1800;"Rønne";"no";0;2;2;55,1;14,7
1801;"Rønne";"no";0;1;1;55,1;14,7
1802;"Rønne";"no";0;0;0;55,1;14,7
1803;"Rønne";"no";0;1;1;55,1;14,7
1804;"Rønne";"no";2;4;6;55,1;14,7
1805;"Rønne";"no";0;1;1;55,1;14,7
1806;"Rønne";"no";0;0;0;55,1;14,7
1807;"Rønne";"no";0;0;0;55,1;14,7
1808;"Rønne";"no";0;0;0;55,1;14,7
1809;"Rønne";"no";0;0;0;55,1;14,7
1810;"Rønne";"no";0;0;0;55,1;14,7
1811;"Rønne";"no";0;0;0;55,1;14,7
1812;"Rønne";"no";0;0;0;55,1;14,7
1813;"Rønne";"no";0;0;0;55,1;14,7
1814;"Rønne";"no";0;0;0;55,1;14,7
1815;"Rønne";"no";0;0;0;55,1;14,7
1816;"Rønne";"no";0;0;0;55,1;14,7
1817;"Rønne";"no";0;0;0;55,1;14,7
1818;"Rønne";"no";0;0;0;55,1;14,7
1819;"Rønne";"no";0;0;0;55,1;14,7
1820;"Rønne";"no";0;1;1;55,1;14,7
1821;"Rønne";"no";3;1;4;55,1;14,7
1822;"Rønne";"no";0;0;0;55,1;14,7
1823;"Rønne";"no";0;0;0;55,1;14,7
1824;"Rønne";"no";0;2;2;55,1;14,7
1825;"Rønne";"no";5;1;6;55,1;14,7
1826;"Rønne";"no";1;3;4;55,1;14,7
1827;"Rønne";"no";1;1;2;55,1;14,7
1828;"Rønne";"no";3;2;5;55,1;14,7
1829;"Rønne";"no";3;2;5;55,1;14,7
1830;"Rønne";"no";2;2;4;55,1;14,7
1831;"Rønne";"no";2;0;2;55,1;14,7
1832;"Rønne";"no";0;1;1;55,1;14,7
1833;"Rønne";"no";1;0;1;55,1;14,7
1834;"Rønne";"no";0;1;1;55,1;14,7
1835;"Rønne";"no";0;0;0;55,1;14,7
1836;"Rønne";"no";0;1;1;55,1;14,7
1837;"Rønne";"no";0;1;1;55,1;14,7
1838;"Rønne";"no";0;4;4;55,1;14,7
1839;"Rønne";"no";0;4;4;55,1;14,7
1840;"Rønne";"no";0;5;5;55,1;14,7
1841;"Rønne";"no";2;6;8;55,1;14,7
1842;"Rønne";"no";0;3;3;55,1;14,7
1843;"Rønne";"no";5;7;12;55,1;14,7
1844;"Rønne";"no";0;7;7;55,1;14,7
1845;"Rønne";"no";0;6;6;55,1;14,7
1846;"Rønne";"no";0;8;8;55,1;14,7
1847;"Rønne";"no";2;8;10;55,1;14,7
1848;"Rønne";"no";0;7;7;55,1;14,7
1849;"Rønne";"no";0;7;7;55,1;14,7
1850;"Rønne";"no";1;10;11;55,1;14,7
1851;"Rønne";"no";1;8;9;55,1;14,7
1852;"Rønne";"no";10;11;21;55,1;14,7
1853;"Rønne";"no";13;11;24;55,1;14,7
1854;"Rønne";"no";12;12;24;55,1;14,7
1855;"Rønne";"no";12;19;31;55,1;14,7
1856;"Rønne";"no";10;23;33;55,1;14,7
1857;"Rønne";"no";7;2;9;55,1;14,7
1634;"Skelskør";"no";0;0;0;55,25;11,316666
1635;"Skelskør";"no";1;0;1;55,25;11,316666
1636;"Skelskør";"no";0;0;0;55,25;11,316666
1637;"Skelskør";"no";2;0;2;55,25;11,316666
1638;"Skelskør";"no";0;0;0;55,25;11,316666
1639;"Skelskør";"no";0;0;0;55,25;11,316666
1640;"Skelskør";"no";1;0;1;55,25;11,316666
1641;"Skelskør";"no";1;0;1;55,25;11,316666
1642;"Skelskør";"no";0;0;0;55,25;11,316666
1643;"Skelskør";"no";0;0;0;55,25;11,316666
1644;"Skelskør";"no";0;0;0;55,25;11,316666
1645;"Skelskør";"no";0;0;0;55,25;11,316666
1646;"Skelskør";"no";0;0;0;55,25;11,316666
1647;"Skelskør";"no";0;0;0;55,25;11,316666
1648;"Skelskør";"no";0;0;0;55,25;11,316666
1649;"Skelskør";"no";0;0;0;55,25;11,316666
1650;"Skelskør";"no";0;0;0;55,25;11,316666
1651;"Skelskør";"no";0;0;0;55,25;11,316666
1652;"Skelskør";"no";0;0;0;55,25;11,316666
1653;"Skelskør";"no";0;0;0;55,25;11,316666
1654;"Skelskør";"no";0;0;0;55,25;11,316666
1655;"Skelskør";"no";0;0;0;55,25;11,316666
1656;"Skelskør";"no";0;0;0;55,25;11,316666
1657;"Skelskør";"no";0;0;0;55,25;11,316666
1658;"Skelskør";"no";0;0;0;55,25;11,316666
1659;"Skelskør";"no";0;0;0;55,25;11,316666
1660;"Skelskør";"no";0;0;0;55,25;11,316666
1661;"Skelskør";"no";0;0;0;55,25;11,316666
1662;"Skelskør";"no";0;0;0;55,25;11,316666
1663;"Skelskør";"no";0;0;0;55,25;11,316666
1664;"Skelskør";"no";0;0;0;55,25;11,316666
1665;"Skelskør";"no";0;0;0;55,25;11,316666
1666;"Skelskør";"no";0;0;0;55,25;11,316666
1667;"Skelskør";"no";0;0;0;55,25;11,316666
1668;"Skelskør";"no";0;0;0;55,25;11,316666
1669;"Skelskør";"no";0;0;0;55,25;11,316666
1670;"Skelskør";"no";0;0;0;55,25;11,316666
1671;"Skelskør";"no";0;0;0;55,25;11,316666
1672;"Skelskør";"no";0;0;0;55,25;11,316666
1673;"Skelskør";"no";0;0;0;55,25;11,316666
1674;"Skelskør";"no";0;0;0;55,25;11,316666
1675;"Skelskør";"no";0;0;0;55,25;11,316666
1676;"Skelskør";"no";0;0;0;55,25;11,316666
1677;"Skelskør";"no";0;0;0;55,25;11,316666
1678;"Skelskør";"no";0;0;0;55,25;11,316666
1679;"Skelskør";"no";0;0;0;55,25;11,316666
1680;"Skelskør";"no";0;0;0;55,25;11,316666
1681;"Skelskør";"no";0;0;0;55,25;11,316666
1682;"Skelskør";"no";0;0;0;55,25;11,316666
1683;"Skelskør";"no";0;0;0;55,25;11,316666
1684;"Skelskør";"no";0;0;0;55,25;11,316666
1685;"Skelskør";"no";0;0;0;55,25;11,316666
1686;"Skelskør";"no";0;0;0;55,25;11,316666
1687;"Skelskør";"no";0;0;0;55,25;11,316666
1688;"Skelskør";"no";0;0;0;55,25;11,316666
1689;"Skelskør";"no";0;0;0;55,25;11,316666
1690;"Skelskør";"no";0;0;0;55,25;11,316666
1691;"Skelskør";"no";0;0;0;55,25;11,316666
1692;"Skelskør";"no";0;0;0;55,25;11,316666
1693;"Skelskør";"no";0;1;1;55,25;11,316666
1694;"Skelskør";"no";0;0;0;55,25;11,316666
1695;"Skelskør";"no";0;0;0;55,25;11,316666
1696;"Skelskør";"no";0;0;0;55,25;11,316666
1697;"Skelskør";"no";0;0;0;55,25;11,316666
1698;"Skelskør";"no";0;0;0;55,25;11,316666
1699;"Skelskør";"no";0;0;0;55,25;11,316666
1700;"Skelskør";"no";0;0;0;55,25;11,316666
1701;"Skelskør";"no";0;0;0;55,25;11,316666
1702;"Skelskør";"no";0;0;0;55,25;11,316666
1703;"Skelskør";"no";0;0;0;55,25;11,316666
1704;"Skelskør";"no";0;0;0;55,25;11,316666
1705;"Skelskør";"no";0;0;0;55,25;11,316666
1706;"Skelskør";"no";0;0;0;55,25;11,316666
1707;"Skelskør";"no";0;0;0;55,25;11,316666
1708;"Skelskør";"no";0;0;0;55,25;11,316666
1709;"Skelskør";"no";0;0;0;55,25;11,316666
1710;"Skelskør";"no";0;0;0;55,25;11,316666
1711;"Skelskør";"no";0;0;0;55,25;11,316666
1712;"Skelskør";"no";0;0;0;55,25;11,316666
1713;"Skelskør";"no";0;0;0;55,25;11,316666
1714;"Skelskør";"no";0;0;0;55,25;11,316666
1715;"Skelskør";"no";0;0;0;55,25;11,316666
1716;"Skelskør";"no";0;0;0;55,25;11,316666
1717;"Skelskør";"no";0;0;0;55,25;11,316666
1718;"Skelskør";"no";0;0;0;55,25;11,316666
1719;"Skelskør";"no";0;0;0;55,25;11,316666
1720;"Skelskør";"no";0;0;0;55,25;11,316666
1721;"Skelskør";"no";0;0;0;55,25;11,316666
1722;"Skelskør";"no";0;1;1;55,25;11,316666
1723;"Skelskør";"no";0;0;0;55,25;11,316666
1724;"Skelskør";"no";0;0;0;55,25;11,316666
1725;"Skelskør";"no";0;0;0;55,25;11,316666
1726;"Skelskør";"no";0;0;0;55,25;11,316666
1727;"Skelskør";"no";0;0;0;55,25;11,316666
1728;"Skelskør";"no";0;0;0;55,25;11,316666
1729;"Skelskør";"no";0;0;0;55,25;11,316666
1730;"Skelskør";"no";0;0;0;55,25;11,316666
1731;"Skelskør";"no";0;0;0;55,25;11,316666
1732;"Skelskør";"no";0;0;0;55,25;11,316666
1733;"Skelskør";"no";0;0;0;55,25;11,316666
1734;"Skelskør";"no";0;0;0;55,25;11,316666
1735;"Skelskør";"no";0;0;0;55,25;11,316666
1736;"Skelskør";"no";0;0;0;55,25;11,316666
1737;"Skelskør";"no";0;0;0;55,25;11,316666
1738;"Skelskør";"no";0;0;0;55,25;11,316666
1739;"Skelskør";"no";0;0;0;55,25;11,316666
1740;"Skelskør";"no";0;0;0;55,25;11,316666
1741;"Skelskør";"no";0;0;0;55,25;11,316666
1742;"Skelskør";"no";0;0;0;55,25;11,316666
1743;"Skelskør";"no";0;0;0;55,25;11,316666
1744;"Skelskør";"no";0;0;0;55,25;11,316666
1745;"Skelskør";"no";0;0;0;55,25;11,316666
1746;"Skelskør";"no";0;0;0;55,25;11,316666
1747;"Skelskør";"no";0;0;0;55,25;11,316666
1748;"Skelskør";"no";0;0;0;55,25;11,316666
1749;"Skelskør";"no";0;0;0;55,25;11,316666
1750;"Skelskør";"no";0;0;0;55,25;11,316666
1751;"Skelskør";"no";0;1;1;55,25;11,316666
1752;"Skelskør";"no";0;0;0;55,25;11,316666
1753;"Skelskør";"no";0;0;0;55,25;11,316666
1754;"Skelskør";"no";0;0;0;55,25;11,316666
1755;"Skelskør";"no";0;0;0;55,25;11,316666
1756;"Skelskør";"no";0;0;0;55,25;11,316666
1757;"Skelskør";"no";0;0;0;55,25;11,316666
1758;"Skelskør";"no";0;0;0;55,25;11,316666
1759;"Skelskør";"no";0;0;0;55,25;11,316666
1760;"Skelskør";"no";0;0;0;55,25;11,316666
1761;"Skelskør";"no";0;0;0;55,25;11,316666
1762;"Skelskør";"no";0;0;0;55,25;11,316666
1763;"Skelskør";"no";0;0;0;55,25;11,316666
1764;"Skelskør";"no";0;0;0;55,25;11,316666
1765;"Skelskør";"no";0;0;0;55,25;11,316666
1766;"Skelskør";"no";0;0;0;55,25;11,316666
1767;"Skelskør";"no";0;0;0;55,25;11,316666
1768;"Skelskør";"no";0;1;1;55,25;11,316666
1769;"Skelskør";"no";0;0;0;55,25;11,316666
1770;"Skelskør";"no";0;0;0;55,25;11,316666
1771;"Skelskør";"no";0;0;0;55,25;11,316666
1772;"Skelskør";"no";0;0;0;55,25;11,316666
1773;"Skelskør";"no";0;0;0;55,25;11,316666
1774;"Skelskør";"no";0;0;0;55,25;11,316666
1775;"Skelskør";"no";0;0;0;55,25;11,316666
1776;"Skelskør";"no";0;0;0;55,25;11,316666
1777;"Skelskør";"no";1;0;1;55,25;11,316666
1778;"Skelskør";"no";0;1;1;55,25;11,316666
1779;"Skelskør";"no";0;1;1;55,25;11,316666
1780;"Skelskør";"no";0;0;0;55,25;11,316666
1781;"Skelskør";"no";0;0;0;55,25;11,316666
1782;"Skelskør";"no";0;0;0;55,25;11,316666
1783;"Skelskør";"no";0;0;0;55,25;11,316666
1784;"Skelskør";"no";0;1;1;55,25;11,316666
1785;"Skelskør";"no";1;0;1;55,25;11,316666
1786;"Skelskør";"no";0;2;2;55,25;11,316666
1787;"Skelskør";"no";0;0;0;55,25;11,316666
1788;"Skelskør";"no";0;0;0;55,25;11,316666
1789;"Skelskør";"no";0;0;0;55,25;11,316666
1790;"Skelskør";"no";0;0;0;55,25;11,316666
1791;"Skelskør";"no";0;0;0;55,25;11,316666
1792;"Skelskør";"no";0;0;0;55,25;11,316666
1793;"Skelskør";"no";0;0;0;55,25;11,316666
1794;"Skelskør";"no";0;0;0;55,25;11,316666
1795;"Skelskør";"no";0;0;0;55,25;11,316666
1796;"Skelskør";"no";0;1;1;55,25;11,316666
1797;"Skelskør";"no";0;0;0;55,25;11,316666
1798;"Skelskør";"no";0;0;0;55,25;11,316666
1799;"Skelskør";"no";0;0;0;55,25;11,316666
1800;"Skelskør";"no";0;0;0;55,25;11,316666
1801;"Skelskør";"no";1;0;1;55,25;11,316666
1802;"Skelskør";"no";0;0;0;55,25;11,316666
1803;"Skelskør";"no";0;0;0;55,25;11,316666
1804;"Skelskør";"no";0;0;0;55,25;11,316666
1805;"Skelskør";"no";0;0;0;55,25;11,316666
1806;"Skelskør";"no";0;0;0;55,25;11,316666
1807;"Skelskør";"no";0;0;0;55,25;11,316666
1808;"Skelskør";"no";0;0;0;55,25;11,316666
1809;"Skelskør";"no";0;0;0;55,25;11,316666
1810;"Skelskør";"no";0;0;0;55,25;11,316666
1811;"Skelskør";"no";1;0;1;55,25;11,316666
1812;"Skelskør";"no";0;0;0;55,25;11,316666
1813;"Skelskør";"no";0;0;0;55,25;11,316666
1814;"Skelskør";"no";0;0;0;55,25;11,316666
1815;"Skelskør";"no";0;1;1;55,25;11,316666
1816;"Skelskør";"no";0;0;0;55,25;11,316666
1817;"Skelskør";"no";0;0;0;55,25;11,316666
1818;"Skelskør";"no";0;0;0;55,25;11,316666
1819;"Skelskør";"no";0;0;0;55,25;11,316666
1820;"Skelskør";"no";0;0;0;55,25;11,316666
1821;"Skelskør";"no";1;1;2;55,25;11,316666
1822;"Skelskør";"no";0;1;1;55,25;11,316666
1823;"Skelskør";"no";0;0;0;55,25;11,316666
1824;"Skelskør";"no";0;0;0;55,25;11,316666
1825;"Skelskør";"no";0;0;0;55,25;11,316666
1826;"Skelskør";"no";0;0;0;55,25;11,316666
1827;"Skelskør";"no";0;1;1;55,25;11,316666
1828;"Skelskør";"no";0;0;0;55,25;11,316666
1829;"Skelskør";"no";0;2;2;55,25;11,316666
1830;"Skelskør";"no";0;0;0;55,25;11,316666
1831;"Skelskør";"no";0;0;0;55,25;11,316666
1832;"Skelskør";"no";0;0;0;55,25;11,316666
1833;"Skelskør";"no";0;0;0;55,25;11,316666
1834;"Skelskør";"no";1;5;6;55,25;11,316666
1835;"Skelskør";"no";0;0;0;55,25;11,316666
1836;"Skelskør";"no";0;0;0;55,25;11,316666
1837;"Skelskør";"no";0;0;0;55,25;11,316666
1838;"Skelskør";"no";0;4;4;55,25;11,316666
1839;"Skelskør";"no";0;2;2;55,25;11,316666
1840;"Skelskør";"no";0;2;2;55,25;11,316666
1841;"Skelskør";"no";0;0;0;55,25;11,316666
1842;"Skelskør";"no";0;0;0;55,25;11,316666
1843;"Skelskør";"no";0;0;0;55,25;11,316666
1844;"Skelskør";"no";0;0;0;55,25;11,316666
1845;"Skelskør";"no";0;1;1;55,25;11,316666
1846;"Skelskør";"no";0;2;2;55,25;11,316666
1847;"Skelskør";"no";0;0;0;55,25;11,316666
1848;"Skelskør";"no";0;1;1;55,25;11,316666
1849;"Skelskør";"no";0;1;1;55,25;11,316666
1850;"Skelskør";"no";1;2;3;55,25;11,316666
1851;"Skelskør";"no";0;1;1;55,25;11,316666
1852;"Skelskør";"no";1;0;1;55,25;11,316666
1853;"Skelskør";"no";0;2;2;55,25;11,316666
1854;"Skelskør";"no";0;0;0;55,25;11,316666
1855;"Skelskør";"no";1;0;1;55,25;11,316666
1856;"Skelskør";"no";2;0;2;55,25;11,316666
1857;"Skelskør";"no";0;0;0;55,25;11,316666
1634;"Stege";"no";0;0;0;54,983333;12,3
1635;"Stege";"no";1;0;1;54,983333;12,3
1636;"Stege";"no";0;0;0;54,983333;12,3
1637;"Stege";"no";0;0;0;54,983333;12,3
1638;"Stege";"no";0;0;0;54,983333;12,3
1639;"Stege";"no";0;0;0;54,983333;12,3
1640;"Stege";"no";2;0;2;54,983333;12,3
1641;"Stege";"no";0;0;0;54,983333;12,3
1642;"Stege";"no";0;0;0;54,983333;12,3
1643;"Stege";"no";1;0;1;54,983333;12,3
1644;"Stege";"no";0;0;0;54,983333;12,3
1645;"Stege";"no";0;0;0;54,983333;12,3
1646;"Stege";"no";0;0;0;54,983333;12,3
1647;"Stege";"no";1;0;1;54,983333;12,3
1648;"Stege";"no";1;0;1;54,983333;12,3
1649;"Stege";"no";0;0;0;54,983333;12,3
1650;"Stege";"no";0;0;0;54,983333;12,3
1651;"Stege";"no";0;0;0;54,983333;12,3
1652;"Stege";"no";0;0;0;54,983333;12,3
1653;"Stege";"no";0;0;0;54,983333;12,3
1654;"Stege";"no";3;0;3;54,983333;12,3
1655;"Stege";"no";2;0;2;54,983333;12,3
1656;"Stege";"no";1;0;1;54,983333;12,3
1657;"Stege";"no";1;0;1;54,983333;12,3
1658;"Stege";"no";0;0;0;54,983333;12,3
1659;"Stege";"no";0;0;0;54,983333;12,3
1660;"Stege";"no";0;0;0;54,983333;12,3
1661;"Stege";"no";0;0;0;54,983333;12,3
1662;"Stege";"no";0;0;0;54,983333;12,3
1663;"Stege";"no";1;0;1;54,983333;12,3
1664;"Stege";"no";2;0;2;54,983333;12,3
1665;"Stege";"no";0;0;0;54,983333;12,3
1666;"Stege";"no";1;0;1;54,983333;12,3
1667;"Stege";"no";3;0;3;54,983333;12,3
1668;"Stege";"no";2;1;3;54,983333;12,3
1669;"Stege";"no";3;0;3;54,983333;12,3
1670;"Stege";"no";1;0;1;54,983333;12,3
1671;"Stege";"no";2;1;3;54,983333;12,3
1672;"Stege";"no";1;1;2;54,983333;12,3
1673;"Stege";"no";3;0;3;54,983333;12,3
1674;"Stege";"no";1;0;1;54,983333;12,3
1675;"Stege";"no";0;0;0;54,983333;12,3
1676;"Stege";"no";0;0;0;54,983333;12,3
1677;"Stege";"no";0;0;0;54,983333;12,3
1678;"Stege";"no";0;0;0;54,983333;12,3
1679;"Stege";"no";0;0;0;54,983333;12,3
1680;"Stege";"no";0;0;0;54,983333;12,3
1681;"Stege";"no";0;0;0;54,983333;12,3
1682;"Stege";"no";2;0;2;54,983333;12,3
1683;"Stege";"no";0;0;0;54,983333;12,3
1684;"Stege";"no";0;0;0;54,983333;12,3
1685;"Stege";"no";1;0;1;54,983333;12,3
1686;"Stege";"no";0;0;0;54,983333;12,3
1687;"Stege";"no";2;1;3;54,983333;12,3
1688;"Stege";"no";1;0;1;54,983333;12,3
1689;"Stege";"no";0;0;0;54,983333;12,3
1690;"Stege";"no";0;0;0;54,983333;12,3
1691;"Stege";"no";0;0;0;54,983333;12,3
1692;"Stege";"no";0;0;0;54,983333;12,3
1693;"Stege";"no";0;0;0;54,983333;12,3
1694;"Stege";"no";0;1;1;54,983333;12,3
1695;"Stege";"no";1;1;2;54,983333;12,3
1696;"Stege";"no";0;0;0;54,983333;12,3
1697;"Stege";"no";0;0;0;54,983333;12,3
1698;"Stege";"no";1;1;2;54,983333;12,3
1699;"Stege";"no";2;1;3;54,983333;12,3
1700;"Stege";"no";0;0;0;54,983333;12,3
1701;"Stege";"no";1;1;2;54,983333;12,3
1702;"Stege";"no";1;0;1;54,983333;12,3
1703;"Stege";"no";0;0;0;54,983333;12,3
1704;"Stege";"no";0;0;0;54,983333;12,3
1705;"Stege";"no";0;0;0;54,983333;12,3
1706;"Stege";"no";0;0;0;54,983333;12,3
1707;"Stege";"no";0;1;1;54,983333;12,3
1708;"Stege";"no";0;0;0;54,983333;12,3
1709;"Stege";"no";0;1;1;54,983333;12,3
1710;"Stege";"no";0;1;1;54,983333;12,3
1711;"Stege";"no";0;1;1;54,983333;12,3
1712;"Stege";"no";0;0;0;54,983333;12,3
1713;"Stege";"no";0;0;0;54,983333;12,3
1714;"Stege";"no";0;0;0;54,983333;12,3
1715;"Stege";"no";0;0;0;54,983333;12,3
1716;"Stege";"no";0;0;0;54,983333;12,3
1717;"Stege";"no";0;0;0;54,983333;12,3
1718;"Stege";"no";0;0;0;54,983333;12,3
1719;"Stege";"no";0;0;0;54,983333;12,3
1720;"Stege";"no";1;0;1;54,983333;12,3
1721;"Stege";"no";0;0;0;54,983333;12,3
1722;"Stege";"no";1;0;1;54,983333;12,3
1723;"Stege";"no";0;1;1;54,983333;12,3
1724;"Stege";"no";0;0;0;54,983333;12,3
1725;"Stege";"no";0;0;0;54,983333;12,3
1726;"Stege";"no";0;0;0;54,983333;12,3
1727;"Stege";"no";0;1;1;54,983333;12,3
1728;"Stege";"no";0;0;0;54,983333;12,3
1729;"Stege";"no";0;0;0;54,983333;12,3
1730;"Stege";"no";0;0;0;54,983333;12,3
1731;"Stege";"no";0;0;0;54,983333;12,3
1732;"Stege";"no";0;0;0;54,983333;12,3
1733;"Stege";"no";0;0;0;54,983333;12,3
1734;"Stege";"no";0;1;1;54,983333;12,3
1735;"Stege";"no";0;2;2;54,983333;12,3
1736;"Stege";"no";0;0;0;54,983333;12,3
1737;"Stege";"no";0;0;0;54,983333;12,3
1738;"Stege";"no";0;4;4;54,983333;12,3
1739;"Stege";"no";0;0;0;54,983333;12,3
1740;"Stege";"no";0;0;0;54,983333;12,3
1741;"Stege";"no";0;0;0;54,983333;12,3
1742;"Stege";"no";0;0;0;54,983333;12,3
1743;"Stege";"no";0;0;0;54,983333;12,3
1744;"Stege";"no";0;0;0;54,983333;12,3
1745;"Stege";"no";1;0;1;54,983333;12,3
1746;"Stege";"no";1;0;1;54,983333;12,3
1747;"Stege";"no";3;3;6;54,983333;12,3
1748;"Stege";"no";0;0;0;54,983333;12,3
1749;"Stege";"no";1;0;1;54,983333;12,3
1750;"Stege";"no";6;3;9;54,983333;12,3
1751;"Stege";"no";1;0;1;54,983333;12,3
1752;"Stege";"no";1;0;1;54,983333;12,3
1753;"Stege";"no";1;2;3;54,983333;12,3
1754;"Stege";"no";4;4;8;54,983333;12,3
1755;"Stege";"no";2;1;3;54,983333;12,3
1756;"Stege";"no";1;1;2;54,983333;12,3
1757;"Stege";"no";2;1;3;54,983333;12,3
1758;"Stege";"no";3;3;6;54,983333;12,3
1759;"Stege";"no";0;2;2;54,983333;12,3
1760;"Stege";"no";1;0;1;54,983333;12,3
1761;"Stege";"no";1;0;1;54,983333;12,3
1762;"Stege";"no";1;0;1;54,983333;12,3
1763;"Stege";"no";0;0;0;54,983333;12,3
1764;"Stege";"no";0;0;0;54,983333;12,3
1765;"Stege";"no";0;0;0;54,983333;12,3
1766;"Stege";"no";0;0;0;54,983333;12,3
1767;"Stege";"no";0;0;0;54,983333;12,3
1768;"Stege";"no";0;1;1;54,983333;12,3
1769;"Stege";"no";1;2;3;54,983333;12,3
1770;"Stege";"no";0;0;0;54,983333;12,3
1771;"Stege";"no";1;1;2;54,983333;12,3
1772;"Stege";"no";2;0;2;54,983333;12,3
1773;"Stege";"no";1;0;1;54,983333;12,3
1774;"Stege";"no";4;3;7;54,983333;12,3
1775;"Stege";"no";3;3;6;54,983333;12,3
1776;"Stege";"no";2;2;4;54,983333;12,3
1777;"Stege";"no";2;0;2;54,983333;12,3
1778;"Stege";"no";6;2;8;54,983333;12,3
1779;"Stege";"no";2;1;3;54,983333;12,3
1780;"Stege";"no";3;2;5;54,983333;12,3
1781;"Stege";"no";4;0;4;54,983333;12,3
1782;"Stege";"no";0;1;1;54,983333;12,3
1783;"Stege";"no";2;0;2;54,983333;12,3
1784;"Stege";"no";0;0;0;54,983333;12,3
1785;"Stege";"no";1;6;7;54,983333;12,3
1786;"Stege";"no";3;2;5;54,983333;12,3
1787;"Stege";"no";4;4;8;54,983333;12,3
1788;"Stege";"no";5;7;12;54,983333;12,3
1789;"Stege";"no";2;6;8;54,983333;12,3
1790;"Stege";"no";2;2;4;54,983333;12,3
1791;"Stege";"no";7;7;14;54,983333;12,3
1792;"Stege";"no";1;1;2;54,983333;12,3
1793;"Stege";"no";1;3;4;54,983333;12,3
1794;"Stege";"no";0;1;1;54,983333;12,3
1795;"Stege";"no";3;2;5;54,983333;12,3
1796;"Stege";"no";2;1;3;54,983333;12,3
1797;"Stege";"no";0;2;2;54,983333;12,3
1798;"Stege";"no";1;2;3;54,983333;12,3
1799;"Stege";"no";2;1;3;54,983333;12,3
1800;"Stege";"no";0;0;0;54,983333;12,3
1801;"Stege";"no";0;2;2;54,983333;12,3
1802;"Stege";"no";0;0;0;54,983333;12,3
1803;"Stege";"no";0;2;2;54,983333;12,3
1804;"Stege";"no";0;0;0;54,983333;12,3
1805;"Stege";"no";0;0;0;54,983333;12,3
1806;"Stege";"no";0;2;2;54,983333;12,3
1807;"Stege";"no";0;0;0;54,983333;12,3
1808;"Stege";"no";0;0;0;54,983333;12,3
1809;"Stege";"no";0;0;0;54,983333;12,3
1810;"Stege";"no";2;0;2;54,983333;12,3
1811;"Stege";"no";0;0;0;54,983333;12,3
1812;"Stege";"no";0;0;0;54,983333;12,3
1813;"Stege";"no";0;0;0;54,983333;12,3
1814;"Stege";"no";0;3;3;54,983333;12,3
1815;"Stege";"no";1;1;2;54,983333;12,3
1816;"Stege";"no";1;1;2;54,983333;12,3
1817;"Stege";"no";0;0;0;54,983333;12,3
1818;"Stege";"no";1;5;6;54,983333;12,3
1819;"Stege";"no";2;6;8;54,983333;12,3
1820;"Stege";"no";2;3;5;54,983333;12,3
1821;"Stege";"no";3;4;7;54,983333;12,3
1822;"Stege";"no";4;5;9;54,983333;12,3
1823;"Stege";"no";6;2;8;54,983333;12,3
1824;"Stege";"no";5;9;14;54,983333;12,3
1825;"Stege";"no";8;2;10;54,983333;12,3
1826;"Stege";"no";6;2;8;54,983333;12,3
1827;"Stege";"no";4;3;7;54,983333;12,3
1828;"Stege";"no";13;7;20;54,983333;12,3
1829;"Stege";"no";8;4;12;54,983333;12,3
1830;"Stege";"no";6;5;11;54,983333;12,3
1831;"Stege";"no";7;7;14;54,983333;12,3
1832;"Stege";"no";13;6;19;54,983333;12,3
1833;"Stege";"no";9;10;19;54,983333;12,3
1834;"Stege";"no";7;5;12;54,983333;12,3
1835;"Stege";"no";4;5;9;54,983333;12,3
1836;"Stege";"no";3;8;11;54,983333;12,3
1837;"Stege";"no";2;2;4;54,983333;12,3
1838;"Stege";"no";3;6;9;54,983333;12,3
1839;"Stege";"no";5;9;14;54,983333;12,3
1840;"Stege";"no";5;10;15;54,983333;12,3
1841;"Stege";"no";3;8;11;54,983333;12,3
1842;"Stege";"no";1;4;5;54,983333;12,3
1843;"Stege";"no";4;1;5;54,983333;12,3
1844;"Stege";"no";8;6;14;54,983333;12,3
1845;"Stege";"no";7;7;14;54,983333;12,3
1846;"Stege";"no";6;4;10;54,983333;12,3
1847;"Stege";"no";6;7;13;54,983333;12,3
1848;"Stege";"no";8;10;18;54,983333;12,3
1849;"Stege";"no";10;4;14;54,983333;12,3
1850;"Stege";"no";5;4;9;54,983333;12,3
1851;"Stege";"no";3;1;4;54,983333;12,3
1852;"Stege";"no";2;5;7;54,983333;12,3
1853;"Stege";"no";7;5;12;54,983333;12,3
1854;"Stege";"no";11;5;16;54,983333;12,3
1855;"Stege";"no";18;9;27;54,983333;12,3
1856;"Stege";"no";8;7;15;54,983333;12,3
1857;"Stege";"no";0;1;1;54,983333;12,3
1634;"Sæby";"no";0;0;0;57,333333;10,533333
1635;"Sæby";"no";7;0;7;57,333333;10,533333
1636;"Sæby";"no";0;0;0;57,333333;10,533333
1637;"Sæby";"no";0;0;0;57,333333;10,533333
1638;"Sæby";"no";1;0;1;57,333333;10,533333
1639;"Sæby";"no";0;0;0;57,333333;10,533333
1640;"Sæby";"no";0;0;0;57,333333;10,533333
1641;"Sæby";"no";0;0;0;57,333333;10,533333
1642;"Sæby";"no";0;0;0;57,333333;10,533333
1643;"Sæby";"no";0;0;0;57,333333;10,533333
1644;"Sæby";"no";0;0;0;57,333333;10,533333
1645;"Sæby";"no";0;0;0;57,333333;10,533333
1646;"Sæby";"no";0;0;0;57,333333;10,533333
1647;"Sæby";"no";0;0;0;57,333333;10,533333
1648;"Sæby";"no";0;0;0;57,333333;10,533333
1649;"Sæby";"no";0;0;0;57,333333;10,533333
1650;"Sæby";"no";0;0;0;57,333333;10,533333
1651;"Sæby";"no";0;0;0;57,333333;10,533333
1652;"Sæby";"no";0;1;1;57,333333;10,533333
1653;"Sæby";"no";0;0;0;57,333333;10,533333
1654;"Sæby";"no";0;0;0;57,333333;10,533333
1655;"Sæby";"no";0;1;1;57,333333;10,533333
1656;"Sæby";"no";0;0;0;57,333333;10,533333
1657;"Sæby";"no";0;0;0;57,333333;10,533333
1658;"Sæby";"no";0;0;0;57,333333;10,533333
1659;"Sæby";"no";0;0;0;57,333333;10,533333
1660;"Sæby";"no";0;0;0;57,333333;10,533333
1661;"Sæby";"no";0;0;0;57,333333;10,533333
1662;"Sæby";"no";0;0;0;57,333333;10,533333
1663;"Sæby";"no";0;0;0;57,333333;10,533333
1664;"Sæby";"no";0;1;1;57,333333;10,533333
1665;"Sæby";"no";0;0;0;57,333333;10,533333
1666;"Sæby";"no";0;0;0;57,333333;10,533333
1667;"Sæby";"no";0;0;0;57,333333;10,533333
1668;"Sæby";"no";0;0;0;57,333333;10,533333
1669;"Sæby";"no";0;0;0;57,333333;10,533333
1670;"Sæby";"no";0;0;0;57,333333;10,533333
1671;"Sæby";"no";0;0;0;57,333333;10,533333
1672;"Sæby";"no";0;0;0;57,333333;10,533333
1673;"Sæby";"no";0;0;0;57,333333;10,533333
1674;"Sæby";"no";2;0;2;57,333333;10,533333
1675;"Sæby";"no";0;0;0;57,333333;10,533333
1676;"Sæby";"no";0;0;0;57,333333;10,533333
1677;"Sæby";"no";0;0;0;57,333333;10,533333
1678;"Sæby";"no";0;0;0;57,333333;10,533333
1679;"Sæby";"no";0;0;0;57,333333;10,533333
1680;"Sæby";"no";0;0;0;57,333333;10,533333
1681;"Sæby";"no";0;0;0;57,333333;10,533333
1682;"Sæby";"no";0;0;0;57,333333;10,533333
1683;"Sæby";"no";0;0;0;57,333333;10,533333
1684;"Sæby";"no";0;0;0;57,333333;10,533333
1685;"Sæby";"no";0;0;0;57,333333;10,533333
1686;"Sæby";"no";0;0;0;57,333333;10,533333
1687;"Sæby";"no";0;0;0;57,333333;10,533333
1688;"Sæby";"no";0;0;0;57,333333;10,533333
1689;"Sæby";"no";0;0;0;57,333333;10,533333
1690;"Sæby";"no";0;0;0;57,333333;10,533333
1691;"Sæby";"no";0;0;0;57,333333;10,533333
1692;"Sæby";"no";0;0;0;57,333333;10,533333
1693;"Sæby";"no";0;0;0;57,333333;10,533333
1694;"Sæby";"no";0;0;0;57,333333;10,533333
1695;"Sæby";"no";0;0;0;57,333333;10,533333
1696;"Sæby";"no";0;0;0;57,333333;10,533333
1697;"Sæby";"no";0;0;0;57,333333;10,533333
1698;"Sæby";"no";0;0;0;57,333333;10,533333
1699;"Sæby";"no";0;0;0;57,333333;10,533333
1700;"Sæby";"no";0;0;0;57,333333;10,533333
1701;"Sæby";"no";0;0;0;57,333333;10,533333
1702;"Sæby";"no";0;0;0;57,333333;10,533333
1703;"Sæby";"no";0;0;0;57,333333;10,533333
1704;"Sæby";"no";0;0;0;57,333333;10,533333
1705;"Sæby";"no";0;0;0;57,333333;10,533333
1706;"Sæby";"no";0;0;0;57,333333;10,533333
1707;"Sæby";"no";0;0;0;57,333333;10,533333
1708;"Sæby";"no";0;0;0;57,333333;10,533333
1709;"Sæby";"no";0;0;0;57,333333;10,533333
1710;"Sæby";"no";0;0;0;57,333333;10,533333
1711;"Sæby";"no";0;0;0;57,333333;10,533333
1712;"Sæby";"no";0;0;0;57,333333;10,533333
1713;"Sæby";"no";0;0;0;57,333333;10,533333
1714;"Sæby";"no";0;0;0;57,333333;10,533333
1715;"Sæby";"no";0;0;0;57,333333;10,533333
1716;"Sæby";"no";0;0;0;57,333333;10,533333
1717;"Sæby";"no";0;0;0;57,333333;10,533333
1718;"Sæby";"no";0;0;0;57,333333;10,533333
1719;"Sæby";"no";0;0;0;57,333333;10,533333
1720;"Sæby";"no";0;0;0;57,333333;10,533333
1721;"Sæby";"no";0;0;0;57,333333;10,533333
1722;"Sæby";"no";0;0;0;57,333333;10,533333
1723;"Sæby";"no";0;0;0;57,333333;10,533333
1724;"Sæby";"no";0;0;0;57,333333;10,533333
1725;"Sæby";"no";0;0;0;57,333333;10,533333
1726;"Sæby";"no";0;0;0;57,333333;10,533333
1727;"Sæby";"no";0;0;0;57,333333;10,533333
1728;"Sæby";"no";0;0;0;57,333333;10,533333
1729;"Sæby";"no";0;0;0;57,333333;10,533333
1730;"Sæby";"no";0;0;0;57,333333;10,533333
1731;"Sæby";"no";0;0;0;57,333333;10,533333
1732;"Sæby";"no";0;0;0;57,333333;10,533333
1733;"Sæby";"no";0;0;0;57,333333;10,533333
1734;"Sæby";"no";0;0;0;57,333333;10,533333
1735;"Sæby";"no";0;0;0;57,333333;10,533333
1736;"Sæby";"no";0;0;0;57,333333;10,533333
1737;"Sæby";"no";0;0;0;57,333333;10,533333
1738;"Sæby";"no";0;0;0;57,333333;10,533333
1739;"Sæby";"no";0;0;0;57,333333;10,533333
1740;"Sæby";"no";0;0;0;57,333333;10,533333
1741;"Sæby";"no";0;0;0;57,333333;10,533333
1742;"Sæby";"no";0;0;0;57,333333;10,533333
1743;"Sæby";"no";0;0;0;57,333333;10,533333
1744;"Sæby";"no";0;0;0;57,333333;10,533333
1745;"Sæby";"no";0;0;0;57,333333;10,533333
1746;"Sæby";"no";0;0;0;57,333333;10,533333
1747;"Sæby";"no";0;0;0;57,333333;10,533333
1748;"Sæby";"no";0;0;0;57,333333;10,533333
1749;"Sæby";"no";0;0;0;57,333333;10,533333
1750;"Sæby";"no";0;0;0;57,333333;10,533333
1751;"Sæby";"no";0;0;0;57,333333;10,533333
1752;"Sæby";"no";0;0;0;57,333333;10,533333
1753;"Sæby";"no";0;0;0;57,333333;10,533333
1754;"Sæby";"no";0;0;0;57,333333;10,533333
1755;"Sæby";"no";0;1;1;57,333333;10,533333
1756;"Sæby";"no";0;0;0;57,333333;10,533333
1757;"Sæby";"no";0;0;0;57,333333;10,533333
1758;"Sæby";"no";0;0;0;57,333333;10,533333
1759;"Sæby";"no";0;0;0;57,333333;10,533333
1760;"Sæby";"no";0;0;0;57,333333;10,533333
1761;"Sæby";"no";0;0;0;57,333333;10,533333
1762;"Sæby";"no";0;0;0;57,333333;10,533333
1763;"Sæby";"no";0;1;1;57,333333;10,533333
1764;"Sæby";"no";0;0;0;57,333333;10,533333
1765;"Sæby";"no";0;0;0;57,333333;10,533333
1766;"Sæby";"no";0;0;0;57,333333;10,533333
1767;"Sæby";"no";0;0;0;57,333333;10,533333
1768;"Sæby";"no";1;0;1;57,333333;10,533333
1769;"Sæby";"no";0;1;1;57,333333;10,533333
1770;"Sæby";"no";0;0;0;57,333333;10,533333
1771;"Sæby";"no";0;0;0;57,333333;10,533333
1772;"Sæby";"no";0;0;0;57,333333;10,533333
1773;"Sæby";"no";0;0;0;57,333333;10,533333
1774;"Sæby";"no";0;0;0;57,333333;10,533333
1775;"Sæby";"no";0;0;0;57,333333;10,533333
1776;"Sæby";"no";0;0;0;57,333333;10,533333
1777;"Sæby";"no";0;0;0;57,333333;10,533333
1778;"Sæby";"no";0;0;0;57,333333;10,533333
1779;"Sæby";"no";0;0;0;57,333333;10,533333
1780;"Sæby";"no";0;0;0;57,333333;10,533333
1781;"Sæby";"no";0;0;0;57,333333;10,533333
1782;"Sæby";"no";0;0;0;57,333333;10,533333
1783;"Sæby";"no";0;0;0;57,333333;10,533333
1784;"Sæby";"no";0;0;0;57,333333;10,533333
1785;"Sæby";"no";0;0;0;57,333333;10,533333
1786;"Sæby";"no";0;1;1;57,333333;10,533333
1787;"Sæby";"no";0;0;0;57,333333;10,533333
1788;"Sæby";"no";0;0;0;57,333333;10,533333
1789;"Sæby";"no";0;0;0;57,333333;10,533333
1790;"Sæby";"no";0;0;0;57,333333;10,533333
1791;"Sæby";"no";0;0;0;57,333333;10,533333
1792;"Sæby";"no";0;1;1;57,333333;10,533333
1793;"Sæby";"no";0;0;0;57,333333;10,533333
1794;"Sæby";"no";0;0;0;57,333333;10,533333
1795;"Sæby";"no";0;0;0;57,333333;10,533333
1796;"Sæby";"no";0;0;0;57,333333;10,533333
1797;"Sæby";"no";0;0;0;57,333333;10,533333
1798;"Sæby";"no";0;0;0;57,333333;10,533333
1799;"Sæby";"no";0;0;0;57,333333;10,533333
1800;"Sæby";"no";0;0;0;57,333333;10,533333
1801;"Sæby";"no";0;0;0;57,333333;10,533333
1802;"Sæby";"no";0;0;0;57,333333;10,533333
1803;"Sæby";"no";0;0;0;57,333333;10,533333
1804;"Sæby";"no";0;0;0;57,333333;10,533333
1805;"Sæby";"no";0;0;0;57,333333;10,533333
1806;"Sæby";"no";0;0;0;57,333333;10,533333
1807;"Sæby";"no";0;0;0;57,333333;10,533333
1808;"Sæby";"no";0;0;0;57,333333;10,533333
1809;"Sæby";"no";0;0;0;57,333333;10,533333
1810;"Sæby";"no";0;0;0;57,333333;10,533333
1811;"Sæby";"no";0;0;0;57,333333;10,533333
1812;"Sæby";"no";0;0;0;57,333333;10,533333
1813;"Sæby";"no";0;0;0;57,333333;10,533333
1814;"Sæby";"no";0;0;0;57,333333;10,533333
1815;"Sæby";"no";0;0;0;57,333333;10,533333
1816;"Sæby";"no";0;0;0;57,333333;10,533333
1817;"Sæby";"no";0;0;0;57,333333;10,533333
1818;"Sæby";"no";0;0;0;57,333333;10,533333
1819;"Sæby";"no";1;1;2;57,333333;10,533333
1820;"Sæby";"no";0;0;0;57,333333;10,533333
1821;"Sæby";"no";0;0;0;57,333333;10,533333
1822;"Sæby";"no";0;0;0;57,333333;10,533333
1823;"Sæby";"no";0;0;0;57,333333;10,533333
1824;"Sæby";"no";0;0;0;57,333333;10,533333
1825;"Sæby";"no";0;0;0;57,333333;10,533333
1826;"Sæby";"no";0;0;0;57,333333;10,533333
1827;"Sæby";"no";0;0;0;57,333333;10,533333
1828;"Sæby";"no";0;0;0;57,333333;10,533333
1829;"Sæby";"no";0;0;0;57,333333;10,533333
1830;"Sæby";"no";0;0;0;57,333333;10,533333
1831;"Sæby";"no";1;0;1;57,333333;10,533333
1832;"Sæby";"no";0;0;0;57,333333;10,533333
1833;"Sæby";"no";0;0;0;57,333333;10,533333
1834;"Sæby";"no";0;0;0;57,333333;10,533333
1835;"Sæby";"no";0;0;0;57,333333;10,533333
1836;"Sæby";"no";0;0;0;57,333333;10,533333
1837;"Sæby";"no";0;0;0;57,333333;10,533333
1838;"Sæby";"no";0;0;0;57,333333;10,533333
1839;"Sæby";"no";0;0;0;57,333333;10,533333
1840;"Sæby";"no";0;0;0;57,333333;10,533333
1841;"Sæby";"no";0;0;0;57,333333;10,533333
1842;"Sæby";"no";0;0;0;57,333333;10,533333
1843;"Sæby";"no";0;0;0;57,333333;10,533333
1844;"Sæby";"no";5;0;5;57,333333;10,533333
1845;"Sæby";"no";0;0;0;57,333333;10,533333
1846;"Sæby";"no";0;0;0;57,333333;10,533333
1847;"Sæby";"no";2;0;2;57,333333;10,533333
1848;"Sæby";"no";0;0;0;57,333333;10,533333
1849;"Sæby";"no";0;0;0;57,333333;10,533333
1850;"Sæby";"no";0;0;0;57,333333;10,533333
1851;"Sæby";"no";2;3;5;57,333333;10,533333
1852;"Sæby";"no";2;0;2;57,333333;10,533333
1853;"Sæby";"no";3;2;5;57,333333;10,533333
1854;"Sæby";"no";1;0;1;57,333333;10,533333
1855;"Sæby";"no";1;3;4;57,333333;10,533333
1856;"Sæby";"no";0;0;0;57,333333;10,533333
1857;"Sæby";"no";0;0;0;57,333333;10,533333
1634;"Vordingborg";"no";0;0;0;55,007777;11,910555
1635;"Vordingborg";"no";3;0;3;55,007777;11,910555
1636;"Vordingborg";"no";1;0;1;55,007777;11,910555
1637;"Vordingborg";"no";0;0;0;55,007777;11,910555
1638;"Vordingborg";"no";2;0;2;55,007777;11,910555
1639;"Vordingborg";"no";2;0;2;55,007777;11,910555
1640;"Vordingborg";"no";0;0;0;55,007777;11,910555
1641;"Vordingborg";"no";1;0;1;55,007777;11,910555
1642;"Vordingborg";"no";0;0;0;55,007777;11,910555
1643;"Vordingborg";"no";0;0;0;55,007777;11,910555
1644;"Vordingborg";"no";0;0;0;55,007777;11,910555
1645;"Vordingborg";"no";0;0;0;55,007777;11,910555
1646;"Vordingborg";"no";0;0;0;55,007777;11,910555
1647;"Vordingborg";"no";1;0;1;55,007777;11,910555
1648;"Vordingborg";"no";0;0;0;55,007777;11,910555
1649;"Vordingborg";"no";1;0;1;55,007777;11,910555
1650;"Vordingborg";"no";0;0;0;55,007777;11,910555
1651;"Vordingborg";"no";1;1;2;55,007777;11,910555
1652;"Vordingborg";"no";0;0;0;55,007777;11,910555
1653;"Vordingborg";"no";0;0;0;55,007777;11,910555
1654;"Vordingborg";"no";0;0;0;55,007777;11,910555
1655;"Vordingborg";"no";0;0;0;55,007777;11,910555
1656;"Vordingborg";"no";0;0;0;55,007777;11,910555
1657;"Vordingborg";"no";0;0;0;55,007777;11,910555
1658;"Vordingborg";"no";0;0;0;55,007777;11,910555
1659;"Vordingborg";"no";0;0;0;55,007777;11,910555
1660;"Vordingborg";"no";0;0;0;55,007777;11,910555
1661;"Vordingborg";"no";0;0;0;55,007777;11,910555
1662;"Vordingborg";"no";0;0;0;55,007777;11,910555
1663;"Vordingborg";"no";1;0;1;55,007777;11,910555
1664;"Vordingborg";"no";1;1;2;55,007777;11,910555
1665;"Vordingborg";"no";1;1;2;55,007777;11,910555
1666;"Vordingborg";"no";0;0;0;55,007777;11,910555
1667;"Vordingborg";"no";0;0;0;55,007777;11,910555
1668;"Vordingborg";"no";2;0;2;55,007777;11,910555
1669;"Vordingborg";"no";1;1;2;55,007777;11,910555
1670;"Vordingborg";"no";1;0;1;55,007777;11,910555
1671;"Vordingborg";"no";2;1;3;55,007777;11,910555
1672;"Vordingborg";"no";1;2;3;55,007777;11,910555
1673;"Vordingborg";"no";1;1;2;55,007777;11,910555
1674;"Vordingborg";"no";0;0;0;55,007777;11,910555
1675;"Vordingborg";"no";0;0;0;55,007777;11,910555
1676;"Vordingborg";"no";0;0;0;55,007777;11,910555
1677;"Vordingborg";"no";0;0;0;55,007777;11,910555
1678;"Vordingborg";"no";1;0;1;55,007777;11,910555
1679;"Vordingborg";"no";0;0;0;55,007777;11,910555
1680;"Vordingborg";"no";1;0;1;55,007777;11,910555
1681;"Vordingborg";"no";1;0;1;55,007777;11,910555
1682;"Vordingborg";"no";0;0;0;55,007777;11,910555
1683;"Vordingborg";"no";0;0;0;55,007777;11,910555
1684;"Vordingborg";"no";0;0;0;55,007777;11,910555
1685;"Vordingborg";"no";0;0;0;55,007777;11,910555
1686;"Vordingborg";"no";0;0;0;55,007777;11,910555
1687;"Vordingborg";"no";0;1;1;55,007777;11,910555
1688;"Vordingborg";"no";0;0;0;55,007777;11,910555
1689;"Vordingborg";"no";0;0;0;55,007777;11,910555
1690;"Vordingborg";"no";0;0;0;55,007777;11,910555
1691;"Vordingborg";"no";1;0;1;55,007777;11,910555
1692;"Vordingborg";"no";0;0;0;55,007777;11,910555
1693;"Vordingborg";"no";0;0;0;55,007777;11,910555
1694;"Vordingborg";"no";2;0;2;55,007777;11,910555
1695;"Vordingborg";"no";2;1;3;55,007777;11,910555
1696;"Vordingborg";"no";2;0;2;55,007777;11,910555
1697;"Vordingborg";"no";0;2;2;55,007777;11,910555
1698;"Vordingborg";"no";0;1;1;55,007777;11,910555
1699;"Vordingborg";"no";0;0;0;55,007777;11,910555
1700;"Vordingborg";"no";0;0;0;55,007777;11,910555
1701;"Vordingborg";"no";0;0;0;55,007777;11,910555
1702;"Vordingborg";"no";1;1;2;55,007777;11,910555
1703;"Vordingborg";"no";0;0;0;55,007777;11,910555
1704;"Vordingborg";"no";0;0;0;55,007777;11,910555
1705;"Vordingborg";"no";1;1;2;55,007777;11,910555
1706;"Vordingborg";"no";0;0;0;55,007777;11,910555
1707;"Vordingborg";"no";0;0;0;55,007777;11,910555
1708;"Vordingborg";"no";0;0;0;55,007777;11,910555
1709;"Vordingborg";"no";0;1;1;55,007777;11,910555
1710;"Vordingborg";"no";0;0;0;55,007777;11,910555
1711;"Vordingborg";"no";0;0;0;55,007777;11,910555
1712;"Vordingborg";"no";0;0;0;55,007777;11,910555
1713;"Vordingborg";"no";0;0;0;55,007777;11,910555
1714;"Vordingborg";"no";0;0;0;55,007777;11,910555
1715;"Vordingborg";"no";0;0;0;55,007777;11,910555
1716;"Vordingborg";"no";0;0;0;55,007777;11,910555
1717;"Vordingborg";"no";0;0;0;55,007777;11,910555
1718;"Vordingborg";"no";0;0;0;55,007777;11,910555
1719;"Vordingborg";"no";0;0;0;55,007777;11,910555
1720;"Vordingborg";"no";0;0;0;55,007777;11,910555
1721;"Vordingborg";"no";0;0;0;55,007777;11,910555
1722;"Vordingborg";"no";0;0;0;55,007777;11,910555
1723;"Vordingborg";"no";0;0;0;55,007777;11,910555
1724;"Vordingborg";"no";0;0;0;55,007777;11,910555
1725;"Vordingborg";"no";0;0;0;55,007777;11,910555
1726;"Vordingborg";"no";0;1;1;55,007777;11,910555
1727;"Vordingborg";"no";0;0;0;55,007777;11,910555
1728;"Vordingborg";"no";0;0;0;55,007777;11,910555
1729;"Vordingborg";"no";0;0;0;55,007777;11,910555
1730;"Vordingborg";"no";2;0;2;55,007777;11,910555
1731;"Vordingborg";"no";2;0;2;55,007777;11,910555
1732;"Vordingborg";"no";0;0;0;55,007777;11,910555
1733;"Vordingborg";"no";0;0;0;55,007777;11,910555
1734;"Vordingborg";"no";0;0;0;55,007777;11,910555
1735;"Vordingborg";"no";0;0;0;55,007777;11,910555
1736;"Vordingborg";"no";0;0;0;55,007777;11,910555
1737;"Vordingborg";"no";0;1;1;55,007777;11,910555
1738;"Vordingborg";"no";0;0;0;55,007777;11,910555
1739;"Vordingborg";"no";0;0;0;55,007777;11,910555
1740;"Vordingborg";"no";0;1;1;55,007777;11,910555
1741;"Vordingborg";"no";0;1;1;55,007777;11,910555
1742;"Vordingborg";"no";0;0;0;55,007777;11,910555
1743;"Vordingborg";"no";2;1;3;55,007777;11,910555
1744;"Vordingborg";"no";0;0;0;55,007777;11,910555
1745;"Vordingborg";"no";0;0;0;55,007777;11,910555
1746;"Vordingborg";"no";0;0;0;55,007777;11,910555
1747;"Vordingborg";"no";0;0;0;55,007777;11,910555
1748;"Vordingborg";"no";2;0;2;55,007777;11,910555
1749;"Vordingborg";"no";1;0;1;55,007777;11,910555
1750;"Vordingborg";"no";0;1;1;55,007777;11,910555
1751;"Vordingborg";"no";1;0;1;55,007777;11,910555
1752;"Vordingborg";"no";0;1;1;55,007777;11,910555
1753;"Vordingborg";"no";0;1;1;55,007777;11,910555
1754;"Vordingborg";"no";3;3;6;55,007777;11,910555
1755;"Vordingborg";"no";6;0;6;55,007777;11,910555
1756;"Vordingborg";"no";1;0;1;55,007777;11,910555
1757;"Vordingborg";"no";2;3;5;55,007777;11,910555
1758;"Vordingborg";"no";0;1;1;55,007777;11,910555
1759;"Vordingborg";"no";2;1;3;55,007777;11,910555
1760;"Vordingborg";"no";0;1;1;55,007777;11,910555
1761;"Vordingborg";"no";3;1;4;55,007777;11,910555
1762;"Vordingborg";"no";0;0;0;55,007777;11,910555
1763;"Vordingborg";"no";0;0;0;55,007777;11,910555
1764;"Vordingborg";"no";0;1;1;55,007777;11,910555
1765;"Vordingborg";"no";0;0;0;55,007777;11,910555
1766;"Vordingborg";"no";1;1;2;55,007777;11,910555
1767;"Vordingborg";"no";0;0;0;55,007777;11,910555
1768;"Vordingborg";"no";0;0;0;55,007777;11,910555
1769;"Vordingborg";"no";0;0;0;55,007777;11,910555
1770;"Vordingborg";"no";1;0;1;55,007777;11,910555
1771;"Vordingborg";"no";0;0;0;55,007777;11,910555
1772;"Vordingborg";"no";1;0;1;55,007777;11,910555
1773;"Vordingborg";"no";0;0;0;55,007777;11,910555
1774;"Vordingborg";"no";0;0;0;55,007777;11,910555
1775;"Vordingborg";"no";0;1;1;55,007777;11,910555
1776;"Vordingborg";"no";1;3;4;55,007777;11,910555
1777;"Vordingborg";"no";1;3;4;55,007777;11,910555
1778;"Vordingborg";"no";2;1;3;55,007777;11,910555
1779;"Vordingborg";"no";0;0;0;55,007777;11,910555
1780;"Vordingborg";"no";1;0;1;55,007777;11,910555
1781;"Vordingborg";"no";0;0;0;55,007777;11,910555
1782;"Vordingborg";"no";1;1;2;55,007777;11,910555
1783;"Vordingborg";"no";1;0;1;55,007777;11,910555
1784;"Vordingborg";"no";1;0;1;55,007777;11,910555
1785;"Vordingborg";"no";2;0;2;55,007777;11,910555
1786;"Vordingborg";"no";0;0;0;55,007777;11,910555
1787;"Vordingborg";"no";0;1;1;55,007777;11,910555
1788;"Vordingborg";"no";2;1;3;55,007777;11,910555
1789;"Vordingborg";"no";1;2;3;55,007777;11,910555
1790;"Vordingborg";"no";1;0;1;55,007777;11,910555
1791;"Vordingborg";"no";2;0;2;55,007777;11,910555
1792;"Vordingborg";"no";3;2;5;55,007777;11,910555
1793;"Vordingborg";"no";4;2;6;55,007777;11,910555
1794;"Vordingborg";"no";2;3;5;55,007777;11,910555
1795;"Vordingborg";"no";0;0;0;55,007777;11,910555
1796;"Vordingborg";"no";2;0;2;55,007777;11,910555
1797;"Vordingborg";"no";1;0;1;55,007777;11,910555
1798;"Vordingborg";"no";1;1;2;55,007777;11,910555
1799;"Vordingborg";"no";1;0;1;55,007777;11,910555
1800;"Vordingborg";"no";3;0;3;55,007777;11,910555
1801;"Vordingborg";"no";0;1;1;55,007777;11,910555
1802;"Vordingborg";"no";0;0;0;55,007777;11,910555
1803;"Vordingborg";"no";1;1;2;55,007777;11,910555
1804;"Vordingborg";"no";1;0;1;55,007777;11,910555
1805;"Vordingborg";"no";1;1;2;55,007777;11,910555
1806;"Vordingborg";"no";0;1;1;55,007777;11,910555
1807;"Vordingborg";"no";0;0;0;55,007777;11,910555
1808;"Vordingborg";"no";0;0;0;55,007777;11,910555
1809;"Vordingborg";"no";0;0;0;55,007777;11,910555
1810;"Vordingborg";"no";1;0;1;55,007777;11,910555
1811;"Vordingborg";"no";0;1;1;55,007777;11,910555
1812;"Vordingborg";"no";0;0;0;55,007777;11,910555
1813;"Vordingborg";"no";0;0;0;55,007777;11,910555
1814;"Vordingborg";"no";1;1;2;55,007777;11,910555
1815;"Vordingborg";"no";0;2;2;55,007777;11,910555
1816;"Vordingborg";"no";2;1;3;55,007777;11,910555
1817;"Vordingborg";"no";2;4;6;55,007777;11,910555
1818;"Vordingborg";"no";2;1;3;55,007777;11,910555
1819;"Vordingborg";"no";1;1;2;55,007777;11,910555
1820;"Vordingborg";"no";2;4;6;55,007777;11,910555
1821;"Vordingborg";"no";5;2;7;55,007777;11,910555
1822;"Vordingborg";"no";3;4;7;55,007777;11,910555
1823;"Vordingborg";"no";6;3;9;55,007777;11,910555
1824;"Vordingborg";"no";4;0;4;55,007777;11,910555
1825;"Vordingborg";"no";7;1;8;55,007777;11,910555
1826;"Vordingborg";"no";7;1;8;55,007777;11,910555
1827;"Vordingborg";"no";8;4;12;55,007777;11,910555
1828;"Vordingborg";"no";6;2;8;55,007777;11,910555
1829;"Vordingborg";"no";5;2;7;55,007777;11,910555
1830;"Vordingborg";"no";5;4;9;55,007777;11,910555
1831;"Vordingborg";"no";4;1;5;55,007777;11,910555
1832;"Vordingborg";"no";4;2;6;55,007777;11,910555
1833;"Vordingborg";"no";2;7;9;55,007777;11,910555
1834;"Vordingborg";"no";1;1;2;55,007777;11,910555
1835;"Vordingborg";"no";3;3;6;55,007777;11,910555
1836;"Vordingborg";"no";0;0;0;55,007777;11,910555
1837;"Vordingborg";"no";2;1;3;55,007777;11,910555
1838;"Vordingborg";"no";2;4;6;55,007777;11,910555
1839;"Vordingborg";"no";0;2;2;55,007777;11,910555
1840;"Vordingborg";"no";3;5;8;55,007777;11,910555
1841;"Vordingborg";"no";2;3;5;55,007777;11,910555
1842;"Vordingborg";"no";1;2;3;55,007777;11,910555
1843;"Vordingborg";"no";1;1;2;55,007777;11,910555
1844;"Vordingborg";"no";2;0;2;55,007777;11,910555
1845;"Vordingborg";"no";3;0;3;55,007777;11,910555
1846;"Vordingborg";"no";2;2;4;55,007777;11,910555
1847;"Vordingborg";"no";1;2;3;55,007777;11,910555
1848;"Vordingborg";"no";5;3;8;55,007777;11,910555
1849;"Vordingborg";"no";5;1;6;55,007777;11,910555
1850;"Vordingborg";"no";5;1;6;55,007777;11,910555
1851;"Vordingborg";"no";1;4;5;55,007777;11,910555
1852;"Vordingborg";"no";5;4;9;55,007777;11,910555
1853;"Vordingborg";"no";3;2;5;55,007777;11,910555
1854;"Vordingborg";"no";5;3;8;55,007777;11,910555
1855;"Vordingborg";"no";7;4;11;55,007777;11,910555
1856;"Vordingborg";"no";5;3;8;55,007777;11,910555
1857;"Vordingborg";"no";0;0;0;55,007777;11,910555
1634;"Assens";"no";0;0;0;55,27;9,900555
1635;"Assens";"no";0;0;0;55,27;9,900555
1636;"Assens";"no";1;0;1;55,27;9,900555
1637;"Assens";"no";0;0;0;55,27;9,900555
1638;"Assens";"no";0;0;0;55,27;9,900555
1639;"Assens";"no";0;0;0;55,27;9,900555
1640;"Assens";"no";0;0;0;55,27;9,900555
1641;"Assens";"no";1;0;1;55,27;9,900555
1642;"Assens";"no";0;0;0;55,27;9,900555
1643;"Assens";"no";0;0;0;55,27;9,900555
1644;"Assens";"no";0;0;0;55,27;9,900555
1645;"Assens";"no";0;0;0;55,27;9,900555
1646;"Assens";"no";0;0;0;55,27;9,900555
1647;"Assens";"no";0;0;0;55,27;9,900555
1648;"Assens";"no";0;0;0;55,27;9,900555
1649;"Assens";"no";0;0;0;55,27;9,900555
1650;"Assens";"no";0;0;0;55,27;9,900555
1651;"Assens";"no";0;1;1;55,27;9,900555
1652;"Assens";"no";0;0;0;55,27;9,900555
1653;"Assens";"no";0;0;0;55,27;9,900555
1654;"Assens";"no";0;0;0;55,27;9,900555
1655;"Assens";"no";0;0;0;55,27;9,900555
1656;"Assens";"no";0;0;0;55,27;9,900555
1657;"Assens";"no";0;0;0;55,27;9,900555
1658;"Assens";"no";0;0;0;55,27;9,900555
1659;"Assens";"no";0;0;0;55,27;9,900555
1660;"Assens";"no";0;0;0;55,27;9,900555
1661;"Assens";"no";0;0;0;55,27;9,900555
1662;"Assens";"no";0;0;0;55,27;9,900555
1663;"Assens";"no";0;0;0;55,27;9,900555
1664;"Assens";"no";0;0;0;55,27;9,900555
1665;"Assens";"no";0;0;0;55,27;9,900555
1666;"Assens";"no";0;0;0;55,27;9,900555
1667;"Assens";"no";0;0;0;55,27;9,900555
1668;"Assens";"no";0;0;0;55,27;9,900555
1669;"Assens";"no";0;0;0;55,27;9,900555
1670;"Assens";"no";0;0;0;55,27;9,900555
1671;"Assens";"no";0;0;0;55,27;9,900555
1672;"Assens";"no";0;0;0;55,27;9,900555
1673;"Assens";"no";0;0;0;55,27;9,900555
1674;"Assens";"no";0;0;0;55,27;9,900555
1675;"Assens";"no";0;0;0;55,27;9,900555
1676;"Assens";"no";0;0;0;55,27;9,900555
1677;"Assens";"no";0;0;0;55,27;9,900555
1678;"Assens";"no";0;0;0;55,27;9,900555
1679;"Assens";"no";0;0;0;55,27;9,900555
1680;"Assens";"no";0;0;0;55,27;9,900555
1681;"Assens";"no";0;1;1;55,27;9,900555
1682;"Assens";"no";0;0;0;55,27;9,900555
1683;"Assens";"no";0;0;0;55,27;9,900555
1684;"Assens";"no";0;0;0;55,27;9,900555
1685;"Assens";"no";0;0;0;55,27;9,900555
1686;"Assens";"no";0;0;0;55,27;9,900555
1687;"Assens";"no";0;0;0;55,27;9,900555
1688;"Assens";"no";0;0;0;55,27;9,900555
1689;"Assens";"no";0;0;0;55,27;9,900555
1690;"Assens";"no";0;0;0;55,27;9,900555
1691;"Assens";"no";0;0;0;55,27;9,900555
1692;"Assens";"no";0;0;0;55,27;9,900555
1693;"Assens";"no";0;0;0;55,27;9,900555
1694;"Assens";"no";0;0;0;55,27;9,900555
1695;"Assens";"no";0;0;0;55,27;9,900555
1696;"Assens";"no";0;0;0;55,27;9,900555
1697;"Assens";"no";0;0;0;55,27;9,900555
1698;"Assens";"no";0;0;0;55,27;9,900555
1699;"Assens";"no";0;0;0;55,27;9,900555
1700;"Assens";"no";0;0;0;55,27;9,900555
1701;"Assens";"no";0;0;0;55,27;9,900555
1702;"Assens";"no";0;0;0;55,27;9,900555
1703;"Assens";"no";0;0;0;55,27;9,900555
1704;"Assens";"no";0;0;0;55,27;9,900555
1705;"Assens";"no";0;0;0;55,27;9,900555
1706;"Assens";"no";0;0;0;55,27;9,900555
1707;"Assens";"no";0;0;0;55,27;9,900555
1708;"Assens";"no";0;0;0;55,27;9,900555
1709;"Assens";"no";0;0;0;55,27;9,900555
1710;"Assens";"no";0;0;0;55,27;9,900555
1711;"Assens";"no";0;0;0;55,27;9,900555
1712;"Assens";"no";0;0;0;55,27;9,900555
1713;"Assens";"no";0;0;0;55,27;9,900555
1714;"Assens";"no";0;0;0;55,27;9,900555
1715;"Assens";"no";0;0;0;55,27;9,900555
1716;"Assens";"no";0;0;0;55,27;9,900555
1717;"Assens";"no";0;0;0;55,27;9,900555
1718;"Assens";"no";0;0;0;55,27;9,900555
1719;"Assens";"no";0;0;0;55,27;9,900555
1720;"Assens";"no";0;0;0;55,27;9,900555
1721;"Assens";"no";0;0;0;55,27;9,900555
1722;"Assens";"no";0;0;0;55,27;9,900555
1723;"Assens";"no";0;0;0;55,27;9,900555
1724;"Assens";"no";0;0;0;55,27;9,900555
1725;"Assens";"no";0;0;0;55,27;9,900555
1726;"Assens";"no";0;0;0;55,27;9,900555
1727;"Assens";"no";0;0;0;55,27;9,900555
1728;"Assens";"no";0;0;0;55,27;9,900555
1729;"Assens";"no";0;0;0;55,27;9,900555
1730;"Assens";"no";0;0;0;55,27;9,900555
1731;"Assens";"no";0;0;0;55,27;9,900555
1732;"Assens";"no";0;0;0;55,27;9,900555
1733;"Assens";"no";0;0;0;55,27;9,900555
1734;"Assens";"no";0;0;0;55,27;9,900555
1735;"Assens";"no";0;0;0;55,27;9,900555
1736;"Assens";"no";0;0;0;55,27;9,900555
1737;"Assens";"no";0;0;0;55,27;9,900555
1738;"Assens";"no";0;0;0;55,27;9,900555
1739;"Assens";"no";0;0;0;55,27;9,900555
1740;"Assens";"no";0;0;0;55,27;9,900555
1741;"Assens";"no";0;0;0;55,27;9,900555
1742;"Assens";"no";0;0;0;55,27;9,900555
1743;"Assens";"no";0;0;0;55,27;9,900555
1744;"Assens";"no";0;0;0;55,27;9,900555
1745;"Assens";"no";0;0;0;55,27;9,900555
1746;"Assens";"no";0;0;0;55,27;9,900555
1747;"Assens";"no";0;0;0;55,27;9,900555
1748;"Assens";"no";0;0;0;55,27;9,900555
1749;"Assens";"no";0;0;0;55,27;9,900555
1750;"Assens";"no";0;0;0;55,27;9,900555
1751;"Assens";"no";0;0;0;55,27;9,900555
1752;"Assens";"no";0;0;0;55,27;9,900555
1753;"Assens";"no";0;0;0;55,27;9,900555
1754;"Assens";"no";0;1;1;55,27;9,900555
1755;"Assens";"no";0;0;0;55,27;9,900555
1756;"Assens";"no";0;0;0;55,27;9,900555
1757;"Assens";"no";0;0;0;55,27;9,900555
1758;"Assens";"no";0;0;0;55,27;9,900555
1759;"Assens";"no";0;0;0;55,27;9,900555
1760;"Assens";"no";0;0;0;55,27;9,900555
1761;"Assens";"no";0;0;0;55,27;9,900555
1762;"Assens";"no";0;0;0;55,27;9,900555
1763;"Assens";"no";0;0;0;55,27;9,900555
1764;"Assens";"no";0;0;0;55,27;9,900555
1765;"Assens";"no";0;0;0;55,27;9,900555
1766;"Assens";"no";0;0;0;55,27;9,900555
1767;"Assens";"no";0;0;0;55,27;9,900555
1768;"Assens";"no";0;0;0;55,27;9,900555
1769;"Assens";"no";0;0;0;55,27;9,900555
1770;"Assens";"no";0;0;0;55,27;9,900555
1771;"Assens";"no";0;0;0;55,27;9,900555
1772;"Assens";"no";0;0;0;55,27;9,900555
1773;"Assens";"no";0;0;0;55,27;9,900555
1774;"Assens";"no";0;0;0;55,27;9,900555
1775;"Assens";"no";0;0;0;55,27;9,900555
1776;"Assens";"no";0;0;0;55,27;9,900555
1777;"Assens";"no";0;0;0;55,27;9,900555
1778;"Assens";"no";0;0;0;55,27;9,900555
1779;"Assens";"no";0;0;0;55,27;9,900555
1780;"Assens";"no";0;1;1;55,27;9,900555
1781;"Assens";"no";0;0;0;55,27;9,900555
1782;"Assens";"no";0;0;0;55,27;9,900555
1783;"Assens";"no";0;0;0;55,27;9,900555
1784;"Assens";"no";0;0;0;55,27;9,900555
1785;"Assens";"no";0;0;0;55,27;9,900555
1786;"Assens";"no";0;0;0;55,27;9,900555
1787;"Assens";"no";0;0;0;55,27;9,900555
1788;"Assens";"no";0;0;0;55,27;9,900555
1789;"Assens";"no";0;0;0;55,27;9,900555
1790;"Assens";"no";0;0;0;55,27;9,900555
1791;"Assens";"no";0;0;0;55,27;9,900555
1792;"Assens";"no";0;1;1;55,27;9,900555
1793;"Assens";"no";0;1;1;55,27;9,900555
1794;"Assens";"no";0;1;1;55,27;9,900555
1795;"Assens";"no";0;0;0;55,27;9,900555
1796;"Assens";"no";0;0;0;55,27;9,900555
1797;"Assens";"no";0;0;0;55,27;9,900555
1798;"Assens";"no";0;0;0;55,27;9,900555
1799;"Assens";"no";0;0;0;55,27;9,900555
1800;"Assens";"no";0;0;0;55,27;9,900555
1801;"Assens";"no";1;0;1;55,27;9,900555
1802;"Assens";"no";0;0;0;55,27;9,900555
1803;"Assens";"no";0;0;0;55,27;9,900555
1804;"Assens";"no";0;0;0;55,27;9,900555
1805;"Assens";"no";0;1;1;55,27;9,900555
1806;"Assens";"no";0;0;0;55,27;9,900555
1807;"Assens";"no";0;0;0;55,27;9,900555
1808;"Assens";"no";0;0;0;55,27;9,900555
1809;"Assens";"no";0;0;0;55,27;9,900555
1810;"Assens";"no";0;0;0;55,27;9,900555
1811;"Assens";"no";0;0;0;55,27;9,900555
1812;"Assens";"no";0;0;0;55,27;9,900555
1813;"Assens";"no";0;0;0;55,27;9,900555
1814;"Assens";"no";0;0;0;55,27;9,900555
1815;"Assens";"no";0;0;0;55,27;9,900555
1816;"Assens";"no";0;0;0;55,27;9,900555
1817;"Assens";"no";0;0;0;55,27;9,900555
1818;"Assens";"no";0;0;0;55,27;9,900555
1819;"Assens";"no";0;0;0;55,27;9,900555
1820;"Assens";"no";0;0;0;55,27;9,900555
1821;"Assens";"no";0;0;0;55,27;9,900555
1822;"Assens";"no";0;0;0;55,27;9,900555
1823;"Assens";"no";0;0;0;55,27;9,900555
1824;"Assens";"no";0;1;1;55,27;9,900555
1825;"Assens";"no";0;0;0;55,27;9,900555
1826;"Assens";"no";0;0;0;55,27;9,900555
1827;"Assens";"no";1;0;1;55,27;9,900555
1828;"Assens";"no";0;0;0;55,27;9,900555
1829;"Assens";"no";0;1;1;55,27;9,900555
1830;"Assens";"no";0;1;1;55,27;9,900555
1831;"Assens";"no";1;0;1;55,27;9,900555
1832;"Assens";"no";0;0;0;55,27;9,900555
1833;"Assens";"no";0;0;0;55,27;9,900555
1834;"Assens";"no";0;0;0;55,27;9,900555
1835;"Assens";"no";0;0;0;55,27;9,900555
1836;"Assens";"no";0;0;0;55,27;9,900555
1837;"Assens";"no";0;0;0;55,27;9,900555
1838;"Assens";"no";1;0;1;55,27;9,900555
1839;"Assens";"no";0;0;0;55,27;9,900555
1840;"Assens";"no";0;0;0;55,27;9,900555
1841;"Assens";"no";0;1;1;55,27;9,900555
1842;"Assens";"no";0;0;0;55,27;9,900555
1843;"Assens";"no";0;0;0;55,27;9,900555
1844;"Assens";"no";0;1;1;55,27;9,900555
1845;"Assens";"no";0;0;0;55,27;9,900555
1846;"Assens";"no";2;0;2;55,27;9,900555
1847;"Assens";"no";0;0;0;55,27;9,900555
1848;"Assens";"no";0;0;0;55,27;9,900555
1849;"Assens";"no";1;1;2;55,27;9,900555
1850;"Assens";"no";0;1;1;55,27;9,900555
1851;"Assens";"no";0;2;2;55,27;9,900555
1852;"Assens";"no";0;0;0;55,27;9,900555
1853;"Assens";"no";0;1;1;55,27;9,900555
1854;"Assens";"no";0;3;3;55,27;9,900555
1855;"Assens";"no";1;0;1;55,27;9,900555
1856;"Assens";"no";0;2;2;55,27;9,900555
1857;"Assens";"no";0;0;0;55,27;9,900555
1634;"Bornholm";"no";0;0;0;55,1;15
1635;"Bornholm";"no";0;1;1;55,1;15
1636;"Bornholm";"no";1;0;1;55,1;15
1637;"Bornholm";"no";0;0;0;55,1;15
1638;"Bornholm";"no";0;0;0;55,1;15
1639;"Bornholm";"no";1;0;1;55,1;15
1640;"Bornholm";"no";0;0;0;55,1;15
1641;"Bornholm";"no";0;0;0;55,1;15
1642;"Bornholm";"no";0;0;0;55,1;15
1643;"Bornholm";"no";0;0;0;55,1;15
1644;"Bornholm";"no";0;0;0;55,1;15
1645;"Bornholm";"no";0;0;0;55,1;15
1646;"Bornholm";"no";0;0;0;55,1;15
1647;"Bornholm";"no";0;0;0;55,1;15
1648;"Bornholm";"no";1;0;1;55,1;15
1649;"Bornholm";"no";0;0;0;55,1;15
1650;"Bornholm";"no";2;0;2;55,1;15
1651;"Bornholm";"no";1;0;1;55,1;15
1652;"Bornholm";"no";0;0;0;55,1;15
1653;"Bornholm";"no";0;0;0;55,1;15
1654;"Bornholm";"no";0;0;0;55,1;15
1655;"Bornholm";"no";0;0;0;55,1;15
1656;"Bornholm";"no";0;0;0;55,1;15
1657;"Bornholm";"no";0;0;0;55,1;15
1658;"Bornholm";"no";0;0;0;55,1;15
1659;"Bornholm";"no";0;0;0;55,1;15
1660;"Bornholm";"no";0;0;0;55,1;15
1661;"Bornholm";"no";0;0;0;55,1;15
1662;"Bornholm";"no";1;0;1;55,1;15
1663;"Bornholm";"no";0;0;0;55,1;15
1664;"Bornholm";"no";1;0;1;55,1;15
1665;"Bornholm";"no";0;0;0;55,1;15
1666;"Bornholm";"no";0;0;0;55,1;15
1667;"Bornholm";"no";0;0;0;55,1;15
1668;"Bornholm";"no";0;0;0;55,1;15
1669;"Bornholm";"no";0;0;0;55,1;15
1670;"Bornholm";"no";0;1;1;55,1;15
1671;"Bornholm";"no";0;0;0;55,1;15
1672;"Bornholm";"no";0;0;0;55,1;15
1673;"Bornholm";"no";0;0;0;55,1;15
1674;"Bornholm";"no";0;0;0;55,1;15
1675;"Bornholm";"no";0;0;0;55,1;15
1676;"Bornholm";"no";0;0;0;55,1;15
1677;"Bornholm";"no";0;0;0;55,1;15
1678;"Bornholm";"no";0;0;0;55,1;15
1679;"Bornholm";"no";0;0;0;55,1;15
1680;"Bornholm";"no";1;0;1;55,1;15
1681;"Bornholm";"no";0;0;0;55,1;15
1682;"Bornholm";"no";1;0;1;55,1;15
1683;"Bornholm";"no";0;0;0;55,1;15
1684;"Bornholm";"no";1;0;1;55,1;15
1685;"Bornholm";"no";0;1;1;55,1;15
1686;"Bornholm";"no";0;0;0;55,1;15
1687;"Bornholm";"no";0;0;0;55,1;15
1688;"Bornholm";"no";6;7;13;55,1;15
1689;"Bornholm";"no";0;0;0;55,1;15
1690;"Bornholm";"no";0;0;0;55,1;15
1691;"Bornholm";"no";0;0;0;55,1;15
1692;"Bornholm";"no";0;0;0;55,1;15
1693;"Bornholm";"no";0;0;0;55,1;15
1694;"Bornholm";"no";0;0;0;55,1;15
1695;"Bornholm";"no";0;0;0;55,1;15
1696;"Bornholm";"no";0;0;0;55,1;15
1697;"Bornholm";"no";0;0;0;55,1;15
1698;"Bornholm";"no";0;0;0;55,1;15
1699;"Bornholm";"no";0;0;0;55,1;15
1700;"Bornholm";"no";0;0;0;55,1;15
1701;"Bornholm";"no";0;0;0;55,1;15
1702;"Bornholm";"no";0;0;0;55,1;15
1703;"Bornholm";"no";0;0;0;55,1;15
1704;"Bornholm";"no";0;0;0;55,1;15
1705;"Bornholm";"no";0;0;0;55,1;15
1706;"Bornholm";"no";1;0;1;55,1;15
1707;"Bornholm";"no";0;0;0;55,1;15
1708;"Bornholm";"no";0;0;0;55,1;15
1709;"Bornholm";"no";0;0;0;55,1;15
1710;"Bornholm";"no";0;0;0;55,1;15
1711;"Bornholm";"no";0;0;0;55,1;15
1712;"Bornholm";"no";1;1;2;55,1;15
1713;"Bornholm";"no";0;0;0;55,1;15
1714;"Bornholm";"no";0;0;0;55,1;15
1715;"Bornholm";"no";0;0;0;55,1;15
1716;"Bornholm";"no";0;0;0;55,1;15
1717;"Bornholm";"no";0;0;0;55,1;15
1718;"Bornholm";"no";0;0;0;55,1;15
1719;"Bornholm";"no";1;0;1;55,1;15
1720;"Bornholm";"no";1;1;2;55,1;15
1721;"Bornholm";"no";0;0;0;55,1;15
1722;"Bornholm";"no";0;0;0;55,1;15
1723;"Bornholm";"no";0;0;0;55,1;15
1724;"Bornholm";"no";0;0;0;55,1;15
1725;"Bornholm";"no";0;0;0;55,1;15
1726;"Bornholm";"no";0;0;0;55,1;15
1727;"Bornholm";"no";0;0;0;55,1;15
1728;"Bornholm";"no";0;0;0;55,1;15
1729;"Bornholm";"no";0;0;0;55,1;15
1730;"Bornholm";"no";0;0;0;55,1;15
1731;"Bornholm";"no";0;0;0;55,1;15
1732;"Bornholm";"no";3;0;3;55,1;15
1733;"Bornholm";"no";1;1;2;55,1;15
1734;"Bornholm";"no";2;1;3;55,1;15
1735;"Bornholm";"no";2;1;3;55,1;15
1736;"Bornholm";"no";3;2;5;55,1;15
1737;"Bornholm";"no";1;0;1;55,1;15
1738;"Bornholm";"no";0;0;0;55,1;15
1739;"Bornholm";"no";0;0;0;55,1;15
1740;"Bornholm";"no";0;0;0;55,1;15
1741;"Bornholm";"no";0;0;0;55,1;15
1742;"Bornholm";"no";0;0;0;55,1;15
1743;"Bornholm";"no";2;0;2;55,1;15
1744;"Bornholm";"no";0;0;0;55,1;15
1745;"Bornholm";"no";0;0;0;55,1;15
1746;"Bornholm";"no";1;0;1;55,1;15
1747;"Bornholm";"no";1;0;1;55,1;15
1748;"Bornholm";"no";0;0;0;55,1;15
1749;"Bornholm";"no";1;0;1;55,1;15
1750;"Bornholm";"no";1;1;2;55,1;15
1751;"Bornholm";"no";0;0;0;55,1;15
1752;"Bornholm";"no";1;1;2;55,1;15
1753;"Bornholm";"no";2;0;2;55,1;15
1754;"Bornholm";"no";2;0;2;55,1;15
1755;"Bornholm";"no";3;2;5;55,1;15
1756;"Bornholm";"no";0;0;0;55,1;15
1757;"Bornholm";"no";0;0;0;55,1;15
1758;"Bornholm";"no";2;0;2;55,1;15
1759;"Bornholm";"no";2;0;2;55,1;15
1760;"Bornholm";"no";1;0;1;55,1;15
1761;"Bornholm";"no";0;0;0;55,1;15
1762;"Bornholm";"no";0;0;0;55,1;15
1763;"Bornholm";"no";0;0;0;55,1;15
1764;"Bornholm";"no";0;1;1;55,1;15
1765;"Bornholm";"no";0;0;0;55,1;15
1766;"Bornholm";"no";1;1;2;55,1;15
1767;"Bornholm";"no";0;0;0;55,1;15
1768;"Bornholm";"no";1;1;2;55,1;15
1769;"Bornholm";"no";1;0;1;55,1;15
1770;"Bornholm";"no";0;0;0;55,1;15
1771;"Bornholm";"no";1;0;1;55,1;15
1772;"Bornholm";"no";1;0;1;55,1;15
1773;"Bornholm";"no";0;0;0;55,1;15
1774;"Bornholm";"no";2;1;3;55,1;15
1775;"Bornholm";"no";2;2;4;55,1;15
1776;"Bornholm";"no";2;2;4;55,1;15
1777;"Bornholm";"no";0;0;0;55,1;15
1778;"Bornholm";"no";0;1;1;55,1;15
1779;"Bornholm";"no";0;1;1;55,1;15
1780;"Bornholm";"no";1;3;4;55,1;15
1781;"Bornholm";"no";3;0;3;55,1;15
1782;"Bornholm";"no";2;0;2;55,1;15
1783;"Bornholm";"no";1;1;2;55,1;15
1784;"Bornholm";"no";1;0;1;55,1;15
1785;"Bornholm";"no";1;0;1;55,1;15
1786;"Bornholm";"no";1;1;2;55,1;15
1787;"Bornholm";"no";3;0;3;55,1;15
1788;"Bornholm";"no";3;0;3;55,1;15
1789;"Bornholm";"no";0;0;0;55,1;15
1790;"Bornholm";"no";1;0;1;55,1;15
1791;"Bornholm";"no";2;1;3;55,1;15
1792;"Bornholm";"no";2;3;5;55,1;15
1793;"Bornholm";"no";2;4;6;55,1;15
1794;"Bornholm";"no";4;3;7;55,1;15
1795;"Bornholm";"no";3;1;4;55,1;15
1796;"Bornholm";"no";2;1;3;55,1;15
1797;"Bornholm";"no";4;1;5;55,1;15
1798;"Bornholm";"no";2;0;2;55,1;15
1799;"Bornholm";"no";2;1;3;55,1;15
1800;"Bornholm";"no";4;1;5;55,1;15
1801;"Bornholm";"no";2;0;2;55,1;15
1802;"Bornholm";"no";5;1;6;55,1;15
1803;"Bornholm";"no";10;5;15;55,1;15
1804;"Bornholm";"no";5;0;5;55,1;15
1805;"Bornholm";"no";1;0;1;55,1;15
1806;"Bornholm";"no";4;2;6;55,1;15
1807;"Bornholm";"no";1;0;1;55,1;15
1808;"Bornholm";"no";0;0;0;55,1;15
1809;"Bornholm";"no";0;0;0;55,1;15
1810;"Bornholm";"no";0;0;0;55,1;15
1811;"Bornholm";"no";0;1;1;55,1;15
1812;"Bornholm";"no";0;1;1;55,1;15
1813;"Bornholm";"no";0;1;1;55,1;15
1814;"Bornholm";"no";0;0;0;55,1;15
1815;"Bornholm";"no";1;0;1;55,1;15
1816;"Bornholm";"no";0;1;1;55,1;15
1817;"Bornholm";"no";0;0;0;55,1;15
1818;"Bornholm";"no";0;0;0;55,1;15
1819;"Bornholm";"no";0;0;0;55,1;15
1820;"Bornholm";"no";1;0;1;55,1;15
1821;"Bornholm";"no";2;0;2;55,1;15
1822;"Bornholm";"no";4;0;4;55,1;15
1823;"Bornholm";"no";3;1;4;55,1;15
1824;"Bornholm";"no";10;1;11;55,1;15
1825;"Bornholm";"no";4;1;5;55,1;15
1826;"Bornholm";"no";6;0;6;55,1;15
1827;"Bornholm";"no";2;0;2;55,1;15
1828;"Bornholm";"no";1;0;1;55,1;15
1829;"Bornholm";"no";1;1;2;55,1;15
1830;"Bornholm";"no";1;1;2;55,1;15
1831;"Bornholm";"no";1;1;2;55,1;15
1832;"Bornholm";"no";6;1;7;55,1;15
1833;"Bornholm";"no";4;1;5;55,1;15
1834;"Bornholm";"no";4;1;5;55,1;15
1835;"Bornholm";"no";4;0;4;55,1;15
1836;"Bornholm";"no";4;1;5;55,1;15
1837;"Bornholm";"no";6;0;6;55,1;15
1838;"Bornholm";"no";8;0;8;55,1;15
1839;"Bornholm";"no";9;2;11;55,1;15
1840;"Bornholm";"no";10;1;11;55,1;15
1841;"Bornholm";"no";8;2;10;55,1;15
1842;"Bornholm";"no";7;1;8;55,1;15
1843;"Bornholm";"no";4;1;5;55,1;15
1844;"Bornholm";"no";10;1;11;55,1;15
1845;"Bornholm";"no";10;0;10;55,1;15
1846;"Bornholm";"no";12;1;13;55,1;15
1847;"Bornholm";"no";8;0;8;55,1;15
1848;"Bornholm";"no";9;2;11;55,1;15
1849;"Bornholm";"no";9;1;10;55,1;15
1850;"Bornholm";"no";15;0;15;55,1;15
1851;"Bornholm";"no";12;1;13;55,1;15
1852;"Bornholm";"no";0;0;0;55,1;15
1853;"Bornholm";"no";0;1;1;55,1;15
1854;"Bornholm";"no";0;1;1;55,1;15
1855;"Bornholm";"no";0;1;1;55,1;15
1856;"Bornholm";"no";0;0;0;55,1;15
1857;"Bornholm";"no";0;0;0;55,1;15
1634;"Lolland";"no";0;0;0;54,802222;11,295
1635;"Lolland";"no";0;3;3;54,802222;11,295
1636;"Lolland";"no";2;0;2;54,802222;11,295
1637;"Lolland";"no";0;0;0;54,802222;11,295
1638;"Lolland";"no";0;0;0;54,802222;11,295
1639;"Lolland";"no";0;0;0;54,802222;11,295
1640;"Lolland";"no";0;0;0;54,802222;11,295
1641;"Lolland";"no";0;0;0;54,802222;11,295
1642;"Lolland";"no";0;0;0;54,802222;11,295
1643;"Lolland";"no";0;0;0;54,802222;11,295
1644;"Lolland";"no";0;0;0;54,802222;11,295
1645;"Lolland";"no";0;0;0;54,802222;11,295
1646;"Lolland";"no";0;0;0;54,802222;11,295
1647;"Lolland";"no";0;0;0;54,802222;11,295
1648;"Lolland";"no";0;0;0;54,802222;11,295
1649;"Lolland";"no";0;0;0;54,802222;11,295
1650;"Lolland";"no";0;1;1;54,802222;11,295
1651;"Lolland";"no";0;0;0;54,802222;11,295
1652;"Lolland";"no";0;0;0;54,802222;11,295
1653;"Lolland";"no";0;0;0;54,802222;11,295
1654;"Lolland";"no";0;0;0;54,802222;11,295
1655;"Lolland";"no";0;0;0;54,802222;11,295
1656;"Lolland";"no";0;0;0;54,802222;11,295
1657;"Lolland";"no";0;0;0;54,802222;11,295
1658;"Lolland";"no";0;0;0;54,802222;11,295
1659;"Lolland";"no";0;0;0;54,802222;11,295
1660;"Lolland";"no";0;0;0;54,802222;11,295
1661;"Lolland";"no";0;0;0;54,802222;11,295
1662;"Lolland";"no";0;0;0;54,802222;11,295
1663;"Lolland";"no";0;0;0;54,802222;11,295
1664;"Lolland";"no";0;0;0;54,802222;11,295
1665;"Lolland";"no";0;0;0;54,802222;11,295
1666;"Lolland";"no";0;0;0;54,802222;11,295
1667;"Lolland";"no";0;0;0;54,802222;11,295
1668;"Lolland";"no";0;0;0;54,802222;11,295
1669;"Lolland";"no";1;1;2;54,802222;11,295
1670;"Lolland";"no";0;0;0;54,802222;11,295
1671;"Lolland";"no";0;0;0;54,802222;11,295
1672;"Lolland";"no";0;0;0;54,802222;11,295
1673;"Lolland";"no";0;3;3;54,802222;11,295
1674;"Lolland";"no";0;1;1;54,802222;11,295
1675;"Lolland";"no";0;0;0;54,802222;11,295
1676;"Lolland";"no";0;0;0;54,802222;11,295
1677;"Lolland";"no";0;0;0;54,802222;11,295
1678;"Lolland";"no";0;0;0;54,802222;11,295
1679;"Lolland";"no";0;0;0;54,802222;11,295
1680;"Lolland";"no";0;0;0;54,802222;11,295
1681;"Lolland";"no";0;0;0;54,802222;11,295
1682;"Lolland";"no";0;0;0;54,802222;11,295
1683;"Lolland";"no";0;0;0;54,802222;11,295
1684;"Lolland";"no";0;0;0;54,802222;11,295
1685;"Lolland";"no";0;0;0;54,802222;11,295
1686;"Lolland";"no";0;0;0;54,802222;11,295
1687;"Lolland";"no";0;0;0;54,802222;11,295
1688;"Lolland";"no";0;0;0;54,802222;11,295
1689;"Lolland";"no";0;0;0;54,802222;11,295
1690;"Lolland";"no";0;0;0;54,802222;11,295
1691;"Lolland";"no";0;1;1;54,802222;11,295
1692;"Lolland";"no";0;0;0;54,802222;11,295
1693;"Lolland";"no";0;0;0;54,802222;11,295
1694;"Lolland";"no";2;1;3;54,802222;11,295
1695;"Lolland";"no";0;0;0;54,802222;11,295
1696;"Lolland";"no";0;0;0;54,802222;11,295
1697;"Lolland";"no";0;0;0;54,802222;11,295
1698;"Lolland";"no";0;0;0;54,802222;11,295
1699;"Lolland";"no";0;0;0;54,802222;11,295
1700;"Lolland";"no";0;0;0;54,802222;11,295
1701;"Lolland";"no";0;0;0;54,802222;11,295
1702;"Lolland";"no";0;0;0;54,802222;11,295
1703;"Lolland";"no";0;0;0;54,802222;11,295
1704;"Lolland";"no";0;0;0;54,802222;11,295
1705;"Lolland";"no";0;0;0;54,802222;11,295
1706;"Lolland";"no";0;0;0;54,802222;11,295
1707;"Lolland";"no";0;0;0;54,802222;11,295
1708;"Lolland";"no";0;0;0;54,802222;11,295
1709;"Lolland";"no";0;0;0;54,802222;11,295
1710;"Lolland";"no";0;0;0;54,802222;11,295
1711;"Lolland";"no";0;0;0;54,802222;11,295
1712;"Lolland";"no";0;0;0;54,802222;11,295
1713;"Lolland";"no";0;0;0;54,802222;11,295
1714;"Lolland";"no";0;0;0;54,802222;11,295
1715;"Lolland";"no";0;0;0;54,802222;11,295
1716;"Lolland";"no";0;0;0;54,802222;11,295
1717;"Lolland";"no";0;0;0;54,802222;11,295
1718;"Lolland";"no";0;0;0;54,802222;11,295
1719;"Lolland";"no";0;0;0;54,802222;11,295
1720;"Lolland";"no";0;0;0;54,802222;11,295
1721;"Lolland";"no";0;0;0;54,802222;11,295
1722;"Lolland";"no";0;0;0;54,802222;11,295
1723;"Lolland";"no";0;0;0;54,802222;11,295
1724;"Lolland";"no";0;0;0;54,802222;11,295
1725;"Lolland";"no";0;0;0;54,802222;11,295
1726;"Lolland";"no";0;0;0;54,802222;11,295
1727;"Lolland";"no";0;0;0;54,802222;11,295
1728;"Lolland";"no";0;0;0;54,802222;11,295
1729;"Lolland";"no";0;0;0;54,802222;11,295
1730;"Lolland";"no";0;0;0;54,802222;11,295
1731;"Lolland";"no";0;0;0;54,802222;11,295
1732;"Lolland";"no";0;0;0;54,802222;11,295
1733;"Lolland";"no";0;0;0;54,802222;11,295
1734;"Lolland";"no";0;0;0;54,802222;11,295
1735;"Lolland";"no";0;0;0;54,802222;11,295
1736;"Lolland";"no";0;0;0;54,802222;11,295
1737;"Lolland";"no";0;0;0;54,802222;11,295
1738;"Lolland";"no";0;0;0;54,802222;11,295
1739;"Lolland";"no";0;0;0;54,802222;11,295
1740;"Lolland";"no";0;0;0;54,802222;11,295
1741;"Lolland";"no";0;0;0;54,802222;11,295
1742;"Lolland";"no";0;0;0;54,802222;11,295
1743;"Lolland";"no";0;0;0;54,802222;11,295
1744;"Lolland";"no";0;0;0;54,802222;11,295
1745;"Lolland";"no";0;0;0;54,802222;11,295
1746;"Lolland";"no";0;0;0;54,802222;11,295
1747;"Lolland";"no";0;0;0;54,802222;11,295
1748;"Lolland";"no";0;0;0;54,802222;11,295
1749;"Lolland";"no";0;0;0;54,802222;11,295
1750;"Lolland";"no";0;0;0;54,802222;11,295
1751;"Lolland";"no";0;0;0;54,802222;11,295
1752;"Lolland";"no";0;0;0;54,802222;11,295
1753;"Lolland";"no";0;0;0;54,802222;11,295
1754;"Lolland";"no";0;0;0;54,802222;11,295
1755;"Lolland";"no";0;0;0;54,802222;11,295
1756;"Lolland";"no";0;0;0;54,802222;11,295
1757;"Lolland";"no";0;0;0;54,802222;11,295
1758;"Lolland";"no";0;0;0;54,802222;11,295
1759;"Lolland";"no";0;0;0;54,802222;11,295
1760;"Lolland";"no";0;0;0;54,802222;11,295
1761;"Lolland";"no";0;0;0;54,802222;11,295
1762;"Lolland";"no";0;0;0;54,802222;11,295
1763;"Lolland";"no";0;0;0;54,802222;11,295
1764;"Lolland";"no";0;0;0;54,802222;11,295
1765;"Lolland";"no";0;0;0;54,802222;11,295
1766;"Lolland";"no";0;0;0;54,802222;11,295
1767;"Lolland";"no";0;0;0;54,802222;11,295
1768;"Lolland";"no";0;0;0;54,802222;11,295
1769;"Lolland";"no";0;0;0;54,802222;11,295
1770;"Lolland";"no";0;0;0;54,802222;11,295
1771;"Lolland";"no";0;0;0;54,802222;11,295
1772;"Lolland";"no";0;0;0;54,802222;11,295
1773;"Lolland";"no";0;0;0;54,802222;11,295
1774;"Lolland";"no";0;0;0;54,802222;11,295
1775;"Lolland";"no";0;0;0;54,802222;11,295
1776;"Lolland";"no";0;0;0;54,802222;11,295
1777;"Lolland";"no";0;0;0;54,802222;11,295
1778;"Lolland";"no";0;0;0;54,802222;11,295
1779;"Lolland";"no";0;0;0;54,802222;11,295
1780;"Lolland";"no";0;0;0;54,802222;11,295
1781;"Lolland";"no";0;0;0;54,802222;11,295
1782;"Lolland";"no";0;0;0;54,802222;11,295
1783;"Lolland";"no";0;0;0;54,802222;11,295
1784;"Lolland";"no";0;0;0;54,802222;11,295
1785;"Lolland";"no";0;0;0;54,802222;11,295
1786;"Lolland";"no";0;0;0;54,802222;11,295
1787;"Lolland";"no";0;0;0;54,802222;11,295
1788;"Lolland";"no";0;0;0;54,802222;11,295
1789;"Lolland";"no";0;0;0;54,802222;11,295
1790;"Lolland";"no";0;0;0;54,802222;11,295
1791;"Lolland";"no";0;0;0;54,802222;11,295
1792;"Lolland";"no";0;0;0;54,802222;11,295
1793;"Lolland";"no";0;0;0;54,802222;11,295
1794;"Lolland";"no";0;0;0;54,802222;11,295
1795;"Lolland";"no";0;0;0;54,802222;11,295
1796;"Lolland";"no";0;0;0;54,802222;11,295
1797;"Lolland";"no";0;0;0;54,802222;11,295
1798;"Lolland";"no";0;0;0;54,802222;11,295
1799;"Lolland";"no";0;0;0;54,802222;11,295
1800;"Lolland";"no";0;0;0;54,802222;11,295
1801;"Lolland";"no";0;0;0;54,802222;11,295
1802;"Lolland";"no";0;0;0;54,802222;11,295
1803;"Lolland";"no";0;0;0;54,802222;11,295
1804;"Lolland";"no";0;0;0;54,802222;11,295
1805;"Lolland";"no";0;0;0;54,802222;11,295
1806;"Lolland";"no";0;0;0;54,802222;11,295
1807;"Lolland";"no";0;0;0;54,802222;11,295
1808;"Lolland";"no";0;0;0;54,802222;11,295
1809;"Lolland";"no";0;0;0;54,802222;11,295
1810;"Lolland";"no";0;0;0;54,802222;11,295
1811;"Lolland";"no";0;0;0;54,802222;11,295
1812;"Lolland";"no";0;0;0;54,802222;11,295
1813;"Lolland";"no";0;0;0;54,802222;11,295
1814;"Lolland";"no";0;0;0;54,802222;11,295
1815;"Lolland";"no";0;0;0;54,802222;11,295
1816;"Lolland";"no";0;0;0;54,802222;11,295
1817;"Lolland";"no";0;0;0;54,802222;11,295
1818;"Lolland";"no";0;0;0;54,802222;11,295
1819;"Lolland";"no";0;0;0;54,802222;11,295
1820;"Lolland";"no";0;0;0;54,802222;11,295
1821;"Lolland";"no";0;0;0;54,802222;11,295
1822;"Lolland";"no";0;0;0;54,802222;11,295
1823;"Lolland";"no";0;0;0;54,802222;11,295
1824;"Lolland";"no";0;0;0;54,802222;11,295
1825;"Lolland";"no";0;0;0;54,802222;11,295
1826;"Lolland";"no";0;0;0;54,802222;11,295
1827;"Lolland";"no";0;0;0;54,802222;11,295
1828;"Lolland";"no";0;0;0;54,802222;11,295
1829;"Lolland";"no";0;0;0;54,802222;11,295
1830;"Lolland";"no";0;0;0;54,802222;11,295
1831;"Lolland";"no";0;0;0;54,802222;11,295
1832;"Lolland";"no";0;0;0;54,802222;11,295
1833;"Lolland";"no";0;0;0;54,802222;11,295
1834;"Lolland";"no";0;0;0;54,802222;11,295
1835;"Lolland";"no";0;0;0;54,802222;11,295
1836;"Lolland";"no";0;0;0;54,802222;11,295
1837;"Lolland";"no";0;0;0;54,802222;11,295
1838;"Lolland";"no";0;0;0;54,802222;11,295
1839;"Lolland";"no";0;0;0;54,802222;11,295
1840;"Lolland";"no";0;0;0;54,802222;11,295
1841;"Lolland";"no";0;4;4;54,802222;11,295
1842;"Lolland";"no";0;0;0;54,802222;11,295
1843;"Lolland";"no";0;0;0;54,802222;11,295
1844;"Lolland";"no";0;0;0;54,802222;11,295
1845;"Lolland";"no";0;0;0;54,802222;11,295
1846;"Lolland";"no";0;0;0;54,802222;11,295
1847;"Lolland";"no";0;0;0;54,802222;11,295
1848;"Lolland";"no";0;0;0;54,802222;11,295
1849;"Lolland";"no";0;0;0;54,802222;11,295
1850;"Lolland";"no";0;0;0;54,802222;11,295
1851;"Lolland";"no";0;0;0;54,802222;11,295
1852;"Lolland";"no";0;0;0;54,802222;11,295
1853;"Lolland";"no";0;0;0;54,802222;11,295
1854;"Lolland";"no";0;0;0;54,802222;11,295
1855;"Lolland";"no";0;0;0;54,802222;11,295
1856;"Lolland";"no";0;1;1;54,802222;11,295
1857;"Lolland";"no";0;0;0;54,802222;11,295
1634;"Randers";"no";0;0;0;56,466666;10,05
1635;"Randers";"no";0;0;0;56,466666;10,05
1636;"Randers";"no";1;0;1;56,466666;10,05
1637;"Randers";"no";2;0;2;56,466666;10,05
1638;"Randers";"no";2;1;3;56,466666;10,05
1639;"Randers";"no";6;0;6;56,466666;10,05
1640;"Randers";"no";5;0;5;56,466666;10,05
1641;"Randers";"no";6;0;6;56,466666;10,05
1642;"Randers";"no";2;1;3;56,466666;10,05
1643;"Randers";"no";7;3;10;56,466666;10,05
1644;"Randers";"no";3;1;4;56,466666;10,05
1645;"Randers";"no";0;0;0;56,466666;10,05
1646;"Randers";"no";1;0;1;56,466666;10,05
1647;"Randers";"no";2;0;2;56,466666;10,05
1648;"Randers";"no";2;2;4;56,466666;10,05
1649;"Randers";"no";0;1;1;56,466666;10,05
1650;"Randers";"no";1;0;1;56,466666;10,05
1651;"Randers";"no";1;0;1;56,466666;10,05
1652;"Randers";"no";0;0;0;56,466666;10,05
1653;"Randers";"no";0;0;0;56,466666;10,05
1654;"Randers";"no";0;0;0;56,466666;10,05
1655;"Randers";"no";0;0;0;56,466666;10,05
1656;"Randers";"no";0;0;0;56,466666;10,05
1657;"Randers";"no";0;0;0;56,466666;10,05
1658;"Randers";"no";0;0;0;56,466666;10,05
1659;"Randers";"no";0;0;0;56,466666;10,05
1660;"Randers";"no";0;0;0;56,466666;10,05
1661;"Randers";"no";1;0;1;56,466666;10,05
1662;"Randers";"no";0;0;0;56,466666;10,05
1663;"Randers";"no";0;0;0;56,466666;10,05
1664;"Randers";"no";1;0;1;56,466666;10,05
1665;"Randers";"no";0;0;0;56,466666;10,05
1666;"Randers";"no";2;0;2;56,466666;10,05
1667;"Randers";"no";0;0;0;56,466666;10,05
1668;"Randers";"no";0;0;0;56,466666;10,05
1669;"Randers";"no";0;0;0;56,466666;10,05
1670;"Randers";"no";0;0;0;56,466666;10,05
1671;"Randers";"no";0;0;0;56,466666;10,05
1672;"Randers";"no";0;0;0;56,466666;10,05
1673;"Randers";"no";0;0;0;56,466666;10,05
1674;"Randers";"no";0;0;0;56,466666;10,05
1675;"Randers";"no";0;0;0;56,466666;10,05
1676;"Randers";"no";0;0;0;56,466666;10,05
1677;"Randers";"no";0;0;0;56,466666;10,05
1678;"Randers";"no";0;0;0;56,466666;10,05
1679;"Randers";"no";0;1;1;56,466666;10,05
1680;"Randers";"no";1;0;1;56,466666;10,05
1681;"Randers";"no";0;0;0;56,466666;10,05
1682;"Randers";"no";0;0;0;56,466666;10,05
1683;"Randers";"no";0;0;0;56,466666;10,05
1684;"Randers";"no";0;1;1;56,466666;10,05
1685;"Randers";"no";0;0;0;56,466666;10,05
1686;"Randers";"no";0;0;0;56,466666;10,05
1687;"Randers";"no";0;0;0;56,466666;10,05
1688;"Randers";"no";0;0;0;56,466666;10,05
1689;"Randers";"no";0;0;0;56,466666;10,05
1690;"Randers";"no";0;0;0;56,466666;10,05
1691;"Randers";"no";0;0;0;56,466666;10,05
1692;"Randers";"no";0;0;0;56,466666;10,05
1693;"Randers";"no";1;1;2;56,466666;10,05
1694;"Randers";"no";0;0;0;56,466666;10,05
1695;"Randers";"no";0;0;0;56,466666;10,05
1696;"Randers";"no";0;0;0;56,466666;10,05
1697;"Randers";"no";0;0;0;56,466666;10,05
1698;"Randers";"no";0;0;0;56,466666;10,05
1699;"Randers";"no";0;1;1;56,466666;10,05
1700;"Randers";"no";1;0;1;56,466666;10,05
1701;"Randers";"no";0;0;0;56,466666;10,05
1702;"Randers";"no";0;0;0;56,466666;10,05
1703;"Randers";"no";1;0;1;56,466666;10,05
1704;"Randers";"no";0;0;0;56,466666;10,05
1705;"Randers";"no";0;1;1;56,466666;10,05
1706;"Randers";"no";0;0;0;56,466666;10,05
1707;"Randers";"no";1;0;1;56,466666;10,05
1708;"Randers";"no";0;0;0;56,466666;10,05
1709;"Randers";"no";0;0;0;56,466666;10,05
1710;"Randers";"no";0;0;0;56,466666;10,05
1711;"Randers";"no";0;0;0;56,466666;10,05
1712;"Randers";"no";0;1;1;56,466666;10,05
1713;"Randers";"no";0;0;0;56,466666;10,05
1714;"Randers";"no";0;1;1;56,466666;10,05
1715;"Randers";"no";0;0;0;56,466666;10,05
1716;"Randers";"no";0;0;0;56,466666;10,05
1717;"Randers";"no";0;0;0;56,466666;10,05
1718;"Randers";"no";0;0;0;56,466666;10,05
1719;"Randers";"no";0;0;0;56,466666;10,05
1720;"Randers";"no";0;0;0;56,466666;10,05
1721;"Randers";"no";0;0;0;56,466666;10,05
1722;"Randers";"no";0;0;0;56,466666;10,05
1723;"Randers";"no";1;0;1;56,466666;10,05
1724;"Randers";"no";1;0;1;56,466666;10,05
1725;"Randers";"no";2;1;3;56,466666;10,05
1726;"Randers";"no";1;0;1;56,466666;10,05
1727;"Randers";"no";0;0;0;56,466666;10,05
1728;"Randers";"no";0;0;0;56,466666;10,05
1729;"Randers";"no";1;1;2;56,466666;10,05
1730;"Randers";"no";0;1;1;56,466666;10,05
1731;"Randers";"no";0;1;1;56,466666;10,05
1732;"Randers";"no";0;0;0;56,466666;10,05
1733;"Randers";"no";1;1;2;56,466666;10,05
1734;"Randers";"no";0;0;0;56,466666;10,05
1735;"Randers";"no";1;0;1;56,466666;10,05
1736;"Randers";"no";2;0;2;56,466666;10,05
1737;"Randers";"no";0;0;0;56,466666;10,05
1738;"Randers";"no";0;0;0;56,466666;10,05
1739;"Randers";"no";0;0;0;56,466666;10,05
1740;"Randers";"no";0;1;1;56,466666;10,05
1741;"Randers";"no";0;0;0;56,466666;10,05
1742;"Randers";"no";0;0;0;56,466666;10,05
1743;"Randers";"no";0;0;0;56,466666;10,05
1744;"Randers";"no";0;0;0;56,466666;10,05
1745;"Randers";"no";0;2;2;56,466666;10,05
1746;"Randers";"no";0;1;1;56,466666;10,05
1747;"Randers";"no";0;0;0;56,466666;10,05
1748;"Randers";"no";0;1;1;56,466666;10,05
1749;"Randers";"no";1;2;3;56,466666;10,05
1750;"Randers";"no";1;0;1;56,466666;10,05
1751;"Randers";"no";1;2;3;56,466666;10,05
1752;"Randers";"no";0;2;2;56,466666;10,05
1753;"Randers";"no";0;2;2;56,466666;10,05
1754;"Randers";"no";1;1;2;56,466666;10,05
1755;"Randers";"no";0;1;1;56,466666;10,05
1756;"Randers";"no";0;0;0;56,466666;10,05
1757;"Randers";"no";0;0;0;56,466666;10,05
1758;"Randers";"no";1;0;1;56,466666;10,05
1759;"Randers";"no";0;2;2;56,466666;10,05
1760;"Randers";"no";7;3;10;56,466666;10,05
1761;"Randers";"no";4;3;7;56,466666;10,05
1762;"Randers";"no";2;0;2;56,466666;10,05
1763;"Randers";"no";3;7;10;56,466666;10,05
1764;"Randers";"no";2;2;4;56,466666;10,05
1765;"Randers";"no";1;3;4;56,466666;10,05
1766;"Randers";"no";2;3;5;56,466666;10,05
1767;"Randers";"no";1;2;3;56,466666;10,05
1768;"Randers";"no";0;0;0;56,466666;10,05
1769;"Randers";"no";1;2;3;56,466666;10,05
1770;"Randers";"no";4;3;7;56,466666;10,05
1771;"Randers";"no";4;8;12;56,466666;10,05
1772;"Randers";"no";1;0;1;56,466666;10,05
1773;"Randers";"no";1;1;2;56,466666;10,05
1774;"Randers";"no";1;1;2;56,466666;10,05
1775;"Randers";"no";2;3;5;56,466666;10,05
1776;"Randers";"no";1;3;4;56,466666;10,05
1777;"Randers";"no";0;2;2;56,466666;10,05
1778;"Randers";"no";0;2;2;56,466666;10,05
1779;"Randers";"no";4;5;9;56,466666;10,05
1780;"Randers";"no";1;0;1;56,466666;10,05
1781;"Randers";"no";0;0;0;56,466666;10,05
1782;"Randers";"no";0;0;0;56,466666;10,05
1783;"Randers";"no";1;7;8;56,466666;10,05
1784;"Randers";"no";4;15;19;56,466666;10,05
1785;"Randers";"no";2;3;5;56,466666;10,05
1786;"Randers";"no";3;17;20;56,466666;10,05
1787;"Randers";"no";3;4;7;56,466666;10,05
1788;"Randers";"no";2;6;8;56,466666;10,05
1789;"Randers";"no";3;2;5;56,466666;10,05
1790;"Randers";"no";2;4;6;56,466666;10,05
1791;"Randers";"no";3;2;5;56,466666;10,05
1792;"Randers";"no";1;2;3;56,466666;10,05
1793;"Randers";"no";3;7;10;56,466666;10,05
1794;"Randers";"no";0;1;1;56,466666;10,05
1795;"Randers";"no";5;2;7;56,466666;10,05
1796;"Randers";"no";3;4;7;56,466666;10,05
1797;"Randers";"no";10;5;15;56,466666;10,05
1798;"Randers";"no";3;17;20;56,466666;10,05
1799;"Randers";"no";7;15;22;56,466666;10,05
1800;"Randers";"no";6;4;10;56,466666;10,05
1801;"Randers";"no";5;8;13;56,466666;10,05
1802;"Randers";"no";2;8;10;56,466666;10,05
1803;"Randers";"no";7;17;24;56,466666;10,05
1804;"Randers";"no";13;17;30;56,466666;10,05
1805;"Randers";"no";35;17;52;56,466666;10,05
1806;"Randers";"no";5;5;10;56,466666;10,05
1807;"Randers";"no";2;2;4;56,466666;10,05
1808;"Randers";"no";0;0;0;56,466666;10,05
1809;"Randers";"no";0;1;1;56,466666;10,05
1810;"Randers";"no";1;0;1;56,466666;10,05
1811;"Randers";"no";1;0;1;56,466666;10,05
1812;"Randers";"no";0;0;0;56,466666;10,05
1813;"Randers";"no";0;0;0;56,466666;10,05
1814;"Randers";"no";3;0;3;56,466666;10,05
1815;"Randers";"no";6;4;10;56,466666;10,05
1816;"Randers";"no";1;1;2;56,466666;10,05
1817;"Randers";"no";25;8;33;56,466666;10,05
1818;"Randers";"no";31;26;57;56,466666;10,05
1819;"Randers";"no";3;6;9;56,466666;10,05
1820;"Randers";"no";1;4;5;56,466666;10,05
1821;"Randers";"no";3;2;5;56,466666;10,05
1822;"Randers";"no";4;3;7;56,466666;10,05
1823;"Randers";"no";6;5;11;56,466666;10,05
1824;"Randers";"no";3;5;8;56,466666;10,05
1825;"Randers";"no";1;3;4;56,466666;10,05
1826;"Randers";"no";4;5;9;56,466666;10,05
1827;"Randers";"no";2;6;8;56,466666;10,05
1828;"Randers";"no";3;5;8;56,466666;10,05
1829;"Randers";"no";3;6;9;56,466666;10,05
1830;"Randers";"no";7;5;12;56,466666;10,05
1831;"Randers";"no";2;9;11;56,466666;10,05
1832;"Randers";"no";8;13;21;56,466666;10,05
1833;"Randers";"no";8;7;15;56,466666;10,05
1834;"Randers";"no";4;4;8;56,466666;10,05
1835;"Randers";"no";2;3;5;56,466666;10,05
1836;"Randers";"no";4;3;7;56,466666;10,05
1837;"Randers";"no";7;7;14;56,466666;10,05
1838;"Randers";"no";3;2;5;56,466666;10,05
1839;"Randers";"no";10;6;16;56,466666;10,05
1840;"Randers";"no";7;7;14;56,466666;10,05
1841;"Randers";"no";3;5;8;56,466666;10,05
1842;"Randers";"no";16;10;26;56,466666;10,05
1843;"Randers";"no";24;15;39;56,466666;10,05
1844;"Randers";"no";18;17;35;56,466666;10,05
1845;"Randers";"no";14;19;33;56,466666;10,05
1846;"Randers";"no";24;23;47;56,466666;10,05
1847;"Randers";"no";26;20;46;56,466666;10,05
1848;"Randers";"no";14;20;34;56,466666;10,05
1849;"Randers";"no";20;22;42;56,466666;10,05
1850;"Randers";"no";21;20;41;56,466666;10,05
1851;"Randers";"no";18;18;36;56,466666;10,05
1852;"Randers";"no";23;14;37;56,466666;10,05
1853;"Randers";"no";22;20;42;56,466666;10,05
1854;"Randers";"no";34;31;65;56,466666;10,05
1855;"Randers";"no";35;31;66;56,466666;10,05
1856;"Randers";"no";93;43;136;56,466666;10,05
1857;"Randers";"no";3;0;3;56,466666;10,05
1634;"Ribe";"no";0;0;0;55,35;8,766666
1635;"Ribe";"no";0;0;0;55,35;8,766666
1636;"Ribe";"no";1;0;1;55,35;8,766666
1637;"Ribe";"no";0;0;0;55,35;8,766666
1638;"Ribe";"no";0;0;0;55,35;8,766666
1639;"Ribe";"no";2;0;2;55,35;8,766666
1640;"Ribe";"no";3;0;3;55,35;8,766666
1641;"Ribe";"no";3;0;3;55,35;8,766666
1642;"Ribe";"no";4;0;4;55,35;8,766666
1643;"Ribe";"no";7;0;7;55,35;8,766666
1644;"Ribe";"no";0;0;0;55,35;8,766666
1645;"Ribe";"no";0;0;0;55,35;8,766666
1646;"Ribe";"no";0;0;0;55,35;8,766666
1647;"Ribe";"no";0;0;0;55,35;8,766666
1648;"Ribe";"no";0;0;0;55,35;8,766666
1649;"Ribe";"no";0;0;0;55,35;8,766666
1650;"Ribe";"no";1;0;1;55,35;8,766666
1651;"Ribe";"no";0;0;0;55,35;8,766666
1652;"Ribe";"no";0;0;0;55,35;8,766666
1653;"Ribe";"no";0;0;0;55,35;8,766666
1654;"Ribe";"no";0;0;0;55,35;8,766666
1655;"Ribe";"no";0;0;0;55,35;8,766666
1656;"Ribe";"no";0;0;0;55,35;8,766666
1657;"Ribe";"no";0;0;0;55,35;8,766666
1658;"Ribe";"no";0;0;0;55,35;8,766666
1659;"Ribe";"no";0;0;0;55,35;8,766666
1660;"Ribe";"no";0;0;0;55,35;8,766666
1661;"Ribe";"no";0;0;0;55,35;8,766666
1662;"Ribe";"no";0;0;0;55,35;8,766666
1663;"Ribe";"no";0;0;0;55,35;8,766666
1664;"Ribe";"no";0;1;1;55,35;8,766666
1665;"Ribe";"no";0;2;2;55,35;8,766666
1666;"Ribe";"no";0;0;0;55,35;8,766666
1667;"Ribe";"no";0;0;0;55,35;8,766666
1668;"Ribe";"no";0;1;1;55,35;8,766666
1669;"Ribe";"no";0;0;0;55,35;8,766666
1670;"Ribe";"no";0;0;0;55,35;8,766666
1671;"Ribe";"no";0;0;0;55,35;8,766666
1672;"Ribe";"no";0;0;0;55,35;8,766666
1673;"Ribe";"no";0;0;0;55,35;8,766666
1674;"Ribe";"no";0;0;0;55,35;8,766666
1675;"Ribe";"no";0;0;0;55,35;8,766666
1676;"Ribe";"no";0;0;0;55,35;8,766666
1677;"Ribe";"no";0;0;0;55,35;8,766666
1678;"Ribe";"no";0;0;0;55,35;8,766666
1679;"Ribe";"no";0;0;0;55,35;8,766666
1680;"Ribe";"no";0;1;1;55,35;8,766666
1681;"Ribe";"no";0;0;0;55,35;8,766666
1682;"Ribe";"no";0;0;0;55,35;8,766666
1683;"Ribe";"no";0;0;0;55,35;8,766666
1684;"Ribe";"no";0;0;0;55,35;8,766666
1685;"Ribe";"no";0;0;0;55,35;8,766666
1686;"Ribe";"no";0;0;0;55,35;8,766666
1687;"Ribe";"no";0;0;0;55,35;8,766666
1688;"Ribe";"no";0;0;0;55,35;8,766666
1689;"Ribe";"no";0;0;0;55,35;8,766666
1690;"Ribe";"no";0;0;0;55,35;8,766666
1691;"Ribe";"no";0;0;0;55,35;8,766666
1692;"Ribe";"no";0;0;0;55,35;8,766666
1693;"Ribe";"no";0;0;0;55,35;8,766666
1694;"Ribe";"no";0;0;0;55,35;8,766666
1695;"Ribe";"no";0;0;0;55,35;8,766666
1696;"Ribe";"no";0;0;0;55,35;8,766666
1697;"Ribe";"no";0;0;0;55,35;8,766666
1698;"Ribe";"no";0;0;0;55,35;8,766666
1699;"Ribe";"no";0;0;0;55,35;8,766666
1700;"Ribe";"no";0;0;0;55,35;8,766666
1701;"Ribe";"no";0;1;1;55,35;8,766666
1702;"Ribe";"no";0;0;0;55,35;8,766666
1703;"Ribe";"no";0;0;0;55,35;8,766666
1704;"Ribe";"no";0;0;0;55,35;8,766666
1705;"Ribe";"no";0;0;0;55,35;8,766666
1706;"Ribe";"no";0;0;0;55,35;8,766666
1707;"Ribe";"no";0;0;0;55,35;8,766666
1708;"Ribe";"no";0;0;0;55,35;8,766666
1709;"Ribe";"no";0;0;0;55,35;8,766666
1710;"Ribe";"no";0;0;0;55,35;8,766666
1711;"Ribe";"no";0;0;0;55,35;8,766666
1712;"Ribe";"no";0;0;0;55,35;8,766666
1713;"Ribe";"no";0;0;0;55,35;8,766666
1714;"Ribe";"no";0;0;0;55,35;8,766666
1715;"Ribe";"no";0;0;0;55,35;8,766666
1716;"Ribe";"no";0;0;0;55,35;8,766666
1717;"Ribe";"no";0;0;0;55,35;8,766666
1718;"Ribe";"no";0;0;0;55,35;8,766666
1719;"Ribe";"no";0;0;0;55,35;8,766666
1720;"Ribe";"no";0;0;0;55,35;8,766666
1721;"Ribe";"no";0;0;0;55,35;8,766666
1722;"Ribe";"no";0;0;0;55,35;8,766666
1723;"Ribe";"no";0;0;0;55,35;8,766666
1724;"Ribe";"no";0;0;0;55,35;8,766666
1725;"Ribe";"no";0;0;0;55,35;8,766666
1726;"Ribe";"no";0;0;0;55,35;8,766666
1727;"Ribe";"no";0;0;0;55,35;8,766666
1728;"Ribe";"no";0;0;0;55,35;8,766666
1729;"Ribe";"no";0;0;0;55,35;8,766666
1730;"Ribe";"no";0;0;0;55,35;8,766666
1731;"Ribe";"no";0;0;0;55,35;8,766666
1732;"Ribe";"no";0;0;0;55,35;8,766666
1733;"Ribe";"no";0;0;0;55,35;8,766666
1734;"Ribe";"no";0;0;0;55,35;8,766666
1735;"Ribe";"no";0;0;0;55,35;8,766666
1736;"Ribe";"no";0;0;0;55,35;8,766666
1737;"Ribe";"no";0;1;1;55,35;8,766666
1738;"Ribe";"no";1;1;2;55,35;8,766666
1739;"Ribe";"no";1;2;3;55,35;8,766666
1740;"Ribe";"no";0;0;0;55,35;8,766666
1741;"Ribe";"no";0;1;1;55,35;8,766666
1742;"Ribe";"no";0;1;1;55,35;8,766666
1743;"Ribe";"no";0;1;1;55,35;8,766666
1744;"Ribe";"no";1;1;2;55,35;8,766666
1745;"Ribe";"no";1;2;3;55,35;8,766666
1746;"Ribe";"no";1;2;3;55,35;8,766666
1747;"Ribe";"no";1;3;4;55,35;8,766666
1748;"Ribe";"no";1;3;4;55,35;8,766666
1749;"Ribe";"no";2;2;4;55,35;8,766666
1750;"Ribe";"no";1;2;3;55,35;8,766666
1751;"Ribe";"no";0;1;1;55,35;8,766666
1752;"Ribe";"no";2;1;3;55,35;8,766666
1753;"Ribe";"no";1;1;2;55,35;8,766666
1754;"Ribe";"no";0;2;2;55,35;8,766666
1755;"Ribe";"no";1;0;1;55,35;8,766666
1756;"Ribe";"no";0;1;1;55,35;8,766666
1757;"Ribe";"no";0;0;0;55,35;8,766666
1758;"Ribe";"no";0;0;0;55,35;8,766666
1759;"Ribe";"no";0;0;0;55,35;8,766666
1760;"Ribe";"no";0;0;0;55,35;8,766666
1761;"Ribe";"no";1;1;2;55,35;8,766666
1762;"Ribe";"no";0;2;2;55,35;8,766666
1763;"Ribe";"no";0;1;1;55,35;8,766666
1764;"Ribe";"no";0;1;1;55,35;8,766666
1765;"Ribe";"no";0;1;1;55,35;8,766666
1766;"Ribe";"no";2;0;2;55,35;8,766666
1767;"Ribe";"no";4;1;5;55,35;8,766666
1768;"Ribe";"no";2;1;3;55,35;8,766666
1769;"Ribe";"no";1;1;2;55,35;8,766666
1770;"Ribe";"no";2;1;3;55,35;8,766666
1771;"Ribe";"no";0;1;1;55,35;8,766666
1772;"Ribe";"no";0;0;0;55,35;8,766666
1773;"Ribe";"no";0;0;0;55,35;8,766666
1774;"Ribe";"no";0;0;0;55,35;8,766666
1775;"Ribe";"no";0;0;0;55,35;8,766666
1776;"Ribe";"no";0;0;0;55,35;8,766666
1777;"Ribe";"no";0;0;0;55,35;8,766666
1778;"Ribe";"no";0;0;0;55,35;8,766666
1779;"Ribe";"no";0;1;1;55,35;8,766666
1780;"Ribe";"no";0;1;1;55,35;8,766666
1781;"Ribe";"no";0;1;1;55,35;8,766666
1782;"Ribe";"no";0;0;0;55,35;8,766666
1783;"Ribe";"no";1;1;2;55,35;8,766666
1784;"Ribe";"no";3;1;4;55,35;8,766666
1785;"Ribe";"no";1;1;2;55,35;8,766666
1786;"Ribe";"no";0;1;1;55,35;8,766666
1787;"Ribe";"no";1;0;1;55,35;8,766666
1788;"Ribe";"no";1;1;2;55,35;8,766666
1789;"Ribe";"no";0;0;0;55,35;8,766666
1790;"Ribe";"no";1;1;2;55,35;8,766666
1791;"Ribe";"no";1;1;2;55,35;8,766666
1792;"Ribe";"no";0;1;1;55,35;8,766666
1793;"Ribe";"no";0;0;0;55,35;8,766666
1794;"Ribe";"no";0;0;0;55,35;8,766666
1795;"Ribe";"no";0;0;0;55,35;8,766666
1796;"Ribe";"no";0;0;0;55,35;8,766666
1797;"Ribe";"no";0;0;0;55,35;8,766666
1798;"Ribe";"no";0;0;0;55,35;8,766666
1799;"Ribe";"no";0;1;1;55,35;8,766666
1800;"Ribe";"no";0;0;0;55,35;8,766666
1801;"Ribe";"no";0;0;0;55,35;8,766666
1802;"Ribe";"no";0;0;0;55,35;8,766666
1803;"Ribe";"no";0;0;0;55,35;8,766666
1804;"Ribe";"no";0;0;0;55,35;8,766666
1805;"Ribe";"no";1;0;1;55,35;8,766666
1806;"Ribe";"no";0;0;0;55,35;8,766666
1807;"Ribe";"no";0;0;0;55,35;8,766666
1808;"Ribe";"no";0;0;0;55,35;8,766666
1809;"Ribe";"no";0;0;0;55,35;8,766666
1810;"Ribe";"no";0;0;0;55,35;8,766666
1811;"Ribe";"no";0;0;0;55,35;8,766666
1812;"Ribe";"no";0;0;0;55,35;8,766666
1813;"Ribe";"no";0;0;0;55,35;8,766666
1814;"Ribe";"no";0;0;0;55,35;8,766666
1815;"Ribe";"no";1;0;1;55,35;8,766666
1816;"Ribe";"no";0;1;1;55,35;8,766666
1817;"Ribe";"no";0;0;0;55,35;8,766666
1818;"Ribe";"no";0;0;0;55,35;8,766666
1819;"Ribe";"no";0;0;0;55,35;8,766666
1820;"Ribe";"no";0;0;0;55,35;8,766666
1821;"Ribe";"no";0;0;0;55,35;8,766666
1822;"Ribe";"no";0;0;0;55,35;8,766666
1823;"Ribe";"no";0;0;0;55,35;8,766666
1824;"Ribe";"no";0;0;0;55,35;8,766666
1825;"Ribe";"no";0;0;0;55,35;8,766666
1826;"Ribe";"no";0;0;0;55,35;8,766666
1827;"Ribe";"no";0;0;0;55,35;8,766666
1828;"Ribe";"no";0;0;0;55,35;8,766666
1829;"Ribe";"no";0;0;0;55,35;8,766666
1830;"Ribe";"no";0;0;0;55,35;8,766666
1831;"Ribe";"no";0;0;0;55,35;8,766666
1832;"Ribe";"no";0;0;0;55,35;8,766666
1833;"Ribe";"no";0;0;0;55,35;8,766666
1834;"Ribe";"no";0;0;0;55,35;8,766666
1835;"Ribe";"no";0;0;0;55,35;8,766666
1836;"Ribe";"no";0;0;0;55,35;8,766666
1837;"Ribe";"no";0;0;0;55,35;8,766666
1838;"Ribe";"no";0;0;0;55,35;8,766666
1839;"Ribe";"no";0;0;0;55,35;8,766666
1840;"Ribe";"no";0;0;0;55,35;8,766666
1841;"Ribe";"no";0;0;0;55,35;8,766666
1842;"Ribe";"no";0;0;0;55,35;8,766666
1843;"Ribe";"no";0;0;0;55,35;8,766666
1844;"Ribe";"no";0;0;0;55,35;8,766666
1845;"Ribe";"no";0;0;0;55,35;8,766666
1846;"Ribe";"no";0;0;0;55,35;8,766666
1847;"Ribe";"no";0;0;0;55,35;8,766666
1848;"Ribe";"no";0;1;1;55,35;8,766666
1849;"Ribe";"no";0;0;0;55,35;8,766666
1850;"Ribe";"no";0;0;0;55,35;8,766666
1851;"Ribe";"no";1;4;5;55,35;8,766666
1852;"Ribe";"no";0;2;2;55,35;8,766666
1853;"Ribe";"no";0;2;2;55,35;8,766666
1854;"Ribe";"no";0;2;2;55,35;8,766666
1855;"Ribe";"no";0;1;1;55,35;8,766666
1856;"Ribe";"no";2;2;4;55,35;8,766666
1857;"Ribe";"no";0;0;0;55,35;8,766666
1634;"Øresund (dansk kyst)";"no";0;0;0;55,833333;12,666666
1635;"Øresund (dansk kyst)";"no";0;0;0;55,833333;12,666666
1636;"Øresund (dansk kyst)";"no";1;0;1;55,833333;12,666666
1637;"Øresund (dansk kyst)";"no";0;0;0;55,833333;12,666666
1638;"Øresund (dansk kyst)";"no";0;0;0;55,833333;12,666666
1639;"Øresund (dansk kyst)";"no";0;0;0;55,833333;12,666666
1640;"Øresund (dansk kyst)";"no";0;0;0;55,833333;12,666666
1641;"Øresund (dansk kyst)";"no";0;0;0;55,833333;12,666666
1642;"Øresund (dansk kyst)";"no";0;0;0;55,833333;12,666666
1643;"Øresund (dansk kyst)";"no";0;0;0;55,833333;12,666666
1644;"Øresund (dansk kyst)";"no";0;0;0;55,833333;12,666666
1645;"Øresund (dansk kyst)";"no";0;0;0;55,833333;12,666666
1646;"Øresund (dansk kyst)";"no";0;0;0;55,833333;12,666666
1647;"Øresund (dansk kyst)";"no";0;0;0;55,833333;12,666666
1648;"Øresund (dansk kyst)";"no";0;0;0;55,833333;12,666666
1649;"Øresund (dansk kyst)";"no";0;0;0;55,833333;12,666666
1650;"Øresund (dansk kyst)";"no";0;0;0;55,833333;12,666666
1651;"Øresund (dansk kyst)";"no";0;0;0;55,833333;12,666666
1652;"Øresund (dansk kyst)";"no";0;0;0;55,833333;12,666666
1653;"Øresund (dansk kyst)";"no";0;0;0;55,833333;12,666666
1654;"Øresund (dansk kyst)";"no";0;0;0;55,833333;12,666666
1655;"Øresund (dansk kyst)";"no";0;0;0;55,833333;12,666666
1656;"Øresund (dansk kyst)";"no";0;0;0;55,833333;12,666666
1657;"Øresund (dansk kyst)";"no";0;0;0;55,833333;12,666666
1658;"Øresund (dansk kyst)";"no";0;0;0;55,833333;12,666666
1659;"Øresund (dansk kyst)";"no";0;0;0;55,833333;12,666666
1660;"Øresund (dansk kyst)";"no";0;0;0;55,833333;12,666666
1661;"Øresund (dansk kyst)";"no";0;0;0;55,833333;12,666666
1662;"Øresund (dansk kyst)";"no";0;0;0;55,833333;12,666666
1663;"Øresund (dansk kyst)";"no";0;0;0;55,833333;12,666666
1664;"Øresund (dansk kyst)";"no";0;0;0;55,833333;12,666666
1665;"Øresund (dansk kyst)";"no";0;0;0;55,833333;12,666666
1666;"Øresund (dansk kyst)";"no";0;0;0;55,833333;12,666666
1667;"Øresund (dansk kyst)";"no";0;0;0;55,833333;12,666666
1668;"Øresund (dansk kyst)";"no";0;0;0;55,833333;12,666666
1669;"Øresund (dansk kyst)";"no";0;0;0;55,833333;12,666666
1670;"Øresund (dansk kyst)";"no";0;0;0;55,833333;12,666666
1671;"Øresund (dansk kyst)";"no";0;0;0;55,833333;12,666666
1672;"Øresund (dansk kyst)";"no";0;0;0;55,833333;12,666666
1673;"Øresund (dansk kyst)";"no";0;0;0;55,833333;12,666666
1674;"Øresund (dansk kyst)";"no";0;0;0;55,833333;12,666666
1675;"Øresund (dansk kyst)";"no";0;0;0;55,833333;12,666666
1676;"Øresund (dansk kyst)";"no";0;0;0;55,833333;12,666666
1677;"Øresund (dansk kyst)";"no";0;0;0;55,833333;12,666666
1678;"Øresund (dansk kyst)";"no";0;0;0;55,833333;12,666666
1679;"Øresund (dansk kyst)";"no";0;0;0;55,833333;12,666666
1680;"Øresund (dansk kyst)";"no";0;0;0;55,833333;12,666666
1681;"Øresund (dansk kyst)";"no";0;0;0;55,833333;12,666666
1682;"Øresund (dansk kyst)";"no";0;0;0;55,833333;12,666666
1683;"Øresund (dansk kyst)";"no";0;0;0;55,833333;12,666666
1684;"Øresund (dansk kyst)";"no";0;0;0;55,833333;12,666666
1685;"Øresund (dansk kyst)";"no";0;0;0;55,833333;12,666666
1686;"Øresund (dansk kyst)";"no";0;0;0;55,833333;12,666666
1687;"Øresund (dansk kyst)";"no";0;0;0;55,833333;12,666666
1688;"Øresund (dansk kyst)";"no";0;0;0;55,833333;12,666666
1689;"Øresund (dansk kyst)";"no";0;0;0;55,833333;12,666666
1690;"Øresund (dansk kyst)";"no";0;0;0;55,833333;12,666666
1691;"Øresund (dansk kyst)";"no";0;0;0;55,833333;12,666666
1692;"Øresund (dansk kyst)";"no";0;0;0;55,833333;12,666666
1693;"Øresund (dansk kyst)";"no";0;0;0;55,833333;12,666666
1694;"Øresund (dansk kyst)";"no";0;0;0;55,833333;12,666666
1695;"Øresund (dansk kyst)";"no";0;0;0;55,833333;12,666666
1696;"Øresund (dansk kyst)";"no";0;0;0;55,833333;12,666666
1697;"Øresund (dansk kyst)";"no";0;0;0;55,833333;12,666666
1698;"Øresund (dansk kyst)";"no";0;0;0;55,833333;12,666666
1699;"Øresund (dansk kyst)";"no";0;0;0;55,833333;12,666666
1700;"Øresund (dansk kyst)";"no";0;0;0;55,833333;12,666666
1701;"Øresund (dansk kyst)";"no";0;0;0;55,833333;12,666666
1702;"Øresund (dansk kyst)";"no";0;0;0;55,833333;12,666666
1703;"Øresund (dansk kyst)";"no";0;0;0;55,833333;12,666666
1704;"Øresund (dansk kyst)";"no";0;0;0;55,833333;12,666666
1705;"Øresund (dansk kyst)";"no";0;0;0;55,833333;12,666666
1706;"Øresund (dansk kyst)";"no";0;0;0;55,833333;12,666666
1707;"Øresund (dansk kyst)";"no";0;0;0;55,833333;12,666666
1708;"Øresund (dansk kyst)";"no";0;0;0;55,833333;12,666666
1709;"Øresund (dansk kyst)";"no";0;0;0;55,833333;12,666666
1710;"Øresund (dansk kyst)";"no";0;0;0;55,833333;12,666666
1711;"Øresund (dansk kyst)";"no";0;0;0;55,833333;12,666666
1712;"Øresund (dansk kyst)";"no";0;0;0;55,833333;12,666666
1713;"Øresund (dansk kyst)";"no";0;0;0;55,833333;12,666666
1714;"Øresund (dansk kyst)";"no";0;0;0;55,833333;12,666666
1715;"Øresund (dansk kyst)";"no";0;0;0;55,833333;12,666666
1716;"Øresund (dansk kyst)";"no";0;0;0;55,833333;12,666666
1717;"Øresund (dansk kyst)";"no";0;0;0;55,833333;12,666666
1718;"Øresund (dansk kyst)";"no";0;0;0;55,833333;12,666666
1719;"Øresund (dansk kyst)";"no";0;0;0;55,833333;12,666666
1720;"Øresund (dansk kyst)";"no";0;0;0;55,833333;12,666666
1721;"Øresund (dansk kyst)";"no";0;0;0;55,833333;12,666666
1722;"Øresund (dansk kyst)";"no";0;0;0;55,833333;12,666666
1723;"Øresund (dansk kyst)";"no";0;0;0;55,833333;12,666666
1724;"Øresund (dansk kyst)";"no";0;0;0;55,833333;12,666666
1725;"Øresund (dansk kyst)";"no";0;0;0;55,833333;12,666666
1726;"Øresund (dansk kyst)";"no";0;0;0;55,833333;12,666666
1727;"Øresund (dansk kyst)";"no";0;0;0;55,833333;12,666666
1728;"Øresund (dansk kyst)";"no";0;0;0;55,833333;12,666666
1729;"Øresund (dansk kyst)";"no";0;0;0;55,833333;12,666666
1730;"Øresund (dansk kyst)";"no";0;0;0;55,833333;12,666666
1731;"Øresund (dansk kyst)";"no";0;0;0;55,833333;12,666666
1732;"Øresund (dansk kyst)";"no";1;0;1;55,833333;12,666666
1733;"Øresund (dansk kyst)";"no";3;0;3;55,833333;12,666666
1734;"Øresund (dansk kyst)";"no";0;0;0;55,833333;12,666666
1735;"Øresund (dansk kyst)";"no";0;0;0;55,833333;12,666666
1736;"Øresund (dansk kyst)";"no";0;0;0;55,833333;12,666666
1737;"Øresund (dansk kyst)";"no";0;0;0;55,833333;12,666666
1738;"Øresund (dansk kyst)";"no";0;0;0;55,833333;12,666666
1739;"Øresund (dansk kyst)";"no";0;0;0;55,833333;12,666666
1740;"Øresund (dansk kyst)";"no";0;0;0;55,833333;12,666666
1741;"Øresund (dansk kyst)";"no";0;0;0;55,833333;12,666666
1742;"Øresund (dansk kyst)";"no";0;0;0;55,833333;12,666666
1743;"Øresund (dansk kyst)";"no";0;0;0;55,833333;12,666666
1744;"Øresund (dansk kyst)";"no";0;0;0;55,833333;12,666666
1745;"Øresund (dansk kyst)";"no";0;0;0;55,833333;12,666666
1746;"Øresund (dansk kyst)";"no";0;0;0;55,833333;12,666666
1747;"Øresund (dansk kyst)";"no";0;0;0;55,833333;12,666666
1748;"Øresund (dansk kyst)";"no";0;0;0;55,833333;12,666666
1749;"Øresund (dansk kyst)";"no";0;0;0;55,833333;12,666666
1750;"Øresund (dansk kyst)";"no";0;0;0;55,833333;12,666666
1751;"Øresund (dansk kyst)";"no";0;0;0;55,833333;12,666666
1752;"Øresund (dansk kyst)";"no";0;0;0;55,833333;12,666666
1753;"Øresund (dansk kyst)";"no";0;0;0;55,833333;12,666666
1754;"Øresund (dansk kyst)";"no";0;0;0;55,833333;12,666666
1755;"Øresund (dansk kyst)";"no";0;0;0;55,833333;12,666666
1756;"Øresund (dansk kyst)";"no";0;0;0;55,833333;12,666666
1757;"Øresund (dansk kyst)";"no";0;0;0;55,833333;12,666666
1758;"Øresund (dansk kyst)";"no";0;0;0;55,833333;12,666666
1759;"Øresund (dansk kyst)";"no";0;0;0;55,833333;12,666666
1760;"Øresund (dansk kyst)";"no";0;0;0;55,833333;12,666666
1761;"Øresund (dansk kyst)";"no";0;0;0;55,833333;12,666666
1762;"Øresund (dansk kyst)";"no";0;0;0;55,833333;12,666666
1763;"Øresund (dansk kyst)";"no";0;0;0;55,833333;12,666666
1764;"Øresund (dansk kyst)";"no";0;0;0;55,833333;12,666666
1765;"Øresund (dansk kyst)";"no";0;0;0;55,833333;12,666666
1766;"Øresund (dansk kyst)";"no";0;0;0;55,833333;12,666666
1767;"Øresund (dansk kyst)";"no";0;0;0;55,833333;12,666666
1768;"Øresund (dansk kyst)";"no";0;0;0;55,833333;12,666666
1769;"Øresund (dansk kyst)";"no";0;0;0;55,833333;12,666666
1770;"Øresund (dansk kyst)";"no";0;0;0;55,833333;12,666666
1771;"Øresund (dansk kyst)";"no";0;0;0;55,833333;12,666666
1772;"Øresund (dansk kyst)";"no";0;0;0;55,833333;12,666666
1773;"Øresund (dansk kyst)";"no";0;0;0;55,833333;12,666666
1774;"Øresund (dansk kyst)";"no";0;0;0;55,833333;12,666666
1775;"Øresund (dansk kyst)";"no";0;0;0;55,833333;12,666666
1776;"Øresund (dansk kyst)";"no";0;0;0;55,833333;12,666666
1777;"Øresund (dansk kyst)";"no";0;0;0;55,833333;12,666666
1778;"Øresund (dansk kyst)";"no";0;0;0;55,833333;12,666666
1779;"Øresund (dansk kyst)";"no";0;0;0;55,833333;12,666666
1780;"Øresund (dansk kyst)";"no";0;0;0;55,833333;12,666666
1781;"Øresund (dansk kyst)";"no";0;0;0;55,833333;12,666666
1782;"Øresund (dansk kyst)";"no";0;0;0;55,833333;12,666666
1783;"Øresund (dansk kyst)";"no";0;0;0;55,833333;12,666666
1784;"Øresund (dansk kyst)";"no";0;0;0;55,833333;12,666666
1785;"Øresund (dansk kyst)";"no";0;0;0;55,833333;12,666666
1786;"Øresund (dansk kyst)";"no";0;0;0;55,833333;12,666666
1787;"Øresund (dansk kyst)";"no";0;0;0;55,833333;12,666666
1788;"Øresund (dansk kyst)";"no";0;0;0;55,833333;12,666666
1789;"Øresund (dansk kyst)";"no";0;0;0;55,833333;12,666666
1790;"Øresund (dansk kyst)";"no";0;0;0;55,833333;12,666666
1791;"Øresund (dansk kyst)";"no";0;0;0;55,833333;12,666666
1792;"Øresund (dansk kyst)";"no";0;0;0;55,833333;12,666666
1793;"Øresund (dansk kyst)";"no";0;0;0;55,833333;12,666666
1794;"Øresund (dansk kyst)";"no";0;0;0;55,833333;12,666666
1795;"Øresund (dansk kyst)";"no";0;0;0;55,833333;12,666666
1796;"Øresund (dansk kyst)";"no";0;0;0;55,833333;12,666666
1797;"Øresund (dansk kyst)";"no";0;0;0;55,833333;12,666666
1798;"Øresund (dansk kyst)";"no";0;0;0;55,833333;12,666666
1799;"Øresund (dansk kyst)";"no";0;0;0;55,833333;12,666666
1800;"Øresund (dansk kyst)";"no";0;0;0;55,833333;12,666666
1801;"Øresund (dansk kyst)";"no";0;0;0;55,833333;12,666666
1802;"Øresund (dansk kyst)";"no";0;0;0;55,833333;12,666666
1803;"Øresund (dansk kyst)";"no";0;0;0;55,833333;12,666666
1804;"Øresund (dansk kyst)";"no";0;0;0;55,833333;12,666666
1805;"Øresund (dansk kyst)";"no";1;0;1;55,833333;12,666666
1806;"Øresund (dansk kyst)";"no";0;0;0;55,833333;12,666666
1807;"Øresund (dansk kyst)";"no";0;0;0;55,833333;12,666666
1808;"Øresund (dansk kyst)";"no";0;0;0;55,833333;12,666666
1809;"Øresund (dansk kyst)";"no";0;0;0;55,833333;12,666666
1810;"Øresund (dansk kyst)";"no";0;0;0;55,833333;12,666666
1811;"Øresund (dansk kyst)";"no";0;0;0;55,833333;12,666666
1812;"Øresund (dansk kyst)";"no";0;0;0;55,833333;12,666666
1813;"Øresund (dansk kyst)";"no";0;0;0;55,833333;12,666666
1814;"Øresund (dansk kyst)";"no";0;0;0;55,833333;12,666666
1815;"Øresund (dansk kyst)";"no";0;0;0;55,833333;12,666666
1816;"Øresund (dansk kyst)";"no";0;0;0;55,833333;12,666666
1817;"Øresund (dansk kyst)";"no";0;0;0;55,833333;12,666666
1818;"Øresund (dansk kyst)";"no";0;0;0;55,833333;12,666666
1819;"Øresund (dansk kyst)";"no";0;0;0;55,833333;12,666666
1820;"Øresund (dansk kyst)";"no";0;0;0;55,833333;12,666666
1821;"Øresund (dansk kyst)";"no";0;0;0;55,833333;12,666666
1822;"Øresund (dansk kyst)";"no";0;0;0;55,833333;12,666666
1823;"Øresund (dansk kyst)";"no";0;0;0;55,833333;12,666666
1824;"Øresund (dansk kyst)";"no";0;0;0;55,833333;12,666666
1825;"Øresund (dansk kyst)";"no";0;0;0;55,833333;12,666666
1826;"Øresund (dansk kyst)";"no";0;0;0;55,833333;12,666666
1827;"Øresund (dansk kyst)";"no";0;0;0;55,833333;12,666666
1828;"Øresund (dansk kyst)";"no";0;0;0;55,833333;12,666666
1829;"Øresund (dansk kyst)";"no";0;0;0;55,833333;12,666666
1830;"Øresund (dansk kyst)";"no";0;0;0;55,833333;12,666666
1831;"Øresund (dansk kyst)";"no";0;0;0;55,833333;12,666666
1832;"Øresund (dansk kyst)";"no";0;0;0;55,833333;12,666666
1833;"Øresund (dansk kyst)";"no";0;0;0;55,833333;12,666666
1834;"Øresund (dansk kyst)";"no";0;0;0;55,833333;12,666666
1835;"Øresund (dansk kyst)";"no";0;0;0;55,833333;12,666666
1836;"Øresund (dansk kyst)";"no";0;0;0;55,833333;12,666666
1837;"Øresund (dansk kyst)";"no";0;0;0;55,833333;12,666666
1838;"Øresund (dansk kyst)";"no";0;0;0;55,833333;12,666666
1839;"Øresund (dansk kyst)";"no";0;0;0;55,833333;12,666666
1840;"Øresund (dansk kyst)";"no";0;0;0;55,833333;12,666666
1841;"Øresund (dansk kyst)";"no";0;0;0;55,833333;12,666666
1842;"Øresund (dansk kyst)";"no";0;0;0;55,833333;12,666666
1843;"Øresund (dansk kyst)";"no";0;0;0;55,833333;12,666666
1844;"Øresund (dansk kyst)";"no";0;0;0;55,833333;12,666666
1845;"Øresund (dansk kyst)";"no";0;0;0;55,833333;12,666666
1846;"Øresund (dansk kyst)";"no";0;0;0;55,833333;12,666666
1847;"Øresund (dansk kyst)";"no";0;0;0;55,833333;12,666666
1848;"Øresund (dansk kyst)";"no";0;0;0;55,833333;12,666666
1849;"Øresund (dansk kyst)";"no";0;0;0;55,833333;12,666666
1850;"Øresund (dansk kyst)";"no";0;0;0;55,833333;12,666666
1851;"Øresund (dansk kyst)";"no";0;0;0;55,833333;12,666666
1852;"Øresund (dansk kyst)";"no";0;0;0;55,833333;12,666666
1853;"Øresund (dansk kyst)";"no";0;0;0;55,833333;12,666666
1854;"Øresund (dansk kyst)";"no";0;1;1;55,833333;12,666666
1855;"Øresund (dansk kyst)";"no";1;0;1;55,833333;12,666666
1856;"Øresund (dansk kyst)";"no";0;0;0;55,833333;12,666666
1857;"Øresund (dansk kyst)";"no";0;0;0;55,833333;12,666666
1634;"Anholt";"no";0;0;0;56,7;11,55
1635;"Anholt";"no";0;0;0;56,7;11,55
1636;"Anholt";"no";0;0;0;56,7;11,55
1637;"Anholt";"no";1;0;1;56,7;11,55
1638;"Anholt";"no";0;0;0;56,7;11,55
1639;"Anholt";"no";0;0;0;56,7;11,55
1640;"Anholt";"no";0;0;0;56,7;11,55
1641;"Anholt";"no";0;0;0;56,7;11,55
1642;"Anholt";"no";0;1;1;56,7;11,55
1643;"Anholt";"no";1;0;1;56,7;11,55
1644;"Anholt";"no";0;0;0;56,7;11,55
1645;"Anholt";"no";0;0;0;56,7;11,55
1646;"Anholt";"no";0;0;0;56,7;11,55
1647;"Anholt";"no";0;0;0;56,7;11,55
1648;"Anholt";"no";0;0;0;56,7;11,55
1649;"Anholt";"no";0;0;0;56,7;11,55
1650;"Anholt";"no";0;0;0;56,7;11,55
1651;"Anholt";"no";0;0;0;56,7;11,55
1652;"Anholt";"no";0;0;0;56,7;11,55
1653;"Anholt";"no";0;0;0;56,7;11,55
1654;"Anholt";"no";0;0;0;56,7;11,55
1655;"Anholt";"no";0;0;0;56,7;11,55
1656;"Anholt";"no";0;0;0;56,7;11,55
1657;"Anholt";"no";0;0;0;56,7;11,55
1658;"Anholt";"no";0;0;0;56,7;11,55
1659;"Anholt";"no";0;0;0;56,7;11,55
1660;"Anholt";"no";0;0;0;56,7;11,55
1661;"Anholt";"no";0;0;0;56,7;11,55
1662;"Anholt";"no";0;0;0;56,7;11,55
1663;"Anholt";"no";1;0;1;56,7;11,55
1664;"Anholt";"no";1;1;2;56,7;11,55
1665;"Anholt";"no";0;0;0;56,7;11,55
1666;"Anholt";"no";1;0;1;56,7;11,55
1667;"Anholt";"no";0;0;0;56,7;11,55
1668;"Anholt";"no";0;0;0;56,7;11,55
1669;"Anholt";"no";0;0;0;56,7;11,55
1670;"Anholt";"no";1;0;1;56,7;11,55
1671;"Anholt";"no";0;0;0;56,7;11,55
1672;"Anholt";"no";0;0;0;56,7;11,55
1673;"Anholt";"no";0;0;0;56,7;11,55
1674;"Anholt";"no";1;0;1;56,7;11,55
1675;"Anholt";"no";0;0;0;56,7;11,55
1676;"Anholt";"no";0;0;0;56,7;11,55
1677;"Anholt";"no";6;0;6;56,7;11,55
1678;"Anholt";"no";0;0;0;56,7;11,55
1679;"Anholt";"no";1;1;2;56,7;11,55
1680;"Anholt";"no";1;0;1;56,7;11,55
1681;"Anholt";"no";0;0;0;56,7;11,55
1682;"Anholt";"no";0;0;0;56,7;11,55
1683;"Anholt";"no";0;0;0;56,7;11,55
1684;"Anholt";"no";0;0;0;56,7;11,55
1685;"Anholt";"no";1;1;2;56,7;11,55
1686;"Anholt";"no";0;0;0;56,7;11,55
1687;"Anholt";"no";1;0;1;56,7;11,55
1688;"Anholt";"no";0;0;0;56,7;11,55
1689;"Anholt";"no";0;0;0;56,7;11,55
1690;"Anholt";"no";0;0;0;56,7;11,55
1691;"Anholt";"no";0;0;0;56,7;11,55
1692;"Anholt";"no";0;0;0;56,7;11,55
1693;"Anholt";"no";0;0;0;56,7;11,55
1694;"Anholt";"no";0;0;0;56,7;11,55
1695;"Anholt";"no";0;0;0;56,7;11,55
1696;"Anholt";"no";0;0;0;56,7;11,55
1697;"Anholt";"no";1;0;1;56,7;11,55
1698;"Anholt";"no";0;0;0;56,7;11,55
1699;"Anholt";"no";0;0;0;56,7;11,55
1700;"Anholt";"no";0;0;0;56,7;11,55
1701;"Anholt";"no";0;0;0;56,7;11,55
1702;"Anholt";"no";0;0;0;56,7;11,55
1703;"Anholt";"no";0;0;0;56,7;11,55
1704;"Anholt";"no";2;0;2;56,7;11,55
1705;"Anholt";"no";0;0;0;56,7;11,55
1706;"Anholt";"no";0;0;0;56,7;11,55
1707;"Anholt";"no";0;0;0;56,7;11,55
1708;"Anholt";"no";0;0;0;56,7;11,55
1709;"Anholt";"no";0;0;0;56,7;11,55
1710;"Anholt";"no";0;0;0;56,7;11,55
1711;"Anholt";"no";0;0;0;56,7;11,55
1712;"Anholt";"no";0;0;0;56,7;11,55
1713;"Anholt";"no";0;0;0;56,7;11,55
1714;"Anholt";"no";0;0;0;56,7;11,55
1715;"Anholt";"no";0;0;0;56,7;11,55
1716;"Anholt";"no";1;0;1;56,7;11,55
1717;"Anholt";"no";0;0;0;56,7;11,55
1718;"Anholt";"no";0;0;0;56,7;11,55
1719;"Anholt";"no";0;0;0;56,7;11,55
1720;"Anholt";"no";1;1;2;56,7;11,55
1721;"Anholt";"no";0;0;0;56,7;11,55
1722;"Anholt";"no";1;0;1;56,7;11,55
1723;"Anholt";"no";0;0;0;56,7;11,55
1724;"Anholt";"no";0;0;0;56,7;11,55
1725;"Anholt";"no";0;0;0;56,7;11,55
1726;"Anholt";"no";1;0;1;56,7;11,55
1727;"Anholt";"no";0;0;0;56,7;11,55
1728;"Anholt";"no";0;0;0;56,7;11,55
1729;"Anholt";"no";0;0;0;56,7;11,55
1730;"Anholt";"no";0;0;0;56,7;11,55
1731;"Anholt";"no";0;0;0;56,7;11,55
1732;"Anholt";"no";0;0;0;56,7;11,55
1733;"Anholt";"no";0;0;0;56,7;11,55
1734;"Anholt";"no";0;0;0;56,7;11,55
1735;"Anholt";"no";0;0;0;56,7;11,55
1736;"Anholt";"no";0;0;0;56,7;11,55
1737;"Anholt";"no";0;0;0;56,7;11,55
1738;"Anholt";"no";0;0;0;56,7;11,55
1739;"Anholt";"no";0;0;0;56,7;11,55
1740;"Anholt";"no";0;0;0;56,7;11,55
1741;"Anholt";"no";0;0;0;56,7;11,55
1742;"Anholt";"no";0;0;0;56,7;11,55
1743;"Anholt";"no";0;0;0;56,7;11,55
1744;"Anholt";"no";0;0;0;56,7;11,55
1745;"Anholt";"no";0;0;0;56,7;11,55
1746;"Anholt";"no";1;0;1;56,7;11,55
1747;"Anholt";"no";0;0;0;56,7;11,55
1748;"Anholt";"no";0;0;0;56,7;11,55
1749;"Anholt";"no";2;0;2;56,7;11,55
1750;"Anholt";"no";0;0;0;56,7;11,55
1751;"Anholt";"no";0;0;0;56,7;11,55
1752;"Anholt";"no";0;1;1;56,7;11,55
1753;"Anholt";"no";0;0;0;56,7;11,55
1754;"Anholt";"no";2;0;2;56,7;11,55
1755;"Anholt";"no";0;0;0;56,7;11,55
1756;"Anholt";"no";0;0;0;56,7;11,55
1757;"Anholt";"no";1;0;1;56,7;11,55
1758;"Anholt";"no";0;0;0;56,7;11,55
1759;"Anholt";"no";0;0;0;56,7;11,55
1760;"Anholt";"no";0;0;0;56,7;11,55
1761;"Anholt";"no";0;0;0;56,7;11,55
1762;"Anholt";"no";0;0;0;56,7;11,55
1763;"Anholt";"no";0;0;0;56,7;11,55
1764;"Anholt";"no";0;0;0;56,7;11,55
1765;"Anholt";"no";1;0;1;56,7;11,55
1766;"Anholt";"no";0;0;0;56,7;11,55
1767;"Anholt";"no";0;1;1;56,7;11,55
1768;"Anholt";"no";0;0;0;56,7;11,55
1769;"Anholt";"no";0;0;0;56,7;11,55
1770;"Anholt";"no";0;0;0;56,7;11,55
1771;"Anholt";"no";0;0;0;56,7;11,55
1772;"Anholt";"no";0;1;1;56,7;11,55
1773;"Anholt";"no";0;0;0;56,7;11,55
1774;"Anholt";"no";0;0;0;56,7;11,55
1775;"Anholt";"no";0;0;0;56,7;11,55
1776;"Anholt";"no";0;0;0;56,7;11,55
1777;"Anholt";"no";0;0;0;56,7;11,55
1778;"Anholt";"no";0;1;1;56,7;11,55
1779;"Anholt";"no";0;0;0;56,7;11,55
1780;"Anholt";"no";0;0;0;56,7;11,55
1781;"Anholt";"no";0;0;0;56,7;11,55
1782;"Anholt";"no";0;0;0;56,7;11,55
1783;"Anholt";"no";0;0;0;56,7;11,55
1784;"Anholt";"no";0;0;0;56,7;11,55
1785;"Anholt";"no";1;0;1;56,7;11,55
1786;"Anholt";"no";0;0;0;56,7;11,55
1787;"Anholt";"no";0;0;0;56,7;11,55
1788;"Anholt";"no";0;0;0;56,7;11,55
1789;"Anholt";"no";0;0;0;56,7;11,55
1790;"Anholt";"no";0;0;0;56,7;11,55
1791;"Anholt";"no";0;0;0;56,7;11,55
1792;"Anholt";"no";0;0;0;56,7;11,55
1793;"Anholt";"no";0;0;0;56,7;11,55
1794;"Anholt";"no";0;0;0;56,7;11,55
1795;"Anholt";"no";0;1;1;56,7;11,55
1796;"Anholt";"no";0;0;0;56,7;11,55
1797;"Anholt";"no";0;1;1;56,7;11,55
1798;"Anholt";"no";0;0;0;56,7;11,55
1799;"Anholt";"no";1;1;2;56,7;11,55
1800;"Anholt";"no";0;0;0;56,7;11,55
1801;"Anholt";"no";0;0;0;56,7;11,55
1802;"Anholt";"no";0;0;0;56,7;11,55
1803;"Anholt";"no";0;0;0;56,7;11,55
1804;"Anholt";"no";0;0;0;56,7;11,55
1805;"Anholt";"no";0;0;0;56,7;11,55
1806;"Anholt";"no";0;0;0;56,7;11,55
1807;"Anholt";"no";0;0;0;56,7;11,55
1808;"Anholt";"no";0;0;0;56,7;11,55
1809;"Anholt";"no";0;0;0;56,7;11,55
1810;"Anholt";"no";0;0;0;56,7;11,55
1811;"Anholt";"no";0;0;0;56,7;11,55
1812;"Anholt";"no";0;0;0;56,7;11,55
1813;"Anholt";"no";0;1;1;56,7;11,55
1814;"Anholt";"no";5;8;13;56,7;11,55
1815;"Anholt";"no";0;0;0;56,7;11,55
1816;"Anholt";"no";0;0;0;56,7;11,55
1817;"Anholt";"no";0;0;0;56,7;11,55
1818;"Anholt";"no";0;0;0;56,7;11,55
1819;"Anholt";"no";0;0;0;56,7;11,55
1820;"Anholt";"no";0;0;0;56,7;11,55
1821;"Anholt";"no";0;0;0;56,7;11,55
1822;"Anholt";"no";1;0;1;56,7;11,55
1823;"Anholt";"no";0;0;0;56,7;11,55
1824;"Anholt";"no";0;0;0;56,7;11,55
1825;"Anholt";"no";1;0;1;56,7;11,55
1826;"Anholt";"no";0;0;0;56,7;11,55
1827;"Anholt";"no";0;0;0;56,7;11,55
1828;"Anholt";"no";0;0;0;56,7;11,55
1829;"Anholt";"no";0;0;0;56,7;11,55
1830;"Anholt";"no";0;0;0;56,7;11,55
1831;"Anholt";"no";0;0;0;56,7;11,55
1832;"Anholt";"no";0;0;0;56,7;11,55
1833;"Anholt";"no";0;0;0;56,7;11,55
1834;"Anholt";"no";0;1;1;56,7;11,55
1835;"Anholt";"no";0;1;1;56,7;11,55
1836;"Anholt";"no";0;0;0;56,7;11,55
1837;"Anholt";"no";1;0;1;56,7;11,55
1838;"Anholt";"no";0;0;0;56,7;11,55
1839;"Anholt";"no";14;0;14;56,7;11,55
1840;"Anholt";"no";6;0;6;56,7;11,55
1841;"Anholt";"no";0;0;0;56,7;11,55
1842;"Anholt";"no";4;0;4;56,7;11,55
1843;"Anholt";"no";2;2;4;56,7;11,55
1844;"Anholt";"no";1;0;1;56,7;11,55
1845;"Anholt";"no";13;0;13;56,7;11,55
1846;"Anholt";"no";3;1;4;56,7;11,55
1847;"Anholt";"no";7;0;7;56,7;11,55
1848;"Anholt";"no";1;0;1;56,7;11,55
1849;"Anholt";"no";1;0;1;56,7;11,55
1850;"Anholt";"no";5;0;5;56,7;11,55
1851;"Anholt";"no";3;0;3;56,7;11,55
1852;"Anholt";"no";4;1;5;56,7;11,55
1853;"Anholt";"no";2;0;2;56,7;11,55
1854;"Anholt";"no";5;1;6;56,7;11,55
1855;"Anholt";"no";4;3;7;56,7;11,55
1856;"Anholt";"no";1;0;1;56,7;11,55
1857;"Anholt";"no";0;0;0;56,7;11,55
1634;"Kristianshavn";"no";0;0;0;55,683333;12,583333
1635;"Kristianshavn";"no";0;0;0;55,683333;12,583333
1636;"Kristianshavn";"no";0;0;0;55,683333;12,583333
1637;"Kristianshavn";"no";1;0;1;55,683333;12,583333
1638;"Kristianshavn";"no";0;0;0;55,683333;12,583333
1639;"Kristianshavn";"no";3;0;3;55,683333;12,583333
1640;"Kristianshavn";"no";2;1;3;55,683333;12,583333
1641;"Kristianshavn";"no";8;1;9;55,683333;12,583333
1642;"Kristianshavn";"no";14;1;15;55,683333;12,583333
1643;"Kristianshavn";"no";10;2;12;55,683333;12,583333
1644;"Kristianshavn";"no";4;0;4;55,683333;12,583333
1645;"Kristianshavn";"no";2;0;2;55,683333;12,583333
1646;"Kristianshavn";"no";5;1;6;55,683333;12,583333
1647;"Kristianshavn";"no";3;0;3;55,683333;12,583333
1648;"Kristianshavn";"no";6;1;7;55,683333;12,583333
1649;"Kristianshavn";"no";4;0;4;55,683333;12,583333
1650;"Kristianshavn";"no";7;1;8;55,683333;12,583333
1651;"Kristianshavn";"no";4;0;4;55,683333;12,583333
1652;"Kristianshavn";"no";3;0;3;55,683333;12,583333
1653;"Kristianshavn";"no";0;0;0;55,683333;12,583333
1654;"Kristianshavn";"no";1;0;1;55,683333;12,583333
1655;"Kristianshavn";"no";2;0;2;55,683333;12,583333
1656;"Kristianshavn";"no";0;0;0;55,683333;12,583333
1657;"Kristianshavn";"no";0;0;0;55,683333;12,583333
1658;"Kristianshavn";"no";0;0;0;55,683333;12,583333
1659;"Kristianshavn";"no";0;0;0;55,683333;12,583333
1660;"Kristianshavn";"no";0;0;0;55,683333;12,583333
1661;"Kristianshavn";"no";0;0;0;55,683333;12,583333
1662;"Kristianshavn";"no";0;0;0;55,683333;12,583333
1663;"Kristianshavn";"no";0;0;0;55,683333;12,583333
1664;"Kristianshavn";"no";0;0;0;55,683333;12,583333
1665;"Kristianshavn";"no";1;0;1;55,683333;12,583333
1666;"Kristianshavn";"no";0;0;0;55,683333;12,583333
1667;"Kristianshavn";"no";0;0;0;55,683333;12,583333
1668;"Kristianshavn";"no";0;0;0;55,683333;12,583333
1669;"Kristianshavn";"no";0;0;0;55,683333;12,583333
1670;"Kristianshavn";"no";0;0;0;55,683333;12,583333
1671;"Kristianshavn";"no";0;0;0;55,683333;12,583333
1672;"Kristianshavn";"no";0;0;0;55,683333;12,583333
1673;"Kristianshavn";"no";1;0;1;55,683333;12,583333
1674;"Kristianshavn";"no";0;0;0;55,683333;12,583333
1675;"Kristianshavn";"no";2;0;2;55,683333;12,583333
1676;"Kristianshavn";"no";0;0;0;55,683333;12,583333
1677;"Kristianshavn";"no";0;0;0;55,683333;12,583333
1678;"Kristianshavn";"no";0;0;0;55,683333;12,583333
1679;"Kristianshavn";"no";0;0;0;55,683333;12,583333
1680;"Kristianshavn";"no";0;0;0;55,683333;12,583333
1681;"Kristianshavn";"no";1;0;1;55,683333;12,583333
1682;"Kristianshavn";"no";0;0;0;55,683333;12,583333
1683;"Kristianshavn";"no";0;0;0;55,683333;12,583333
1684;"Kristianshavn";"no";0;0;0;55,683333;12,583333
1685;"Kristianshavn";"no";0;0;0;55,683333;12,583333
1686;"Kristianshavn";"no";0;0;0;55,683333;12,583333
1687;"Kristianshavn";"no";0;0;0;55,683333;12,583333
1688;"Kristianshavn";"no";0;0;0;55,683333;12,583333
1689;"Kristianshavn";"no";0;0;0;55,683333;12,583333
1690;"Kristianshavn";"no";0;0;0;55,683333;12,583333
1691;"Kristianshavn";"no";0;0;0;55,683333;12,583333
1692;"Kristianshavn";"no";0;0;0;55,683333;12,583333
1693;"Kristianshavn";"no";0;0;0;55,683333;12,583333
1694;"Kristianshavn";"no";0;0;0;55,683333;12,583333
1695;"Kristianshavn";"no";0;0;0;55,683333;12,583333
1696;"Kristianshavn";"no";0;0;0;55,683333;12,583333
1697;"Kristianshavn";"no";0;0;0;55,683333;12,583333
1698;"Kristianshavn";"no";0;0;0;55,683333;12,583333
1699;"Kristianshavn";"no";0;0;0;55,683333;12,583333
1700;"Kristianshavn";"no";0;0;0;55,683333;12,583333
1701;"Kristianshavn";"no";0;0;0;55,683333;12,583333
1702;"Kristianshavn";"no";0;0;0;55,683333;12,583333
1703;"Kristianshavn";"no";0;0;0;55,683333;12,583333
1704;"Kristianshavn";"no";0;0;0;55,683333;12,583333
1705;"Kristianshavn";"no";0;0;0;55,683333;12,583333
1706;"Kristianshavn";"no";0;0;0;55,683333;12,583333
1707;"Kristianshavn";"no";0;0;0;55,683333;12,583333
1708;"Kristianshavn";"no";0;0;0;55,683333;12,583333
1709;"Kristianshavn";"no";0;0;0;55,683333;12,583333
1710;"Kristianshavn";"no";0;0;0;55,683333;12,583333
1711;"Kristianshavn";"no";0;0;0;55,683333;12,583333
1712;"Kristianshavn";"no";0;0;0;55,683333;12,583333
1713;"Kristianshavn";"no";0;0;0;55,683333;12,583333
1714;"Kristianshavn";"no";0;0;0;55,683333;12,583333
1715;"Kristianshavn";"no";0;0;0;55,683333;12,583333
1716;"Kristianshavn";"no";0;0;0;55,683333;12,583333
1717;"Kristianshavn";"no";0;0;0;55,683333;12,583333
1718;"Kristianshavn";"no";0;0;0;55,683333;12,583333
1719;"Kristianshavn";"no";0;0;0;55,683333;12,583333
1720;"Kristianshavn";"no";0;0;0;55,683333;12,583333
1721;"Kristianshavn";"no";0;0;0;55,683333;12,583333
1722;"Kristianshavn";"no";0;0;0;55,683333;12,583333
1723;"Kristianshavn";"no";0;0;0;55,683333;12,583333
1724;"Kristianshavn";"no";0;0;0;55,683333;12,583333
1725;"Kristianshavn";"no";0;0;0;55,683333;12,583333
1726;"Kristianshavn";"no";0;0;0;55,683333;12,583333
1727;"Kristianshavn";"no";0;0;0;55,683333;12,583333
1728;"Kristianshavn";"no";0;0;0;55,683333;12,583333
1729;"Kristianshavn";"no";0;0;0;55,683333;12,583333
1730;"Kristianshavn";"no";0;0;0;55,683333;12,583333
1731;"Kristianshavn";"no";0;0;0;55,683333;12,583333
1732;"Kristianshavn";"no";0;0;0;55,683333;12,583333
1733;"Kristianshavn";"no";0;0;0;55,683333;12,583333
1734;"Kristianshavn";"no";0;0;0;55,683333;12,583333
1735;"Kristianshavn";"no";0;0;0;55,683333;12,583333
1736;"Kristianshavn";"no";0;0;0;55,683333;12,583333
1737;"Kristianshavn";"no";0;0;0;55,683333;12,583333
1738;"Kristianshavn";"no";0;0;0;55,683333;12,583333
1739;"Kristianshavn";"no";0;0;0;55,683333;12,583333
1740;"Kristianshavn";"no";0;0;0;55,683333;12,583333
1741;"Kristianshavn";"no";0;0;0;55,683333;12,583333
1742;"Kristianshavn";"no";0;0;0;55,683333;12,583333
1743;"Kristianshavn";"no";0;0;0;55,683333;12,583333
1744;"Kristianshavn";"no";0;0;0;55,683333;12,583333
1745;"Kristianshavn";"no";0;0;0;55,683333;12,583333
1746;"Kristianshavn";"no";0;0;0;55,683333;12,583333
1747;"Kristianshavn";"no";0;0;0;55,683333;12,583333
1748;"Kristianshavn";"no";0;0;0;55,683333;12,583333
1749;"Kristianshavn";"no";0;0;0;55,683333;12,583333
1750;"Kristianshavn";"no";0;0;0;55,683333;12,583333
1751;"Kristianshavn";"no";0;0;0;55,683333;12,583333
1752;"Kristianshavn";"no";0;0;0;55,683333;12,583333
1753;"Kristianshavn";"no";0;0;0;55,683333;12,583333
1754;"Kristianshavn";"no";0;0;0;55,683333;12,583333
1755;"Kristianshavn";"no";0;0;0;55,683333;12,583333
1756;"Kristianshavn";"no";0;0;0;55,683333;12,583333
1757;"Kristianshavn";"no";0;0;0;55,683333;12,583333
1758;"Kristianshavn";"no";0;0;0;55,683333;12,583333
1759;"Kristianshavn";"no";0;0;0;55,683333;12,583333
1760;"Kristianshavn";"no";0;0;0;55,683333;12,583333
1761;"Kristianshavn";"no";0;0;0;55,683333;12,583333
1762;"Kristianshavn";"no";0;0;0;55,683333;12,583333
1763;"Kristianshavn";"no";1;0;1;55,683333;12,583333
1764;"Kristianshavn";"no";0;0;0;55,683333;12,583333
1765;"Kristianshavn";"no";0;0;0;55,683333;12,583333
1766;"Kristianshavn";"no";0;0;0;55,683333;12,583333
1767;"Kristianshavn";"no";0;0;0;55,683333;12,583333
1768;"Kristianshavn";"no";0;0;0;55,683333;12,583333
1769;"Kristianshavn";"no";0;0;0;55,683333;12,583333
1770;"Kristianshavn";"no";0;0;0;55,683333;12,583333
1771;"Kristianshavn";"no";0;0;0;55,683333;12,583333
1772;"Kristianshavn";"no";2;0;2;55,683333;12,583333
1773;"Kristianshavn";"no";0;1;1;55,683333;12,583333
1774;"Kristianshavn";"no";0;0;0;55,683333;12,583333
1775;"Kristianshavn";"no";0;0;0;55,683333;12,583333
1776;"Kristianshavn";"no";0;0;0;55,683333;12,583333
1777;"Kristianshavn";"no";0;0;0;55,683333;12,583333
1778;"Kristianshavn";"no";0;0;0;55,683333;12,583333
1779;"Kristianshavn";"no";0;0;0;55,683333;12,583333
1780;"Kristianshavn";"no";0;0;0;55,683333;12,583333
1781;"Kristianshavn";"no";0;0;0;55,683333;12,583333
1782;"Kristianshavn";"no";0;0;0;55,683333;12,583333
1783;"Kristianshavn";"no";0;0;0;55,683333;12,583333
1784;"Kristianshavn";"no";0;0;0;55,683333;12,583333
1785;"Kristianshavn";"no";0;0;0;55,683333;12,583333
1786;"Kristianshavn";"no";0;0;0;55,683333;12,583333
1787;"Kristianshavn";"no";1;0;1;55,683333;12,583333
1788;"Kristianshavn";"no";0;0;0;55,683333;12,583333
1789;"Kristianshavn";"no";0;0;0;55,683333;12,583333
1790;"Kristianshavn";"no";0;0;0;55,683333;12,583333
1791;"Kristianshavn";"no";0;0;0;55,683333;12,583333
1792;"Kristianshavn";"no";0;0;0;55,683333;12,583333
1793;"Kristianshavn";"no";0;0;0;55,683333;12,583333
1794;"Kristianshavn";"no";0;0;0;55,683333;12,583333
1795;"Kristianshavn";"no";0;0;0;55,683333;12,583333
1796;"Kristianshavn";"no";0;0;0;55,683333;12,583333
1797;"Kristianshavn";"no";0;0;0;55,683333;12,583333
1798;"Kristianshavn";"no";0;0;0;55,683333;12,583333
1799;"Kristianshavn";"no";0;0;0;55,683333;12,583333
1800;"Kristianshavn";"no";0;0;0;55,683333;12,583333
1801;"Kristianshavn";"no";0;0;0;55,683333;12,583333
1802;"Kristianshavn";"no";0;0;0;55,683333;12,583333
1803;"Kristianshavn";"no";0;0;0;55,683333;12,583333
1804;"Kristianshavn";"no";0;0;0;55,683333;12,583333
1805;"Kristianshavn";"no";0;0;0;55,683333;12,583333
1806;"Kristianshavn";"no";0;0;0;55,683333;12,583333
1807;"Kristianshavn";"no";0;0;0;55,683333;12,583333
1808;"Kristianshavn";"no";0;0;0;55,683333;12,583333
1809;"Kristianshavn";"no";0;0;0;55,683333;12,583333
1810;"Kristianshavn";"no";0;0;0;55,683333;12,583333
1811;"Kristianshavn";"no";0;0;0;55,683333;12,583333
1812;"Kristianshavn";"no";0;0;0;55,683333;12,583333
1813;"Kristianshavn";"no";0;0;0;55,683333;12,583333
1814;"Kristianshavn";"no";0;0;0;55,683333;12,583333
1815;"Kristianshavn";"no";0;0;0;55,683333;12,583333
1816;"Kristianshavn";"no";0;0;0;55,683333;12,583333
1817;"Kristianshavn";"no";0;0;0;55,683333;12,583333
1818;"Kristianshavn";"no";0;0;0;55,683333;12,583333
1819;"Kristianshavn";"no";0;0;0;55,683333;12,583333
1820;"Kristianshavn";"no";0;0;0;55,683333;12,583333
1821;"Kristianshavn";"no";0;0;0;55,683333;12,583333
1822;"Kristianshavn";"no";0;0;0;55,683333;12,583333
1823;"Kristianshavn";"no";0;0;0;55,683333;12,583333
1824;"Kristianshavn";"no";0;0;0;55,683333;12,583333
1825;"Kristianshavn";"no";0;0;0;55,683333;12,583333
1826;"Kristianshavn";"no";0;0;0;55,683333;12,583333
1827;"Kristianshavn";"no";0;1;1;55,683333;12,583333
1828;"Kristianshavn";"no";0;0;0;55,683333;12,583333
1829;"Kristianshavn";"no";0;0;0;55,683333;12,583333
1830;"Kristianshavn";"no";0;0;0;55,683333;12,583333
1831;"Kristianshavn";"no";0;3;3;55,683333;12,583333
1832;"Kristianshavn";"no";0;0;0;55,683333;12,583333
1833;"Kristianshavn";"no";1;0;1;55,683333;12,583333
1834;"Kristianshavn";"no";0;0;0;55,683333;12,583333
1835;"Kristianshavn";"no";0;0;0;55,683333;12,583333
1836;"Kristianshavn";"no";0;0;0;55,683333;12,583333
1837;"Kristianshavn";"no";0;0;0;55,683333;12,583333
1838;"Kristianshavn";"no";0;0;0;55,683333;12,583333
1839;"Kristianshavn";"no";0;0;0;55,683333;12,583333
1840;"Kristianshavn";"no";0;0;0;55,683333;12,583333
1841;"Kristianshavn";"no";0;0;0;55,683333;12,583333
1842;"Kristianshavn";"no";0;0;0;55,683333;12,583333
1843;"Kristianshavn";"no";0;0;0;55,683333;12,583333
1844;"Kristianshavn";"no";0;0;0;55,683333;12,583333
1845;"Kristianshavn";"no";0;0;0;55,683333;12,583333
1846;"Kristianshavn";"no";0;0;0;55,683333;12,583333
1847;"Kristianshavn";"no";0;0;0;55,683333;12,583333
1848;"Kristianshavn";"no";0;0;0;55,683333;12,583333
1849;"Kristianshavn";"no";0;0;0;55,683333;12,583333
1850;"Kristianshavn";"no";0;0;0;55,683333;12,583333
1851;"Kristianshavn";"no";0;0;0;55,683333;12,583333
1852;"Kristianshavn";"no";0;0;0;55,683333;12,583333
1853;"Kristianshavn";"no";0;1;1;55,683333;12,583333
1854;"Kristianshavn";"no";0;0;0;55,683333;12,583333
1855;"Kristianshavn";"no";0;0;0;55,683333;12,583333
1856;"Kristianshavn";"no";0;0;0;55,683333;12,583333
1857;"Kristianshavn";"no";0;0;0;55,683333;12,583333
1634;"Nykøbing Sjælland";"no";0;0;0;55,924722;11,670833
1635;"Nykøbing Sjælland";"no";0;0;0;55,924722;11,670833
1636;"Nykøbing Sjælland";"no";0;0;0;55,924722;11,670833
1637;"Nykøbing Sjælland";"no";1;0;1;55,924722;11,670833
1638;"Nykøbing Sjælland";"no";0;0;0;55,924722;11,670833
1639;"Nykøbing Sjælland";"no";0;0;0;55,924722;11,670833
1640;"Nykøbing Sjælland";"no";0;0;0;55,924722;11,670833
1641;"Nykøbing Sjælland";"no";0;0;0;55,924722;11,670833
1642;"Nykøbing Sjælland";"no";0;0;0;55,924722;11,670833
1643;"Nykøbing Sjælland";"no";0;0;0;55,924722;11,670833
1644;"Nykøbing Sjælland";"no";0;0;0;55,924722;11,670833
1645;"Nykøbing Sjælland";"no";0;0;0;55,924722;11,670833
1646;"Nykøbing Sjælland";"no";0;0;0;55,924722;11,670833
1647;"Nykøbing Sjælland";"no";0;0;0;55,924722;11,670833
1648;"Nykøbing Sjælland";"no";0;0;0;55,924722;11,670833
1649;"Nykøbing Sjælland";"no";0;0;0;55,924722;11,670833
1650;"Nykøbing Sjælland";"no";0;0;0;55,924722;11,670833
1651;"Nykøbing Sjælland";"no";0;0;0;55,924722;11,670833
1652;"Nykøbing Sjælland";"no";1;0;1;55,924722;11,670833
1653;"Nykøbing Sjælland";"no";0;0;0;55,924722;11,670833
1654;"Nykøbing Sjælland";"no";0;0;0;55,924722;11,670833
1655;"Nykøbing Sjælland";"no";0;0;0;55,924722;11,670833
1656;"Nykøbing Sjælland";"no";0;0;0;55,924722;11,670833
1657;"Nykøbing Sjælland";"no";0;0;0;55,924722;11,670833
1658;"Nykøbing Sjælland";"no";0;0;0;55,924722;11,670833
1659;"Nykøbing Sjælland";"no";0;0;0;55,924722;11,670833
1660;"Nykøbing Sjælland";"no";0;0;0;55,924722;11,670833
1661;"Nykøbing Sjælland";"no";0;0;0;55,924722;11,670833
1662;"Nykøbing Sjælland";"no";0;0;0;55,924722;11,670833
1663;"Nykøbing Sjælland";"no";0;0;0;55,924722;11,670833
1664;"Nykøbing Sjælland";"no";0;0;0;55,924722;11,670833
1665;"Nykøbing Sjælland";"no";0;0;0;55,924722;11,670833
1666;"Nykøbing Sjælland";"no";0;0;0;55,924722;11,670833
1667;"Nykøbing Sjælland";"no";0;0;0;55,924722;11,670833
1668;"Nykøbing Sjælland";"no";0;0;0;55,924722;11,670833
1669;"Nykøbing Sjælland";"no";0;0;0;55,924722;11,670833
1670;"Nykøbing Sjælland";"no";0;0;0;55,924722;11,670833
1671;"Nykøbing Sjælland";"no";0;0;0;55,924722;11,670833
1672;"Nykøbing Sjælland";"no";0;0;0;55,924722;11,670833
1673;"Nykøbing Sjælland";"no";0;0;0;55,924722;11,670833
1674;"Nykøbing Sjælland";"no";0;0;0;55,924722;11,670833
1675;"Nykøbing Sjælland";"no";0;0;0;55,924722;11,670833
1676;"Nykøbing Sjælland";"no";0;0;0;55,924722;11,670833
1677;"Nykøbing Sjælland";"no";0;0;0;55,924722;11,670833
1678;"Nykøbing Sjælland";"no";0;0;0;55,924722;11,670833
1679;"Nykøbing Sjælland";"no";0;0;0;55,924722;11,670833
1680;"Nykøbing Sjælland";"no";0;0;0;55,924722;11,670833
1681;"Nykøbing Sjælland";"no";0;0;0;55,924722;11,670833
1682;"Nykøbing Sjælland";"no";0;0;0;55,924722;11,670833
1683;"Nykøbing Sjælland";"no";0;0;0;55,924722;11,670833
1684;"Nykøbing Sjælland";"no";0;0;0;55,924722;11,670833
1685;"Nykøbing Sjælland";"no";0;0;0;55,924722;11,670833
1686;"Nykøbing Sjælland";"no";0;0;0;55,924722;11,670833
1687;"Nykøbing Sjælland";"no";0;0;0;55,924722;11,670833
1688;"Nykøbing Sjælland";"no";0;0;0;55,924722;11,670833
1689;"Nykøbing Sjælland";"no";0;0;0;55,924722;11,670833
1690;"Nykøbing Sjælland";"no";0;0;0;55,924722;11,670833
1691;"Nykøbing Sjælland";"no";0;0;0;55,924722;11,670833
1692;"Nykøbing Sjælland";"no";0;0;0;55,924722;11,670833
1693;"Nykøbing Sjælland";"no";0;0;0;55,924722;11,670833
1694;"Nykøbing Sjælland";"no";0;0;0;55,924722;11,670833
1695;"Nykøbing Sjælland";"no";0;1;1;55,924722;11,670833
1696;"Nykøbing Sjælland";"no";0;0;0;55,924722;11,670833
1697;"Nykøbing Sjælland";"no";0;1;1;55,924722;11,670833
1698;"Nykøbing Sjælland";"no";0;0;0;55,924722;11,670833
1699;"Nykøbing Sjælland";"no";0;0;0;55,924722;11,670833
1700;"Nykøbing Sjælland";"no";0;0;0;55,924722;11,670833
1701;"Nykøbing Sjælland";"no";0;0;0;55,924722;11,670833
1702;"Nykøbing Sjælland";"no";0;0;0;55,924722;11,670833
1703;"Nykøbing Sjælland";"no";0;0;0;55,924722;11,670833
1704;"Nykøbing Sjælland";"no";0;0;0;55,924722;11,670833
1705;"Nykøbing Sjælland";"no";0;0;0;55,924722;11,670833
1706;"Nykøbing Sjælland";"no";0;0;0;55,924722;11,670833
1707;"Nykøbing Sjælland";"no";0;1;1;55,924722;11,670833
1708;"Nykøbing Sjælland";"no";0;1;1;55,924722;11,670833
1709;"Nykøbing Sjælland";"no";0;0;0;55,924722;11,670833
1710;"Nykøbing Sjælland";"no";0;0;0;55,924722;11,670833
1711;"Nykøbing Sjælland";"no";0;0;0;55,924722;11,670833
1712;"Nykøbing Sjælland";"no";0;0;0;55,924722;11,670833
1713;"Nykøbing Sjælland";"no";0;0;0;55,924722;11,670833
1714;"Nykøbing Sjælland";"no";0;0;0;55,924722;11,670833
1715;"Nykøbing Sjælland";"no";0;0;0;55,924722;11,670833
1716;"Nykøbing Sjælland";"no";0;0;0;55,924722;11,670833
1717;"Nykøbing Sjælland";"no";0;0;0;55,924722;11,670833
1718;"Nykøbing Sjælland";"no";0;0;0;55,924722;11,670833
1719;"Nykøbing Sjælland";"no";0;0;0;55,924722;11,670833
1720;"Nykøbing Sjælland";"no";0;0;0;55,924722;11,670833
1721;"Nykøbing Sjælland";"no";0;0;0;55,924722;11,670833
1722;"Nykøbing Sjælland";"no";0;0;0;55,924722;11,670833
1723;"Nykøbing Sjælland";"no";0;0;0;55,924722;11,670833
1724;"Nykøbing Sjælland";"no";0;0;0;55,924722;11,670833
1725;"Nykøbing Sjælland";"no";0;0;0;55,924722;11,670833
1726;"Nykøbing Sjælland";"no";0;0;0;55,924722;11,670833
1727;"Nykøbing Sjælland";"no";0;0;0;55,924722;11,670833
1728;"Nykøbing Sjælland";"no";0;1;1;55,924722;11,670833
1729;"Nykøbing Sjælland";"no";0;0;0;55,924722;11,670833
1730;"Nykøbing Sjælland";"no";0;0;0;55,924722;11,670833
1731;"Nykøbing Sjælland";"no";0;0;0;55,924722;11,670833
1732;"Nykøbing Sjælland";"no";0;0;0;55,924722;11,670833
1733;"Nykøbing Sjælland";"no";0;0;0;55,924722;11,670833
1734;"Nykøbing Sjælland";"no";0;0;0;55,924722;11,670833
1735;"Nykøbing Sjælland";"no";0;0;0;55,924722;11,670833
1736;"Nykøbing Sjælland";"no";0;0;0;55,924722;11,670833
1737;"Nykøbing Sjælland";"no";0;0;0;55,924722;11,670833
1738;"Nykøbing Sjælland";"no";0;0;0;55,924722;11,670833
1739;"Nykøbing Sjælland";"no";0;0;0;55,924722;11,670833
1740;"Nykøbing Sjælland";"no";0;0;0;55,924722;11,670833
1741;"Nykøbing Sjælland";"no";0;0;0;55,924722;11,670833
1742;"Nykøbing Sjælland";"no";0;0;0;55,924722;11,670833
1743;"Nykøbing Sjælland";"no";0;0;0;55,924722;11,670833
1744;"Nykøbing Sjælland";"no";0;0;0;55,924722;11,670833
1745;"Nykøbing Sjælland";"no";0;0;0;55,924722;11,670833
1746;"Nykøbing Sjælland";"no";0;0;0;55,924722;11,670833
1747;"Nykøbing Sjælland";"no";0;0;0;55,924722;11,670833
1748;"Nykøbing Sjælland";"no";0;0;0;55,924722;11,670833
1749;"Nykøbing Sjælland";"no";0;0;0;55,924722;11,670833
1750;"Nykøbing Sjælland";"no";0;0;0;55,924722;11,670833
1751;"Nykøbing Sjælland";"no";0;0;0;55,924722;11,670833
1752;"Nykøbing Sjælland";"no";0;0;0;55,924722;11,670833
1753;"Nykøbing Sjælland";"no";0;1;1;55,924722;11,670833
1754;"Nykøbing Sjælland";"no";0;0;0;55,924722;11,670833
1755;"Nykøbing Sjælland";"no";0;0;0;55,924722;11,670833
1756;"Nykøbing Sjælland";"no";0;0;0;55,924722;11,670833
1757;"Nykøbing Sjælland";"no";0;0;0;55,924722;11,670833
1758;"Nykøbing Sjælland";"no";0;0;0;55,924722;11,670833
1759;"Nykøbing Sjælland";"no";0;0;0;55,924722;11,670833
1760;"Nykøbing Sjælland";"no";0;0;0;55,924722;11,670833
1761;"Nykøbing Sjælland";"no";0;0;0;55,924722;11,670833
1762;"Nykøbing Sjælland";"no";0;0;0;55,924722;11,670833
1763;"Nykøbing Sjælland";"no";0;0;0;55,924722;11,670833
1764;"Nykøbing Sjælland";"no";0;0;0;55,924722;11,670833
1765;"Nykøbing Sjælland";"no";0;0;0;55,924722;11,670833
1766;"Nykøbing Sjælland";"no";0;0;0;55,924722;11,670833
1767;"Nykøbing Sjælland";"no";0;0;0;55,924722;11,670833
1768;"Nykøbing Sjælland";"no";0;0;0;55,924722;11,670833
1769;"Nykøbing Sjælland";"no";0;0;0;55,924722;11,670833
1770;"Nykøbing Sjælland";"no";0;0;0;55,924722;11,670833
1771;"Nykøbing Sjælland";"no";0;0;0;55,924722;11,670833
1772;"Nykøbing Sjælland";"no";0;0;0;55,924722;11,670833
1773;"Nykøbing Sjælland";"no";0;0;0;55,924722;11,670833
1774;"Nykøbing Sjælland";"no";0;0;0;55,924722;11,670833
1775;"Nykøbing Sjælland";"no";0;0;0;55,924722;11,670833
1776;"Nykøbing Sjælland";"no";0;0;0;55,924722;11,670833
1777;"Nykøbing Sjælland";"no";0;0;0;55,924722;11,670833
1778;"Nykøbing Sjælland";"no";0;0;0;55,924722;11,670833
1779;"Nykøbing Sjælland";"no";0;0;0;55,924722;11,670833
1780;"Nykøbing Sjælland";"no";0;0;0;55,924722;11,670833
1781;"Nykøbing Sjælland";"no";0;0;0;55,924722;11,670833
1782;"Nykøbing Sjælland";"no";0;0;0;55,924722;11,670833
1783;"Nykøbing Sjælland";"no";0;0;0;55,924722;11,670833
1784;"Nykøbing Sjælland";"no";0;0;0;55,924722;11,670833
1785;"Nykøbing Sjælland";"no";0;0;0;55,924722;11,670833
1786;"Nykøbing Sjælland";"no";0;0;0;55,924722;11,670833
1787;"Nykøbing Sjælland";"no";0;0;0;55,924722;11,670833
1788;"Nykøbing Sjælland";"no";0;0;0;55,924722;11,670833
1789;"Nykøbing Sjælland";"no";0;0;0;55,924722;11,670833
1790;"Nykøbing Sjælland";"no";0;0;0;55,924722;11,670833
1791;"Nykøbing Sjælland";"no";0;0;0;55,924722;11,670833
1792;"Nykøbing Sjælland";"no";0;0;0;55,924722;11,670833
1793;"Nykøbing Sjælland";"no";0;0;0;55,924722;11,670833
1794;"Nykøbing Sjælland";"no";0;0;0;55,924722;11,670833
1795;"Nykøbing Sjælland";"no";0;0;0;55,924722;11,670833
1796;"Nykøbing Sjælland";"no";0;0;0;55,924722;11,670833
1797;"Nykøbing Sjælland";"no";0;0;0;55,924722;11,670833
1798;"Nykøbing Sjælland";"no";0;0;0;55,924722;11,670833
1799;"Nykøbing Sjælland";"no";0;0;0;55,924722;11,670833
1800;"Nykøbing Sjælland";"no";0;0;0;55,924722;11,670833
1801;"Nykøbing Sjælland";"no";0;0;0;55,924722;11,670833
1802;"Nykøbing Sjælland";"no";0;0;0;55,924722;11,670833
1803;"Nykøbing Sjælland";"no";0;0;0;55,924722;11,670833
1804;"Nykøbing Sjælland";"no";0;0;0;55,924722;11,670833
1805;"Nykøbing Sjælland";"no";0;0;0;55,924722;11,670833
1806;"Nykøbing Sjælland";"no";0;0;0;55,924722;11,670833
1807;"Nykøbing Sjælland";"no";0;0;0;55,924722;11,670833
1808;"Nykøbing Sjælland";"no";0;0;0;55,924722;11,670833
1809;"Nykøbing Sjælland";"no";0;0;0;55,924722;11,670833
1810;"Nykøbing Sjælland";"no";0;0;0;55,924722;11,670833
1811;"Nykøbing Sjælland";"no";0;0;0;55,924722;11,670833
1812;"Nykøbing Sjælland";"no";0;0;0;55,924722;11,670833
1813;"Nykøbing Sjælland";"no";0;0;0;55,924722;11,670833
1814;"Nykøbing Sjælland";"no";0;0;0;55,924722;11,670833
1815;"Nykøbing Sjælland";"no";0;0;0;55,924722;11,670833
1816;"Nykøbing Sjælland";"no";0;0;0;55,924722;11,670833
1817;"Nykøbing Sjælland";"no";0;0;0;55,924722;11,670833
1818;"Nykøbing Sjælland";"no";0;0;0;55,924722;11,670833
1819;"Nykøbing Sjælland";"no";0;0;0;55,924722;11,670833
1820;"Nykøbing Sjælland";"no";0;0;0;55,924722;11,670833
1821;"Nykøbing Sjælland";"no";0;0;0;55,924722;11,670833
1822;"Nykøbing Sjælland";"no";0;0;0;55,924722;11,670833
1823;"Nykøbing Sjælland";"no";0;0;0;55,924722;11,670833
1824;"Nykøbing Sjælland";"no";0;0;0;55,924722;11,670833
1825;"Nykøbing Sjælland";"no";0;0;0;55,924722;11,670833
1826;"Nykøbing Sjælland";"no";0;0;0;55,924722;11,670833
1827;"Nykøbing Sjælland";"no";0;0;0;55,924722;11,670833
1828;"Nykøbing Sjælland";"no";0;0;0;55,924722;11,670833
1829;"Nykøbing Sjælland";"no";0;0;0;55,924722;11,670833
1830;"Nykøbing Sjælland";"no";0;0;0;55,924722;11,670833
1831;"Nykøbing Sjælland";"no";0;0;0;55,924722;11,670833
1832;"Nykøbing Sjælland";"no";0;0;0;55,924722;11,670833
1833;"Nykøbing Sjælland";"no";0;0;0;55,924722;11,670833
1834;"Nykøbing Sjælland";"no";0;0;0;55,924722;11,670833
1835;"Nykøbing Sjælland";"no";0;0;0;55,924722;11,670833
1836;"Nykøbing Sjælland";"no";0;0;0;55,924722;11,670833
1837;"Nykøbing Sjælland";"no";0;0;0;55,924722;11,670833
1838;"Nykøbing Sjælland";"no";0;0;0;55,924722;11,670833
1839;"Nykøbing Sjælland";"no";0;0;0;55,924722;11,670833
1840;"Nykøbing Sjælland";"no";0;0;0;55,924722;11,670833
1841;"Nykøbing Sjælland";"no";1;0;1;55,924722;11,670833
1842;"Nykøbing Sjælland";"no";0;0;0;55,924722;11,670833
1843;"Nykøbing Sjælland";"no";0;0;0;55,924722;11,670833
1844;"Nykøbing Sjælland";"no";2;0;2;55,924722;11,670833
1845;"Nykøbing Sjælland";"no";2;0;2;55,924722;11,670833
1846;"Nykøbing Sjælland";"no";2;0;2;55,924722;11,670833
1847;"Nykøbing Sjælland";"no";0;0;0;55,924722;11,670833
1848;"Nykøbing Sjælland";"no";0;0;0;55,924722;11,670833
1849;"Nykøbing Sjælland";"no";4;1;5;55,924722;11,670833
1850;"Nykøbing Sjælland";"no";4;4;8;55,924722;11,670833
1851;"Nykøbing Sjælland";"no";6;5;11;55,924722;11,670833
1852;"Nykøbing Sjælland";"no";3;1;4;55,924722;11,670833
1853;"Nykøbing Sjælland";"no";3;3;6;55,924722;11,670833
1854;"Nykøbing Sjælland";"no";1;1;2;55,924722;11,670833
1855;"Nykøbing Sjælland";"no";4;3;7;55,924722;11,670833
1856;"Nykøbing Sjælland";"no";3;1;4;55,924722;11,670833
1857;"Nykøbing Sjælland";"no";0;1;1;55,924722;11,670833
1634;"Slangerup";"no";0;0;0;55,85;12,183333
1635;"Slangerup";"no";0;0;0;55,85;12,183333
1636;"Slangerup";"no";0;0;0;55,85;12,183333
1637;"Slangerup";"no";2;1;3;55,85;12,183333
1638;"Slangerup";"no";0;1;1;55,85;12,183333
1639;"Slangerup";"no";0;0;0;55,85;12,183333
1640;"Slangerup";"no";0;0;0;55,85;12,183333
1641;"Slangerup";"no";0;0;0;55,85;12,183333
1642;"Slangerup";"no";0;0;0;55,85;12,183333
1643;"Slangerup";"no";0;0;0;55,85;12,183333
1644;"Slangerup";"no";0;0;0;55,85;12,183333
1645;"Slangerup";"no";0;0;0;55,85;12,183333
1646;"Slangerup";"no";0;0;0;55,85;12,183333
1647;"Slangerup";"no";0;0;0;55,85;12,183333
1648;"Slangerup";"no";0;0;0;55,85;12,183333
1649;"Slangerup";"no";0;0;0;55,85;12,183333
1650;"Slangerup";"no";0;1;1;55,85;12,183333
1651;"Slangerup";"no";0;1;1;55,85;12,183333
1652;"Slangerup";"no";0;0;0;55,85;12,183333
1653;"Slangerup";"no";0;0;0;55,85;12,183333
1654;"Slangerup";"no";0;0;0;55,85;12,183333
1655;"Slangerup";"no";0;0;0;55,85;12,183333
1656;"Slangerup";"no";0;0;0;55,85;12,183333
1657;"Slangerup";"no";0;0;0;55,85;12,183333
1658;"Slangerup";"no";0;0;0;55,85;12,183333
1659;"Slangerup";"no";0;0;0;55,85;12,183333
1660;"Slangerup";"no";0;0;0;55,85;12,183333
1661;"Slangerup";"no";0;0;0;55,85;12,183333
1662;"Slangerup";"no";0;0;0;55,85;12,183333
1663;"Slangerup";"no";0;0;0;55,85;12,183333
1664;"Slangerup";"no";0;0;0;55,85;12,183333
1665;"Slangerup";"no";0;0;0;55,85;12,183333
1666;"Slangerup";"no";0;0;0;55,85;12,183333
1667;"Slangerup";"no";0;0;0;55,85;12,183333
1668;"Slangerup";"no";0;0;0;55,85;12,183333
1669;"Slangerup";"no";0;1;1;55,85;12,183333
1670;"Slangerup";"no";0;0;0;55,85;12,183333
1671;"Slangerup";"no";0;0;0;55,85;12,183333
1672;"Slangerup";"no";0;0;0;55,85;12,183333
1673;"Slangerup";"no";0;0;0;55,85;12,183333
1674;"Slangerup";"no";0;0;0;55,85;12,183333
1675;"Slangerup";"no";0;0;0;55,85;12,183333
1676;"Slangerup";"no";0;0;0;55,85;12,183333
1677;"Slangerup";"no";0;0;0;55,85;12,183333
1678;"Slangerup";"no";0;0;0;55,85;12,183333
1679;"Slangerup";"no";0;0;0;55,85;12,183333
1680;"Slangerup";"no";0;0;0;55,85;12,183333
1681;"Slangerup";"no";0;0;0;55,85;12,183333
1682;"Slangerup";"no";0;0;0;55,85;12,183333
1683;"Slangerup";"no";0;0;0;55,85;12,183333
1684;"Slangerup";"no";0;0;0;55,85;12,183333
1685;"Slangerup";"no";0;0;0;55,85;12,183333
1686;"Slangerup";"no";0;0;0;55,85;12,183333
1687;"Slangerup";"no";0;0;0;55,85;12,183333
1688;"Slangerup";"no";0;0;0;55,85;12,183333
1689;"Slangerup";"no";0;0;0;55,85;12,183333
1690;"Slangerup";"no";0;0;0;55,85;12,183333
1691;"Slangerup";"no";0;0;0;55,85;12,183333
1692;"Slangerup";"no";0;0;0;55,85;12,183333
1693;"Slangerup";"no";0;0;0;55,85;12,183333
1694;"Slangerup";"no";0;0;0;55,85;12,183333
1695;"Slangerup";"no";0;0;0;55,85;12,183333
1696;"Slangerup";"no";0;0;0;55,85;12,183333
1697;"Slangerup";"no";0;0;0;55,85;12,183333
1698;"Slangerup";"no";0;0;0;55,85;12,183333
1699;"Slangerup";"no";0;0;0;55,85;12,183333
1700;"Slangerup";"no";0;0;0;55,85;12,183333
1701;"Slangerup";"no";0;0;0;55,85;12,183333
1702;"Slangerup";"no";0;0;0;55,85;12,183333
1703;"Slangerup";"no";0;0;0;55,85;12,183333
1704;"Slangerup";"no";0;0;0;55,85;12,183333
1705;"Slangerup";"no";0;0;0;55,85;12,183333
1706;"Slangerup";"no";0;0;0;55,85;12,183333
1707;"Slangerup";"no";0;0;0;55,85;12,183333
1708;"Slangerup";"no";0;0;0;55,85;12,183333
1709;"Slangerup";"no";0;0;0;55,85;12,183333
1710;"Slangerup";"no";0;0;0;55,85;12,183333
1711;"Slangerup";"no";0;0;0;55,85;12,183333
1712;"Slangerup";"no";0;0;0;55,85;12,183333
1713;"Slangerup";"no";0;0;0;55,85;12,183333
1714;"Slangerup";"no";0;0;0;55,85;12,183333
1715;"Slangerup";"no";0;0;0;55,85;12,183333
1716;"Slangerup";"no";0;0;0;55,85;12,183333
1717;"Slangerup";"no";0;0;0;55,85;12,183333
1718;"Slangerup";"no";0;0;0;55,85;12,183333
1719;"Slangerup";"no";0;0;0;55,85;12,183333
1720;"Slangerup";"no";0;0;0;55,85;12,183333
1721;"Slangerup";"no";0;0;0;55,85;12,183333
1722;"Slangerup";"no";0;0;0;55,85;12,183333
1723;"Slangerup";"no";0;0;0;55,85;12,183333
1724;"Slangerup";"no";0;0;0;55,85;12,183333
1725;"Slangerup";"no";0;0;0;55,85;12,183333
1726;"Slangerup";"no";0;0;0;55,85;12,183333
1727;"Slangerup";"no";0;0;0;55,85;12,183333
1728;"Slangerup";"no";0;0;0;55,85;12,183333
1729;"Slangerup";"no";0;0;0;55,85;12,183333
1730;"Slangerup";"no";0;0;0;55,85;12,183333
1731;"Slangerup";"no";0;0;0;55,85;12,183333
1732;"Slangerup";"no";0;0;0;55,85;12,183333
1733;"Slangerup";"no";0;0;0;55,85;12,183333
1734;"Slangerup";"no";0;0;0;55,85;12,183333
1735;"Slangerup";"no";0;0;0;55,85;12,183333
1736;"Slangerup";"no";0;0;0;55,85;12,183333
1737;"Slangerup";"no";0;0;0;55,85;12,183333
1738;"Slangerup";"no";0;0;0;55,85;12,183333
1739;"Slangerup";"no";0;0;0;55,85;12,183333
1740;"Slangerup";"no";0;0;0;55,85;12,183333
1741;"Slangerup";"no";0;0;0;55,85;12,183333
1742;"Slangerup";"no";0;0;0;55,85;12,183333
1743;"Slangerup";"no";0;0;0;55,85;12,183333
1744;"Slangerup";"no";0;0;0;55,85;12,183333
1745;"Slangerup";"no";0;0;0;55,85;12,183333
1746;"Slangerup";"no";0;0;0;55,85;12,183333
1747;"Slangerup";"no";0;0;0;55,85;12,183333
1748;"Slangerup";"no";0;0;0;55,85;12,183333
1749;"Slangerup";"no";0;0;0;55,85;12,183333
1750;"Slangerup";"no";0;0;0;55,85;12,183333
1751;"Slangerup";"no";0;0;0;55,85;12,183333
1752;"Slangerup";"no";0;0;0;55,85;12,183333
1753;"Slangerup";"no";0;0;0;55,85;12,183333
1754;"Slangerup";"no";0;0;0;55,85;12,183333
1755;"Slangerup";"no";0;0;0;55,85;12,183333
1756;"Slangerup";"no";0;0;0;55,85;12,183333
1757;"Slangerup";"no";0;0;0;55,85;12,183333
1758;"Slangerup";"no";0;0;0;55,85;12,183333
1759;"Slangerup";"no";0;0;0;55,85;12,183333
1760;"Slangerup";"no";0;0;0;55,85;12,183333
1761;"Slangerup";"no";0;0;0;55,85;12,183333
1762;"Slangerup";"no";0;0;0;55,85;12,183333
1763;"Slangerup";"no";0;0;0;55,85;12,183333
1764;"Slangerup";"no";0;0;0;55,85;12,183333
1765;"Slangerup";"no";0;0;0;55,85;12,183333
1766;"Slangerup";"no";0;0;0;55,85;12,183333
1767;"Slangerup";"no";0;0;0;55,85;12,183333
1768;"Slangerup";"no";0;0;0;55,85;12,183333
1769;"Slangerup";"no";0;0;0;55,85;12,183333
1770;"Slangerup";"no";0;0;0;55,85;12,183333
1771;"Slangerup";"no";0;0;0;55,85;12,183333
1772;"Slangerup";"no";0;0;0;55,85;12,183333
1773;"Slangerup";"no";0;0;0;55,85;12,183333
1774;"Slangerup";"no";0;0;0;55,85;12,183333
1775;"Slangerup";"no";0;0;0;55,85;12,183333
1776;"Slangerup";"no";0;0;0;55,85;12,183333
1777;"Slangerup";"no";0;0;0;55,85;12,183333
1778;"Slangerup";"no";0;0;0;55,85;12,183333
1779;"Slangerup";"no";0;0;0;55,85;12,183333
1780;"Slangerup";"no";0;0;0;55,85;12,183333
1781;"Slangerup";"no";0;0;0;55,85;12,183333
1782;"Slangerup";"no";0;0;0;55,85;12,183333
1783;"Slangerup";"no";0;0;0;55,85;12,183333
1784;"Slangerup";"no";0;0;0;55,85;12,183333
1785;"Slangerup";"no";0;0;0;55,85;12,183333
1786;"Slangerup";"no";0;0;0;55,85;12,183333
1787;"Slangerup";"no";0;0;0;55,85;12,183333
1788;"Slangerup";"no";0;0;0;55,85;12,183333
1789;"Slangerup";"no";0;0;0;55,85;12,183333
1790;"Slangerup";"no";0;0;0;55,85;12,183333
1791;"Slangerup";"no";0;0;0;55,85;12,183333
1792;"Slangerup";"no";0;0;0;55,85;12,183333
1793;"Slangerup";"no";0;0;0;55,85;12,183333
1794;"Slangerup";"no";0;0;0;55,85;12,183333
1795;"Slangerup";"no";0;0;0;55,85;12,183333
1796;"Slangerup";"no";0;0;0;55,85;12,183333
1797;"Slangerup";"no";0;0;0;55,85;12,183333
1798;"Slangerup";"no";0;0;0;55,85;12,183333
1799;"Slangerup";"no";0;0;0;55,85;12,183333
1800;"Slangerup";"no";0;0;0;55,85;12,183333
1801;"Slangerup";"no";0;0;0;55,85;12,183333
1802;"Slangerup";"no";0;0;0;55,85;12,183333
1803;"Slangerup";"no";0;0;0;55,85;12,183333
1804;"Slangerup";"no";0;0;0;55,85;12,183333
1805;"Slangerup";"no";0;0;0;55,85;12,183333
1806;"Slangerup";"no";0;0;0;55,85;12,183333
1807;"Slangerup";"no";0;0;0;55,85;12,183333
1808;"Slangerup";"no";0;0;0;55,85;12,183333
1809;"Slangerup";"no";0;0;0;55,85;12,183333
1810;"Slangerup";"no";0;0;0;55,85;12,183333
1811;"Slangerup";"no";0;0;0;55,85;12,183333
1812;"Slangerup";"no";0;0;0;55,85;12,183333
1813;"Slangerup";"no";0;0;0;55,85;12,183333
1814;"Slangerup";"no";0;0;0;55,85;12,183333
1815;"Slangerup";"no";0;0;0;55,85;12,183333
1816;"Slangerup";"no";0;0;0;55,85;12,183333
1817;"Slangerup";"no";0;0;0;55,85;12,183333
1818;"Slangerup";"no";0;0;0;55,85;12,183333
1819;"Slangerup";"no";0;0;0;55,85;12,183333
1820;"Slangerup";"no";0;0;0;55,85;12,183333
1821;"Slangerup";"no";0;0;0;55,85;12,183333
1822;"Slangerup";"no";0;0;0;55,85;12,183333
1823;"Slangerup";"no";0;0;0;55,85;12,183333
1824;"Slangerup";"no";0;0;0;55,85;12,183333
1825;"Slangerup";"no";0;0;0;55,85;12,183333
1826;"Slangerup";"no";0;0;0;55,85;12,183333
1827;"Slangerup";"no";0;0;0;55,85;12,183333
1828;"Slangerup";"no";0;0;0;55,85;12,183333
1829;"Slangerup";"no";0;0;0;55,85;12,183333
1830;"Slangerup";"no";0;0;0;55,85;12,183333
1831;"Slangerup";"no";0;0;0;55,85;12,183333
1832;"Slangerup";"no";0;0;0;55,85;12,183333
1833;"Slangerup";"no";0;0;0;55,85;12,183333
1834;"Slangerup";"no";0;0;0;55,85;12,183333
1835;"Slangerup";"no";0;0;0;55,85;12,183333
1836;"Slangerup";"no";0;0;0;55,85;12,183333
1837;"Slangerup";"no";0;0;0;55,85;12,183333
1838;"Slangerup";"no";0;0;0;55,85;12,183333
1839;"Slangerup";"no";0;0;0;55,85;12,183333
1840;"Slangerup";"no";0;0;0;55,85;12,183333
1841;"Slangerup";"no";0;0;0;55,85;12,183333
1842;"Slangerup";"no";0;0;0;55,85;12,183333
1843;"Slangerup";"no";0;0;0;55,85;12,183333
1844;"Slangerup";"no";0;0;0;55,85;12,183333
1845;"Slangerup";"no";0;0;0;55,85;12,183333
1846;"Slangerup";"no";0;0;0;55,85;12,183333
1847;"Slangerup";"no";0;0;0;55,85;12,183333
1848;"Slangerup";"no";0;0;0;55,85;12,183333
1849;"Slangerup";"no";0;0;0;55,85;12,183333
1850;"Slangerup";"no";0;0;0;55,85;12,183333
1851;"Slangerup";"no";0;0;0;55,85;12,183333
1852;"Slangerup";"no";0;0;0;55,85;12,183333
1853;"Slangerup";"no";0;0;0;55,85;12,183333
1854;"Slangerup";"no";0;0;0;55,85;12,183333
1855;"Slangerup";"no";0;0;0;55,85;12,183333
1856;"Slangerup";"no";0;0;0;55,85;12,183333
1857;"Slangerup";"no";0;0;0;55,85;12,183333
1634;"Dronningborg";"no";0;0;0;56,4762872;10,0721052
1635;"Dronningborg";"no";0;0;0;56,4762872;10,0721052
1636;"Dronningborg";"no";0;0;0;56,4762872;10,0721052
1637;"Dronningborg";"no";0;0;0;56,4762872;10,0721052
1638;"Dronningborg";"no";2;0;2;56,4762872;10,0721052
1639;"Dronningborg";"no";0;0;0;56,4762872;10,0721052
1640;"Dronningborg";"no";0;0;0;56,4762872;10,0721052
1641;"Dronningborg";"no";0;0;0;56,4762872;10,0721052
1642;"Dronningborg";"no";0;0;0;56,4762872;10,0721052
1643;"Dronningborg";"no";0;0;0;56,4762872;10,0721052
1644;"Dronningborg";"no";0;0;0;56,4762872;10,0721052
1645;"Dronningborg";"no";0;0;0;56,4762872;10,0721052
1646;"Dronningborg";"no";0;0;0;56,4762872;10,0721052
1647;"Dronningborg";"no";0;0;0;56,4762872;10,0721052
1648;"Dronningborg";"no";0;0;0;56,4762872;10,0721052
1649;"Dronningborg";"no";0;0;0;56,4762872;10,0721052
1650;"Dronningborg";"no";0;0;0;56,4762872;10,0721052
1651;"Dronningborg";"no";0;0;0;56,4762872;10,0721052
1652;"Dronningborg";"no";0;0;0;56,4762872;10,0721052
1653;"Dronningborg";"no";0;0;0;56,4762872;10,0721052
1654;"Dronningborg";"no";0;0;0;56,4762872;10,0721052
1655;"Dronningborg";"no";0;0;0;56,4762872;10,0721052
1656;"Dronningborg";"no";0;0;0;56,4762872;10,0721052
1657;"Dronningborg";"no";0;0;0;56,4762872;10,0721052
1658;"Dronningborg";"no";0;0;0;56,4762872;10,0721052
1659;"Dronningborg";"no";0;0;0;56,4762872;10,0721052
1660;"Dronningborg";"no";0;0;0;56,4762872;10,0721052
1661;"Dronningborg";"no";0;0;0;56,4762872;10,0721052
1662;"Dronningborg";"no";0;0;0;56,4762872;10,0721052
1663;"Dronningborg";"no";0;0;0;56,4762872;10,0721052
1664;"Dronningborg";"no";0;0;0;56,4762872;10,0721052
1665;"Dronningborg";"no";0;0;0;56,4762872;10,0721052
1666;"Dronningborg";"no";0;0;0;56,4762872;10,0721052
1667;"Dronningborg";"no";0;0;0;56,4762872;10,0721052
1668;"Dronningborg";"no";0;0;0;56,4762872;10,0721052
1669;"Dronningborg";"no";0;0;0;56,4762872;10,0721052
1670;"Dronningborg";"no";0;0;0;56,4762872;10,0721052
1671;"Dronningborg";"no";0;0;0;56,4762872;10,0721052
1672;"Dronningborg";"no";0;0;0;56,4762872;10,0721052
1673;"Dronningborg";"no";0;0;0;56,4762872;10,0721052
1674;"Dronningborg";"no";0;0;0;56,4762872;10,0721052
1675;"Dronningborg";"no";0;0;0;56,4762872;10,0721052
1676;"Dronningborg";"no";0;0;0;56,4762872;10,0721052
1677;"Dronningborg";"no";0;0;0;56,4762872;10,0721052
1678;"Dronningborg";"no";0;0;0;56,4762872;10,0721052
1679;"Dronningborg";"no";0;0;0;56,4762872;10,0721052
1680;"Dronningborg";"no";0;0;0;56,4762872;10,0721052
1681;"Dronningborg";"no";0;0;0;56,4762872;10,0721052
1682;"Dronningborg";"no";0;0;0;56,4762872;10,0721052
1683;"Dronningborg";"no";0;0;0;56,4762872;10,0721052
1684;"Dronningborg";"no";0;0;0;56,4762872;10,0721052
1685;"Dronningborg";"no";0;0;0;56,4762872;10,0721052
1686;"Dronningborg";"no";0;0;0;56,4762872;10,0721052
1687;"Dronningborg";"no";0;0;0;56,4762872;10,0721052
1688;"Dronningborg";"no";0;0;0;56,4762872;10,0721052
1689;"Dronningborg";"no";0;0;0;56,4762872;10,0721052
1690;"Dronningborg";"no";0;0;0;56,4762872;10,0721052
1691;"Dronningborg";"no";0;0;0;56,4762872;10,0721052
1692;"Dronningborg";"no";0;0;0;56,4762872;10,0721052
1693;"Dronningborg";"no";0;0;0;56,4762872;10,0721052
1694;"Dronningborg";"no";0;0;0;56,4762872;10,0721052
1695;"Dronningborg";"no";0;0;0;56,4762872;10,0721052
1696;"Dronningborg";"no";0;0;0;56,4762872;10,0721052
1697;"Dronningborg";"no";0;0;0;56,4762872;10,0721052
1698;"Dronningborg";"no";0;0;0;56,4762872;10,0721052
1699;"Dronningborg";"no";0;0;0;56,4762872;10,0721052
1700;"Dronningborg";"no";0;0;0;56,4762872;10,0721052
1701;"Dronningborg";"no";0;0;0;56,4762872;10,0721052
1702;"Dronningborg";"no";0;0;0;56,4762872;10,0721052
1703;"Dronningborg";"no";0;0;0;56,4762872;10,0721052
1704;"Dronningborg";"no";0;0;0;56,4762872;10,0721052
1705;"Dronningborg";"no";0;0;0;56,4762872;10,0721052
1706;"Dronningborg";"no";0;0;0;56,4762872;10,0721052
1707;"Dronningborg";"no";0;0;0;56,4762872;10,0721052
1708;"Dronningborg";"no";0;0;0;56,4762872;10,0721052
1709;"Dronningborg";"no";0;0;0;56,4762872;10,0721052
1710;"Dronningborg";"no";0;0;0;56,4762872;10,0721052
1711;"Dronningborg";"no";0;0;0;56,4762872;10,0721052
1712;"Dronningborg";"no";0;0;0;56,4762872;10,0721052
1713;"Dronningborg";"no";0;0;0;56,4762872;10,0721052
1714;"Dronningborg";"no";0;0;0;56,4762872;10,0721052
1715;"Dronningborg";"no";0;0;0;56,4762872;10,0721052
1716;"Dronningborg";"no";0;0;0;56,4762872;10,0721052
1717;"Dronningborg";"no";0;0;0;56,4762872;10,0721052
1718;"Dronningborg";"no";0;0;0;56,4762872;10,0721052
1719;"Dronningborg";"no";0;0;0;56,4762872;10,0721052
1720;"Dronningborg";"no";0;0;0;56,4762872;10,0721052
1721;"Dronningborg";"no";0;0;0;56,4762872;10,0721052
1722;"Dronningborg";"no";0;0;0;56,4762872;10,0721052
1723;"Dronningborg";"no";0;0;0;56,4762872;10,0721052
1724;"Dronningborg";"no";0;0;0;56,4762872;10,0721052
1725;"Dronningborg";"no";0;0;0;56,4762872;10,0721052
1726;"Dronningborg";"no";0;0;0;56,4762872;10,0721052
1727;"Dronningborg";"no";0;0;0;56,4762872;10,0721052
1728;"Dronningborg";"no";0;0;0;56,4762872;10,0721052
1729;"Dronningborg";"no";0;0;0;56,4762872;10,0721052
1730;"Dronningborg";"no";0;0;0;56,4762872;10,0721052
1731;"Dronningborg";"no";0;0;0;56,4762872;10,0721052
1732;"Dronningborg";"no";0;0;0;56,4762872;10,0721052
1733;"Dronningborg";"no";0;0;0;56,4762872;10,0721052
1734;"Dronningborg";"no";0;0;0;56,4762872;10,0721052
1735;"Dronningborg";"no";0;0;0;56,4762872;10,0721052
1736;"Dronningborg";"no";0;0;0;56,4762872;10,0721052
1737;"Dronningborg";"no";0;0;0;56,4762872;10,0721052
1738;"Dronningborg";"no";0;0;0;56,4762872;10,0721052
1739;"Dronningborg";"no";0;0;0;56,4762872;10,0721052
1740;"Dronningborg";"no";0;0;0;56,4762872;10,0721052
1741;"Dronningborg";"no";0;0;0;56,4762872;10,0721052
1742;"Dronningborg";"no";0;0;0;56,4762872;10,0721052
1743;"Dronningborg";"no";0;0;0;56,4762872;10,0721052
1744;"Dronningborg";"no";0;0;0;56,4762872;10,0721052
1745;"Dronningborg";"no";0;0;0;56,4762872;10,0721052
1746;"Dronningborg";"no";0;0;0;56,4762872;10,0721052
1747;"Dronningborg";"no";0;0;0;56,4762872;10,0721052
1748;"Dronningborg";"no";0;0;0;56,4762872;10,0721052
1749;"Dronningborg";"no";0;0;0;56,4762872;10,0721052
1750;"Dronningborg";"no";0;0;0;56,4762872;10,0721052
1751;"Dronningborg";"no";0;0;0;56,4762872;10,0721052
1752;"Dronningborg";"no";0;0;0;56,4762872;10,0721052
1753;"Dronningborg";"no";0;0;0;56,4762872;10,0721052
1754;"Dronningborg";"no";0;0;0;56,4762872;10,0721052
1755;"Dronningborg";"no";0;0;0;56,4762872;10,0721052
1756;"Dronningborg";"no";0;0;0;56,4762872;10,0721052
1757;"Dronningborg";"no";0;0;0;56,4762872;10,0721052
1758;"Dronningborg";"no";0;0;0;56,4762872;10,0721052
1759;"Dronningborg";"no";0;0;0;56,4762872;10,0721052
1760;"Dronningborg";"no";0;0;0;56,4762872;10,0721052
1761;"Dronningborg";"no";0;0;0;56,4762872;10,0721052
1762;"Dronningborg";"no";0;0;0;56,4762872;10,0721052
1763;"Dronningborg";"no";0;0;0;56,4762872;10,0721052
1764;"Dronningborg";"no";0;0;0;56,4762872;10,0721052
1765;"Dronningborg";"no";0;0;0;56,4762872;10,0721052
1766;"Dronningborg";"no";0;0;0;56,4762872;10,0721052
1767;"Dronningborg";"no";0;0;0;56,4762872;10,0721052
1768;"Dronningborg";"no";0;0;0;56,4762872;10,0721052
1769;"Dronningborg";"no";0;0;0;56,4762872;10,0721052
1770;"Dronningborg";"no";0;0;0;56,4762872;10,0721052
1771;"Dronningborg";"no";0;0;0;56,4762872;10,0721052
1772;"Dronningborg";"no";0;0;0;56,4762872;10,0721052
1773;"Dronningborg";"no";0;0;0;56,4762872;10,0721052
1774;"Dronningborg";"no";0;0;0;56,4762872;10,0721052
1775;"Dronningborg";"no";0;0;0;56,4762872;10,0721052
1776;"Dronningborg";"no";0;0;0;56,4762872;10,0721052
1777;"Dronningborg";"no";0;0;0;56,4762872;10,0721052
1778;"Dronningborg";"no";0;0;0;56,4762872;10,0721052
1779;"Dronningborg";"no";0;0;0;56,4762872;10,0721052
1780;"Dronningborg";"no";0;0;0;56,4762872;10,0721052
1781;"Dronningborg";"no";0;0;0;56,4762872;10,0721052
1782;"Dronningborg";"no";0;0;0;56,4762872;10,0721052
1783;"Dronningborg";"no";0;0;0;56,4762872;10,0721052
1784;"Dronningborg";"no";0;0;0;56,4762872;10,0721052
1785;"Dronningborg";"no";0;0;0;56,4762872;10,0721052
1786;"Dronningborg";"no";0;0;0;56,4762872;10,0721052
1787;"Dronningborg";"no";0;0;0;56,4762872;10,0721052
1788;"Dronningborg";"no";0;0;0;56,4762872;10,0721052
1789;"Dronningborg";"no";0;0;0;56,4762872;10,0721052
1790;"Dronningborg";"no";0;0;0;56,4762872;10,0721052
1791;"Dronningborg";"no";0;0;0;56,4762872;10,0721052
1792;"Dronningborg";"no";0;0;0;56,4762872;10,0721052
1793;"Dronningborg";"no";0;0;0;56,4762872;10,0721052
1794;"Dronningborg";"no";0;0;0;56,4762872;10,0721052
1795;"Dronningborg";"no";0;0;0;56,4762872;10,0721052
1796;"Dronningborg";"no";0;0;0;56,4762872;10,0721052
1797;"Dronningborg";"no";0;0;0;56,4762872;10,0721052
1798;"Dronningborg";"no";0;0;0;56,4762872;10,0721052
1799;"Dronningborg";"no";0;0;0;56,4762872;10,0721052
1800;"Dronningborg";"no";0;0;0;56,4762872;10,0721052
1801;"Dronningborg";"no";0;0;0;56,4762872;10,0721052
1802;"Dronningborg";"no";0;0;0;56,4762872;10,0721052
1803;"Dronningborg";"no";0;0;0;56,4762872;10,0721052
1804;"Dronningborg";"no";0;0;0;56,4762872;10,0721052
1805;"Dronningborg";"no";0;0;0;56,4762872;10,0721052
1806;"Dronningborg";"no";0;0;0;56,4762872;10,0721052
1807;"Dronningborg";"no";0;0;0;56,4762872;10,0721052
1808;"Dronningborg";"no";0;0;0;56,4762872;10,0721052
1809;"Dronningborg";"no";0;0;0;56,4762872;10,0721052
1810;"Dronningborg";"no";0;0;0;56,4762872;10,0721052
1811;"Dronningborg";"no";0;0;0;56,4762872;10,0721052
1812;"Dronningborg";"no";0;0;0;56,4762872;10,0721052
1813;"Dronningborg";"no";0;0;0;56,4762872;10,0721052
1814;"Dronningborg";"no";0;0;0;56,4762872;10,0721052
1815;"Dronningborg";"no";0;0;0;56,4762872;10,0721052
1816;"Dronningborg";"no";0;0;0;56,4762872;10,0721052
1817;"Dronningborg";"no";0;0;0;56,4762872;10,0721052
1818;"Dronningborg";"no";0;0;0;56,4762872;10,0721052
1819;"Dronningborg";"no";0;0;0;56,4762872;10,0721052
1820;"Dronningborg";"no";0;0;0;56,4762872;10,0721052
1821;"Dronningborg";"no";0;0;0;56,4762872;10,0721052
1822;"Dronningborg";"no";0;0;0;56,4762872;10,0721052
1823;"Dronningborg";"no";0;0;0;56,4762872;10,0721052
1824;"Dronningborg";"no";0;0;0;56,4762872;10,0721052
1825;"Dronningborg";"no";0;0;0;56,4762872;10,0721052
1826;"Dronningborg";"no";0;0;0;56,4762872;10,0721052
1827;"Dronningborg";"no";0;0;0;56,4762872;10,0721052
1828;"Dronningborg";"no";0;0;0;56,4762872;10,0721052
1829;"Dronningborg";"no";0;0;0;56,4762872;10,0721052
1830;"Dronningborg";"no";0;0;0;56,4762872;10,0721052
1831;"Dronningborg";"no";0;0;0;56,4762872;10,0721052
1832;"Dronningborg";"no";0;0;0;56,4762872;10,0721052
1833;"Dronningborg";"no";0;0;0;56,4762872;10,0721052
1834;"Dronningborg";"no";0;0;0;56,4762872;10,0721052
1835;"Dronningborg";"no";0;0;0;56,4762872;10,0721052
1836;"Dronningborg";"no";0;0;0;56,4762872;10,0721052
1837;"Dronningborg";"no";0;0;0;56,4762872;10,0721052
1838;"Dronningborg";"no";0;0;0;56,4762872;10,0721052
1839;"Dronningborg";"no";0;0;0;56,4762872;10,0721052
1840;"Dronningborg";"no";0;0;0;56,4762872;10,0721052
1841;"Dronningborg";"no";0;0;0;56,4762872;10,0721052
1842;"Dronningborg";"no";0;0;0;56,4762872;10,0721052
1843;"Dronningborg";"no";0;0;0;56,4762872;10,0721052
1844;"Dronningborg";"no";0;0;0;56,4762872;10,0721052
1845;"Dronningborg";"no";0;0;0;56,4762872;10,0721052
1846;"Dronningborg";"no";0;0;0;56,4762872;10,0721052
1847;"Dronningborg";"no";0;0;0;56,4762872;10,0721052
1848;"Dronningborg";"no";0;0;0;56,4762872;10,0721052
1849;"Dronningborg";"no";0;0;0;56,4762872;10,0721052
1850;"Dronningborg";"no";0;0;0;56,4762872;10,0721052
1851;"Dronningborg";"no";0;0;0;56,4762872;10,0721052
1852;"Dronningborg";"no";0;0;0;56,4762872;10,0721052
1853;"Dronningborg";"no";0;0;0;56,4762872;10,0721052
1854;"Dronningborg";"no";0;0;0;56,4762872;10,0721052
1855;"Dronningborg";"no";0;0;0;56,4762872;10,0721052
1856;"Dronningborg";"no";0;0;0;56,4762872;10,0721052
1857;"Dronningborg";"no";0;0;0;56,4762872;10,0721052
1634;"Issefjord";"no";0;0;0;55,866666;11,816666
1635;"Issefjord";"no";0;2;2;55,866666;11,816666
1636;"Issefjord";"no";0;0;0;55,866666;11,816666
1637;"Issefjord";"no";0;0;0;55,866666;11,816666
1638;"Issefjord";"no";1;0;1;55,866666;11,816666
1639;"Issefjord";"no";0;0;0;55,866666;11,816666
1640;"Issefjord";"no";0;0;0;55,866666;11,816666
1641;"Issefjord";"no";0;1;1;55,866666;11,816666
1642;"Issefjord";"no";0;0;0;55,866666;11,816666
1643;"Issefjord";"no";1;3;4;55,866666;11,816666
1644;"Issefjord";"no";0;0;0;55,866666;11,816666
1645;"Issefjord";"no";0;0;0;55,866666;11,816666
1646;"Issefjord";"no";0;0;0;55,866666;11,816666
1647;"Issefjord";"no";0;0;0;55,866666;11,816666
1648;"Issefjord";"no";0;0;0;55,866666;11,816666
1649;"Issefjord";"no";0;0;0;55,866666;11,816666
1650;"Issefjord";"no";0;1;1;55,866666;11,816666
1651;"Issefjord";"no";0;2;2;55,866666;11,816666
1652;"Issefjord";"no";0;0;0;55,866666;11,816666
1653;"Issefjord";"no";0;1;1;55,866666;11,816666
1654;"Issefjord";"no";0;0;0;55,866666;11,816666
1655;"Issefjord";"no";0;0;0;55,866666;11,816666
1656;"Issefjord";"no";0;0;0;55,866666;11,816666
1657;"Issefjord";"no";0;0;0;55,866666;11,816666
1658;"Issefjord";"no";0;0;0;55,866666;11,816666
1659;"Issefjord";"no";0;0;0;55,866666;11,816666
1660;"Issefjord";"no";0;0;0;55,866666;11,816666
1661;"Issefjord";"no";0;0;0;55,866666;11,816666
1662;"Issefjord";"no";0;0;0;55,866666;11,816666
1663;"Issefjord";"no";0;0;0;55,866666;11,816666
1664;"Issefjord";"no";0;1;1;55,866666;11,816666
1665;"Issefjord";"no";0;0;0;55,866666;11,816666
1666;"Issefjord";"no";0;0;0;55,866666;11,816666
1667;"Issefjord";"no";0;0;0;55,866666;11,816666
1668;"Issefjord";"no";0;0;0;55,866666;11,816666
1669;"Issefjord";"no";0;1;1;55,866666;11,816666
1670;"Issefjord";"no";0;0;0;55,866666;11,816666
1671;"Issefjord";"no";0;0;0;55,866666;11,816666
1672;"Issefjord";"no";0;0;0;55,866666;11,816666
1673;"Issefjord";"no";0;0;0;55,866666;11,816666
1674;"Issefjord";"no";0;0;0;55,866666;11,816666
1675;"Issefjord";"no";0;0;0;55,866666;11,816666
1676;"Issefjord";"no";0;0;0;55,866666;11,816666
1677;"Issefjord";"no";0;0;0;55,866666;11,816666
1678;"Issefjord";"no";0;0;0;55,866666;11,816666
1679;"Issefjord";"no";0;0;0;55,866666;11,816666
1680;"Issefjord";"no";1;0;1;55,866666;11,816666
1681;"Issefjord";"no";0;0;0;55,866666;11,816666
1682;"Issefjord";"no";0;0;0;55,866666;11,816666
1683;"Issefjord";"no";0;0;0;55,866666;11,816666
1684;"Issefjord";"no";0;0;0;55,866666;11,816666
1685;"Issefjord";"no";0;0;0;55,866666;11,816666
1686;"Issefjord";"no";0;0;0;55,866666;11,816666
1687;"Issefjord";"no";0;0;0;55,866666;11,816666
1688;"Issefjord";"no";0;0;0;55,866666;11,816666
1689;"Issefjord";"no";0;0;0;55,866666;11,816666
1690;"Issefjord";"no";0;0;0;55,866666;11,816666
1691;"Issefjord";"no";0;0;0;55,866666;11,816666
1692;"Issefjord";"no";0;0;0;55,866666;11,816666
1693;"Issefjord";"no";0;0;0;55,866666;11,816666
1694;"Issefjord";"no";2;0;2;55,866666;11,816666
1695;"Issefjord";"no";0;0;0;55,866666;11,816666
1696;"Issefjord";"no";0;0;0;55,866666;11,816666
1697;"Issefjord";"no";0;0;0;55,866666;11,816666
1698;"Issefjord";"no";0;0;0;55,866666;11,816666
1699;"Issefjord";"no";0;0;0;55,866666;11,816666
1700;"Issefjord";"no";0;0;0;55,866666;11,816666
1701;"Issefjord";"no";0;0;0;55,866666;11,816666
1702;"Issefjord";"no";0;0;0;55,866666;11,816666
1703;"Issefjord";"no";0;0;0;55,866666;11,816666
1704;"Issefjord";"no";0;0;0;55,866666;11,816666
1705;"Issefjord";"no";0;0;0;55,866666;11,816666
1706;"Issefjord";"no";0;0;0;55,866666;11,816666
1707;"Issefjord";"no";0;0;0;55,866666;11,816666
1708;"Issefjord";"no";0;0;0;55,866666;11,816666
1709;"Issefjord";"no";0;0;0;55,866666;11,816666
1710;"Issefjord";"no";0;0;0;55,866666;11,816666
1711;"Issefjord";"no";1;0;1;55,866666;11,816666
1712;"Issefjord";"no";0;0;0;55,866666;11,816666
1713;"Issefjord";"no";0;0;0;55,866666;11,816666
1714;"Issefjord";"no";0;1;1;55,866666;11,816666
1715;"Issefjord";"no";0;0;0;55,866666;11,816666
1716;"Issefjord";"no";0;0;0;55,866666;11,816666
1717;"Issefjord";"no";0;0;0;55,866666;11,816666
1718;"Issefjord";"no";0;0;0;55,866666;11,816666
1719;"Issefjord";"no";0;1;1;55,866666;11,816666
1720;"Issefjord";"no";0;0;0;55,866666;11,816666
1721;"Issefjord";"no";0;0;0;55,866666;11,816666
1722;"Issefjord";"no";0;0;0;55,866666;11,816666
1723;"Issefjord";"no";0;0;0;55,866666;11,816666
1724;"Issefjord";"no";0;0;0;55,866666;11,816666
1725;"Issefjord";"no";0;0;0;55,866666;11,816666
1726;"Issefjord";"no";0;0;0;55,866666;11,816666
1727;"Issefjord";"no";0;0;0;55,866666;11,816666
1728;"Issefjord";"no";0;1;1;55,866666;11,816666
1729;"Issefjord";"no";0;1;1;55,866666;11,816666
1730;"Issefjord";"no";0;0;0;55,866666;11,816666
1731;"Issefjord";"no";0;0;0;55,866666;11,816666
1732;"Issefjord";"no";0;1;1;55,866666;11,816666
1733;"Issefjord";"no";0;2;2;55,866666;11,816666
1734;"Issefjord";"no";0;0;0;55,866666;11,816666
1735;"Issefjord";"no";0;0;0;55,866666;11,816666
1736;"Issefjord";"no";0;2;2;55,866666;11,816666
1737;"Issefjord";"no";0;1;1;55,866666;11,816666
1738;"Issefjord";"no";0;1;1;55,866666;11,816666
1739;"Issefjord";"no";0;1;1;55,866666;11,816666
1740;"Issefjord";"no";0;0;0;55,866666;11,816666
1741;"Issefjord";"no";0;0;0;55,866666;11,816666
1742;"Issefjord";"no";0;0;0;55,866666;11,816666
1743;"Issefjord";"no";0;0;0;55,866666;11,816666
1744;"Issefjord";"no";0;0;0;55,866666;11,816666
1745;"Issefjord";"no";0;0;0;55,866666;11,816666
1746;"Issefjord";"no";0;1;1;55,866666;11,816666
1747;"Issefjord";"no";0;0;0;55,866666;11,816666
1748;"Issefjord";"no";0;0;0;55,866666;11,816666
1749;"Issefjord";"no";0;0;0;55,866666;11,816666
1750;"Issefjord";"no";0;0;0;55,866666;11,816666
1751;"Issefjord";"no";0;0;0;55,866666;11,816666
1752;"Issefjord";"no";0;0;0;55,866666;11,816666
1753;"Issefjord";"no";0;0;0;55,866666;11,816666
1754;"Issefjord";"no";0;0;0;55,866666;11,816666
1755;"Issefjord";"no";0;0;0;55,866666;11,816666
1756;"Issefjord";"no";0;0;0;55,866666;11,816666
1757;"Issefjord";"no";0;0;0;55,866666;11,816666
1758;"Issefjord";"no";0;0;0;55,866666;11,816666
1759;"Issefjord";"no";0;0;0;55,866666;11,816666
1760;"Issefjord";"no";0;0;0;55,866666;11,816666
1761;"Issefjord";"no";0;0;0;55,866666;11,816666
1762;"Issefjord";"no";0;0;0;55,866666;11,816666
1763;"Issefjord";"no";0;0;0;55,866666;11,816666
1764;"Issefjord";"no";0;0;0;55,866666;11,816666
1765;"Issefjord";"no";0;0;0;55,866666;11,816666
1766;"Issefjord";"no";0;0;0;55,866666;11,816666
1767;"Issefjord";"no";0;0;0;55,866666;11,816666
1768;"Issefjord";"no";0;0;0;55,866666;11,816666
1769;"Issefjord";"no";0;0;0;55,866666;11,816666
1770;"Issefjord";"no";0;0;0;55,866666;11,816666
1771;"Issefjord";"no";0;0;0;55,866666;11,816666
1772;"Issefjord";"no";0;0;0;55,866666;11,816666
1773;"Issefjord";"no";0;0;0;55,866666;11,816666
1774;"Issefjord";"no";0;1;1;55,866666;11,816666
1775;"Issefjord";"no";0;0;0;55,866666;11,816666
1776;"Issefjord";"no";0;0;0;55,866666;11,816666
1777;"Issefjord";"no";0;0;0;55,866666;11,816666
1778;"Issefjord";"no";0;0;0;55,866666;11,816666
1779;"Issefjord";"no";0;0;0;55,866666;11,816666
1780;"Issefjord";"no";0;0;0;55,866666;11,816666
1781;"Issefjord";"no";0;0;0;55,866666;11,816666
1782;"Issefjord";"no";0;0;0;55,866666;11,816666
1783;"Issefjord";"no";0;0;0;55,866666;11,816666
1784;"Issefjord";"no";0;0;0;55,866666;11,816666
1785;"Issefjord";"no";0;0;0;55,866666;11,816666
1786;"Issefjord";"no";0;0;0;55,866666;11,816666
1787;"Issefjord";"no";0;0;0;55,866666;11,816666
1788;"Issefjord";"no";0;0;0;55,866666;11,816666
1789;"Issefjord";"no";0;0;0;55,866666;11,816666
1790;"Issefjord";"no";0;0;0;55,866666;11,816666
1791;"Issefjord";"no";0;0;0;55,866666;11,816666
1792;"Issefjord";"no";0;0;0;55,866666;11,816666
1793;"Issefjord";"no";0;0;0;55,866666;11,816666
1794;"Issefjord";"no";0;0;0;55,866666;11,816666
1795;"Issefjord";"no";0;0;0;55,866666;11,816666
1796;"Issefjord";"no";0;0;0;55,866666;11,816666
1797;"Issefjord";"no";0;0;0;55,866666;11,816666
1798;"Issefjord";"no";0;0;0;55,866666;11,816666
1799;"Issefjord";"no";0;0;0;55,866666;11,816666
1800;"Issefjord";"no";0;0;0;55,866666;11,816666
1801;"Issefjord";"no";0;0;0;55,866666;11,816666
1802;"Issefjord";"no";0;0;0;55,866666;11,816666
1803;"Issefjord";"no";0;0;0;55,866666;11,816666
1804;"Issefjord";"no";0;0;0;55,866666;11,816666
1805;"Issefjord";"no";0;0;0;55,866666;11,816666
1806;"Issefjord";"no";0;0;0;55,866666;11,816666
1807;"Issefjord";"no";0;0;0;55,866666;11,816666
1808;"Issefjord";"no";0;0;0;55,866666;11,816666
1809;"Issefjord";"no";0;0;0;55,866666;11,816666
1810;"Issefjord";"no";0;0;0;55,866666;11,816666
1811;"Issefjord";"no";0;0;0;55,866666;11,816666
1812;"Issefjord";"no";0;0;0;55,866666;11,816666
1813;"Issefjord";"no";0;0;0;55,866666;11,816666
1814;"Issefjord";"no";0;0;0;55,866666;11,816666
1815;"Issefjord";"no";0;0;0;55,866666;11,816666
1816;"Issefjord";"no";0;0;0;55,866666;11,816666
1817;"Issefjord";"no";0;0;0;55,866666;11,816666
1818;"Issefjord";"no";0;0;0;55,866666;11,816666
1819;"Issefjord";"no";0;0;0;55,866666;11,816666
1820;"Issefjord";"no";0;0;0;55,866666;11,816666
1821;"Issefjord";"no";0;0;0;55,866666;11,816666
1822;"Issefjord";"no";0;0;0;55,866666;11,816666
1823;"Issefjord";"no";0;0;0;55,866666;11,816666
1824;"Issefjord";"no";0;0;0;55,866666;11,816666
1825;"Issefjord";"no";0;0;0;55,866666;11,816666
1826;"Issefjord";"no";0;0;0;55,866666;11,816666
1827;"Issefjord";"no";0;0;0;55,866666;11,816666
1828;"Issefjord";"no";0;0;0;55,866666;11,816666
1829;"Issefjord";"no";0;0;0;55,866666;11,816666
1830;"Issefjord";"no";0;0;0;55,866666;11,816666
1831;"Issefjord";"no";0;0;0;55,866666;11,816666
1832;"Issefjord";"no";0;0;0;55,866666;11,816666
1833;"Issefjord";"no";0;0;0;55,866666;11,816666
1834;"Issefjord";"no";0;0;0;55,866666;11,816666
1835;"Issefjord";"no";0;0;0;55,866666;11,816666
1836;"Issefjord";"no";0;0;0;55,866666;11,816666
1837;"Issefjord";"no";0;0;0;55,866666;11,816666
1838;"Issefjord";"no";0;1;1;55,866666;11,816666
1839;"Issefjord";"no";0;1;1;55,866666;11,816666
1840;"Issefjord";"no";0;1;1;55,866666;11,816666
1841;"Issefjord";"no";0;1;1;55,866666;11,816666
1842;"Issefjord";"no";0;0;0;55,866666;11,816666
1843;"Issefjord";"no";0;0;0;55,866666;11,816666
1844;"Issefjord";"no";0;2;2;55,866666;11,816666
1845;"Issefjord";"no";0;2;2;55,866666;11,816666
1846;"Issefjord";"no";0;1;1;55,866666;11,816666
1847;"Issefjord";"no";0;0;0;55,866666;11,816666
1848;"Issefjord";"no";0;0;0;55,866666;11,816666
1849;"Issefjord";"no";0;2;2;55,866666;11,816666
1850;"Issefjord";"no";0;0;0;55,866666;11,816666
1851;"Issefjord";"no";0;0;0;55,866666;11,816666
1852;"Issefjord";"no";0;3;3;55,866666;11,816666
1853;"Issefjord";"no";0;0;0;55,866666;11,816666
1854;"Issefjord";"no";0;0;0;55,866666;11,816666
1855;"Issefjord";"no";0;1;1;55,866666;11,816666
1856;"Issefjord";"no";0;0;0;55,866666;11,816666
1857;"Issefjord";"no";0;0;0;55,866666;11,816666
1634;"Korsør";"no";0;0;0;55,329722;11,138333
1635;"Korsør";"no";0;0;0;55,329722;11,138333
1636;"Korsør";"no";0;0;0;55,329722;11,138333
1637;"Korsør";"no";0;2;2;55,329722;11,138333
1638;"Korsør";"no";1;0;1;55,329722;11,138333
1639;"Korsør";"no";0;0;0;55,329722;11,138333
1640;"Korsør";"no";0;0;0;55,329722;11,138333
1641;"Korsør";"no";0;0;0;55,329722;11,138333
1642;"Korsør";"no";0;0;0;55,329722;11,138333
1643;"Korsør";"no";0;0;0;55,329722;11,138333
1644;"Korsør";"no";1;0;1;55,329722;11,138333
1645;"Korsør";"no";0;1;1;55,329722;11,138333
1646;"Korsør";"no";0;0;0;55,329722;11,138333
1647;"Korsør";"no";1;0;1;55,329722;11,138333
1648;"Korsør";"no";0;1;1;55,329722;11,138333
1649;"Korsør";"no";0;0;0;55,329722;11,138333
1650;"Korsør";"no";0;1;1;55,329722;11,138333
1651;"Korsør";"no";0;0;0;55,329722;11,138333
1652;"Korsør";"no";0;0;0;55,329722;11,138333
1653;"Korsør";"no";0;0;0;55,329722;11,138333
1654;"Korsør";"no";0;0;0;55,329722;11,138333
1655;"Korsør";"no";0;0;0;55,329722;11,138333
1656;"Korsør";"no";0;0;0;55,329722;11,138333
1657;"Korsør";"no";0;0;0;55,329722;11,138333
1658;"Korsør";"no";0;0;0;55,329722;11,138333
1659;"Korsør";"no";0;0;0;55,329722;11,138333
1660;"Korsør";"no";0;0;0;55,329722;11,138333
1661;"Korsør";"no";0;0;0;55,329722;11,138333
1662;"Korsør";"no";0;0;0;55,329722;11,138333
1663;"Korsør";"no";0;1;1;55,329722;11,138333
1664;"Korsør";"no";0;0;0;55,329722;11,138333
1665;"Korsør";"no";0;0;0;55,329722;11,138333
1666;"Korsør";"no";0;0;0;55,329722;11,138333
1667;"Korsør";"no";0;0;0;55,329722;11,138333
1668;"Korsør";"no";0;0;0;55,329722;11,138333
1669;"Korsør";"no";0;0;0;55,329722;11,138333
1670;"Korsør";"no";0;1;1;55,329722;11,138333
1671;"Korsør";"no";0;0;0;55,329722;11,138333
1672;"Korsør";"no";0;1;1;55,329722;11,138333
1673;"Korsør";"no";0;2;2;55,329722;11,138333
1674;"Korsør";"no";0;2;2;55,329722;11,138333
1675;"Korsør";"no";0;0;0;55,329722;11,138333
1676;"Korsør";"no";0;0;0;55,329722;11,138333
1677;"Korsør";"no";0;0;0;55,329722;11,138333
1678;"Korsør";"no";1;0;1;55,329722;11,138333
1679;"Korsør";"no";0;0;0;55,329722;11,138333
1680;"Korsør";"no";1;0;1;55,329722;11,138333
1681;"Korsør";"no";0;0;0;55,329722;11,138333
1682;"Korsør";"no";0;0;0;55,329722;11,138333
1683;"Korsør";"no";0;0;0;55,329722;11,138333
1684;"Korsør";"no";0;0;0;55,329722;11,138333
1685;"Korsør";"no";0;0;0;55,329722;11,138333
1686;"Korsør";"no";0;0;0;55,329722;11,138333
1687;"Korsør";"no";0;0;0;55,329722;11,138333
1688;"Korsør";"no";1;0;1;55,329722;11,138333
1689;"Korsør";"no";1;0;1;55,329722;11,138333
1690;"Korsør";"no";0;0;0;55,329722;11,138333
1691;"Korsør";"no";0;0;0;55,329722;11,138333
1692;"Korsør";"no";0;2;2;55,329722;11,138333
1693;"Korsør";"no";0;0;0;55,329722;11,138333
1694;"Korsør";"no";0;0;0;55,329722;11,138333
1695;"Korsør";"no";0;0;0;55,329722;11,138333
1696;"Korsør";"no";0;0;0;55,329722;11,138333
1697;"Korsør";"no";0;0;0;55,329722;11,138333
1698;"Korsør";"no";0;0;0;55,329722;11,138333
1699;"Korsør";"no";0;0;0;55,329722;11,138333
1700;"Korsør";"no";0;0;0;55,329722;11,138333
1701;"Korsør";"no";0;0;0;55,329722;11,138333
1702;"Korsør";"no";0;0;0;55,329722;11,138333
1703;"Korsør";"no";0;0;0;55,329722;11,138333
1704;"Korsør";"no";0;0;0;55,329722;11,138333
1705;"Korsør";"no";0;0;0;55,329722;11,138333
1706;"Korsør";"no";0;0;0;55,329722;11,138333
1707;"Korsør";"no";0;1;1;55,329722;11,138333
1708;"Korsør";"no";0;0;0;55,329722;11,138333
1709;"Korsør";"no";0;1;1;55,329722;11,138333
1710;"Korsør";"no";1;0;1;55,329722;11,138333
1711;"Korsør";"no";0;0;0;55,329722;11,138333
1712;"Korsør";"no";0;0;0;55,329722;11,138333
1713;"Korsør";"no";1;0;1;55,329722;11,138333
1714;"Korsør";"no";0;1;1;55,329722;11,138333
1715;"Korsør";"no";0;0;0;55,329722;11,138333
1716;"Korsør";"no";0;0;0;55,329722;11,138333
1717;"Korsør";"no";0;0;0;55,329722;11,138333
1718;"Korsør";"no";0;0;0;55,329722;11,138333
1719;"Korsør";"no";0;0;0;55,329722;11,138333
1720;"Korsør";"no";0;0;0;55,329722;11,138333
1721;"Korsør";"no";0;0;0;55,329722;11,138333
1722;"Korsør";"no";0;0;0;55,329722;11,138333
1723;"Korsør";"no";0;0;0;55,329722;11,138333
1724;"Korsør";"no";0;0;0;55,329722;11,138333
1725;"Korsør";"no";0;0;0;55,329722;11,138333
1726;"Korsør";"no";0;0;0;55,329722;11,138333
1727;"Korsør";"no";0;1;1;55,329722;11,138333
1728;"Korsør";"no";0;0;0;55,329722;11,138333
1729;"Korsør";"no";0;0;0;55,329722;11,138333
1730;"Korsør";"no";0;0;0;55,329722;11,138333
1731;"Korsør";"no";0;0;0;55,329722;11,138333
1732;"Korsør";"no";0;0;0;55,329722;11,138333
1733;"Korsør";"no";0;1;1;55,329722;11,138333
1734;"Korsør";"no";0;0;0;55,329722;11,138333
1735;"Korsør";"no";0;2;2;55,329722;11,138333
1736;"Korsør";"no";0;0;0;55,329722;11,138333
1737;"Korsør";"no";0;0;0;55,329722;11,138333
1738;"Korsør";"no";0;1;1;55,329722;11,138333
1739;"Korsør";"no";0;0;0;55,329722;11,138333
1740;"Korsør";"no";0;0;0;55,329722;11,138333
1741;"Korsør";"no";0;1;1;55,329722;11,138333
1742;"Korsør";"no";0;2;2;55,329722;11,138333
1743;"Korsør";"no";0;0;0;55,329722;11,138333
1744;"Korsør";"no";0;0;0;55,329722;11,138333
1745;"Korsør";"no";0;0;0;55,329722;11,138333
1746;"Korsør";"no";0;0;0;55,329722;11,138333
1747;"Korsør";"no";0;1;1;55,329722;11,138333
1748;"Korsør";"no";0;0;0;55,329722;11,138333
1749;"Korsør";"no";0;0;0;55,329722;11,138333
1750;"Korsør";"no";0;0;0;55,329722;11,138333
1751;"Korsør";"no";0;1;1;55,329722;11,138333
1752;"Korsør";"no";0;0;0;55,329722;11,138333
1753;"Korsør";"no";0;0;0;55,329722;11,138333
1754;"Korsør";"no";0;0;0;55,329722;11,138333
1755;"Korsør";"no";0;0;0;55,329722;11,138333
1756;"Korsør";"no";0;0;0;55,329722;11,138333
1757;"Korsør";"no";0;0;0;55,329722;11,138333
1758;"Korsør";"no";0;0;0;55,329722;11,138333
1759;"Korsør";"no";0;0;0;55,329722;11,138333
1760;"Korsør";"no";0;0;0;55,329722;11,138333
1761;"Korsør";"no";0;2;2;55,329722;11,138333
1762;"Korsør";"no";0;0;0;55,329722;11,138333
1763;"Korsør";"no";0;0;0;55,329722;11,138333
1764;"Korsør";"no";1;0;1;55,329722;11,138333
1765;"Korsør";"no";0;0;0;55,329722;11,138333
1766;"Korsør";"no";0;0;0;55,329722;11,138333
1767;"Korsør";"no";0;1;1;55,329722;11,138333
1768;"Korsør";"no";0;0;0;55,329722;11,138333
1769;"Korsør";"no";0;1;1;55,329722;11,138333
1770;"Korsør";"no";0;0;0;55,329722;11,138333
1771;"Korsør";"no";0;0;0;55,329722;11,138333
1772;"Korsør";"no";0;0;0;55,329722;11,138333
1773;"Korsør";"no";0;0;0;55,329722;11,138333
1774;"Korsør";"no";0;2;2;55,329722;11,138333
1775;"Korsør";"no";0;1;1;55,329722;11,138333
1776;"Korsør";"no";0;1;1;55,329722;11,138333
1777;"Korsør";"no";0;0;0;55,329722;11,138333
1778;"Korsør";"no";0;0;0;55,329722;11,138333
1779;"Korsør";"no";0;0;0;55,329722;11,138333
1780;"Korsør";"no";0;0;0;55,329722;11,138333
1781;"Korsør";"no";0;2;2;55,329722;11,138333
1782;"Korsør";"no";0;0;0;55,329722;11,138333
1783;"Korsør";"no";0;0;0;55,329722;11,138333
1784;"Korsør";"no";0;0;0;55,329722;11,138333
1785;"Korsør";"no";0;0;0;55,329722;11,138333
1786;"Korsør";"no";0;0;0;55,329722;11,138333
1787;"Korsør";"no";0;0;0;55,329722;11,138333
1788;"Korsør";"no";0;0;0;55,329722;11,138333
1789;"Korsør";"no";0;0;0;55,329722;11,138333
1790;"Korsør";"no";0;1;1;55,329722;11,138333
1791;"Korsør";"no";0;0;0;55,329722;11,138333
1792;"Korsør";"no";0;0;0;55,329722;11,138333
1793;"Korsør";"no";0;2;2;55,329722;11,138333
1794;"Korsør";"no";0;0;0;55,329722;11,138333
1795;"Korsør";"no";0;0;0;55,329722;11,138333
1796;"Korsør";"no";0;0;0;55,329722;11,138333
1797;"Korsør";"no";0;1;1;55,329722;11,138333
1798;"Korsør";"no";0;0;0;55,329722;11,138333
1799;"Korsør";"no";0;0;0;55,329722;11,138333
1800;"Korsør";"no";0;0;0;55,329722;11,138333
1801;"Korsør";"no";0;0;0;55,329722;11,138333
1802;"Korsør";"no";0;0;0;55,329722;11,138333
1803;"Korsør";"no";0;0;0;55,329722;11,138333
1804;"Korsør";"no";0;0;0;55,329722;11,138333
1805;"Korsør";"no";0;1;1;55,329722;11,138333
1806;"Korsør";"no";0;1;1;55,329722;11,138333
1807;"Korsør";"no";0;0;0;55,329722;11,138333
1808;"Korsør";"no";0;0;0;55,329722;11,138333
1809;"Korsør";"no";0;0;0;55,329722;11,138333
1810;"Korsør";"no";0;1;1;55,329722;11,138333
1811;"Korsør";"no";0;1;1;55,329722;11,138333
1812;"Korsør";"no";4;0;4;55,329722;11,138333
1813;"Korsør";"no";0;0;0;55,329722;11,138333
1814;"Korsør";"no";3;0;3;55,329722;11,138333
1815;"Korsør";"no";0;0;0;55,329722;11,138333
1816;"Korsør";"no";0;1;1;55,329722;11,138333
1817;"Korsør";"no";0;0;0;55,329722;11,138333
1818;"Korsør";"no";0;0;0;55,329722;11,138333
1819;"Korsør";"no";0;0;0;55,329722;11,138333
1820;"Korsør";"no";0;0;0;55,329722;11,138333
1821;"Korsør";"no";0;0;0;55,329722;11,138333
1822;"Korsør";"no";0;2;2;55,329722;11,138333
1823;"Korsør";"no";1;1;2;55,329722;11,138333
1824;"Korsør";"no";1;0;1;55,329722;11,138333
1825;"Korsør";"no";0;1;1;55,329722;11,138333
1826;"Korsør";"no";0;0;0;55,329722;11,138333
1827;"Korsør";"no";0;1;1;55,329722;11,138333
1828;"Korsør";"no";0;2;2;55,329722;11,138333
1829;"Korsør";"no";0;0;0;55,329722;11,138333
1830;"Korsør";"no";0;1;1;55,329722;11,138333
1831;"Korsør";"no";0;0;0;55,329722;11,138333
1832;"Korsør";"no";0;0;0;55,329722;11,138333
1833;"Korsør";"no";0;1;1;55,329722;11,138333
1834;"Korsør";"no";0;3;3;55,329722;11,138333
1835;"Korsør";"no";0;0;0;55,329722;11,138333
1836;"Korsør";"no";2;1;3;55,329722;11,138333
1837;"Korsør";"no";1;1;2;55,329722;11,138333
1838;"Korsør";"no";5;1;6;55,329722;11,138333
1839;"Korsør";"no";0;1;1;55,329722;11,138333
1840;"Korsør";"no";0;1;1;55,329722;11,138333
1841;"Korsør";"no";0;0;0;55,329722;11,138333
1842;"Korsør";"no";0;1;1;55,329722;11,138333
1843;"Korsør";"no";1;1;2;55,329722;11,138333
1844;"Korsør";"no";1;0;1;55,329722;11,138333
1845;"Korsør";"no";0;1;1;55,329722;11,138333
1846;"Korsør";"no";0;1;1;55,329722;11,138333
1847;"Korsør";"no";0;1;1;55,329722;11,138333
1848;"Korsør";"no";1;4;5;55,329722;11,138333
1849;"Korsør";"no";0;4;4;55,329722;11,138333
1850;"Korsør";"no";0;2;2;55,329722;11,138333
1851;"Korsør";"no";1;5;6;55,329722;11,138333
1852;"Korsør";"no";1;2;3;55,329722;11,138333
1853;"Korsør";"no";0;0;0;55,329722;11,138333
1854;"Korsør";"no";2;3;5;55,329722;11,138333
1855;"Korsør";"no";2;3;5;55,329722;11,138333
1856;"Korsør";"no";0;2;2;55,329722;11,138333
1857;"Korsør";"no";0;0;0;55,329722;11,138333
1634;"Lemvig";"west";0;0;0;56,548333;8,31
1635;"Lemvig";"west";0;0;0;56,548333;8,31
1636;"Lemvig";"west";0;0;0;56,548333;8,31
1637;"Lemvig";"west";0;0;0;56,548333;8,31
1638;"Lemvig";"west";1;0;1;56,548333;8,31
1639;"Lemvig";"west";0;0;0;56,548333;8,31
1640;"Lemvig";"west";0;0;0;56,548333;8,31
1641;"Lemvig";"west";0;0;0;56,548333;8,31
1642;"Lemvig";"west";1;0;1;56,548333;8,31
1643;"Lemvig";"west";1;0;1;56,548333;8,31
1644;"Lemvig";"west";0;0;0;56,548333;8,31
1645;"Lemvig";"west";0;0;0;56,548333;8,31
1646;"Lemvig";"west";0;0;0;56,548333;8,31
1647;"Lemvig";"west";0;0;0;56,548333;8,31
1648;"Lemvig";"west";0;0;0;56,548333;8,31
1649;"Lemvig";"west";0;0;0;56,548333;8,31
1650;"Lemvig";"west";0;0;0;56,548333;8,31
1651;"Lemvig";"west";0;0;0;56,548333;8,31
1652;"Lemvig";"west";0;0;0;56,548333;8,31
1653;"Lemvig";"west";0;0;0;56,548333;8,31
1654;"Lemvig";"west";0;0;0;56,548333;8,31
1655;"Lemvig";"west";0;0;0;56,548333;8,31
1656;"Lemvig";"west";0;0;0;56,548333;8,31
1657;"Lemvig";"west";0;0;0;56,548333;8,31
1658;"Lemvig";"west";0;0;0;56,548333;8,31
1659;"Lemvig";"west";0;0;0;56,548333;8,31
1660;"Lemvig";"west";0;0;0;56,548333;8,31
1661;"Lemvig";"west";0;0;0;56,548333;8,31
1662;"Lemvig";"west";0;0;0;56,548333;8,31
1663;"Lemvig";"west";0;0;0;56,548333;8,31
1664;"Lemvig";"west";0;0;0;56,548333;8,31
1665;"Lemvig";"west";0;0;0;56,548333;8,31
1666;"Lemvig";"west";0;0;0;56,548333;8,31
1667;"Lemvig";"west";0;0;0;56,548333;8,31
1668;"Lemvig";"west";0;0;0;56,548333;8,31
1669;"Lemvig";"west";0;0;0;56,548333;8,31
1670;"Lemvig";"west";0;0;0;56,548333;8,31
1671;"Lemvig";"west";0;0;0;56,548333;8,31
1672;"Lemvig";"west";0;0;0;56,548333;8,31
1673;"Lemvig";"west";0;0;0;56,548333;8,31
1674;"Lemvig";"west";0;0;0;56,548333;8,31
1675;"Lemvig";"west";0;0;0;56,548333;8,31
1676;"Lemvig";"west";0;0;0;56,548333;8,31
1677;"Lemvig";"west";0;0;0;56,548333;8,31
1678;"Lemvig";"west";0;0;0;56,548333;8,31
1679;"Lemvig";"west";0;0;0;56,548333;8,31
1680;"Lemvig";"west";0;0;0;56,548333;8,31
1681;"Lemvig";"west";0;0;0;56,548333;8,31
1682;"Lemvig";"west";0;0;0;56,548333;8,31
1683;"Lemvig";"west";0;0;0;56,548333;8,31
1684;"Lemvig";"west";0;0;0;56,548333;8,31
1685;"Lemvig";"west";0;0;0;56,548333;8,31
1686;"Lemvig";"west";0;0;0;56,548333;8,31
1687;"Lemvig";"west";0;0;0;56,548333;8,31
1688;"Lemvig";"west";0;0;0;56,548333;8,31
1689;"Lemvig";"west";0;0;0;56,548333;8,31
1690;"Lemvig";"west";0;0;0;56,548333;8,31
1691;"Lemvig";"west";0;0;0;56,548333;8,31
1692;"Lemvig";"west";0;0;0;56,548333;8,31
1693;"Lemvig";"west";0;0;0;56,548333;8,31
1694;"Lemvig";"west";0;0;0;56,548333;8,31
1695;"Lemvig";"west";0;0;0;56,548333;8,31
1696;"Lemvig";"west";0;0;0;56,548333;8,31
1697;"Lemvig";"west";0;0;0;56,548333;8,31
1698;"Lemvig";"west";0;0;0;56,548333;8,31
1699;"Lemvig";"west";0;0;0;56,548333;8,31
1700;"Lemvig";"west";0;0;0;56,548333;8,31
1701;"Lemvig";"west";0;0;0;56,548333;8,31
1702;"Lemvig";"west";0;0;0;56,548333;8,31
1703;"Lemvig";"west";0;0;0;56,548333;8,31
1704;"Lemvig";"west";0;0;0;56,548333;8,31
1705;"Lemvig";"west";0;0;0;56,548333;8,31
1706;"Lemvig";"west";0;0;0;56,548333;8,31
1707;"Lemvig";"west";0;0;0;56,548333;8,31
1708;"Lemvig";"west";0;0;0;56,548333;8,31
1709;"Lemvig";"west";0;0;0;56,548333;8,31
1710;"Lemvig";"west";0;0;0;56,548333;8,31
1711;"Lemvig";"west";0;0;0;56,548333;8,31
1712;"Lemvig";"west";0;0;0;56,548333;8,31
1713;"Lemvig";"west";0;0;0;56,548333;8,31
1714;"Lemvig";"west";0;0;0;56,548333;8,31
1715;"Lemvig";"west";0;0;0;56,548333;8,31
1716;"Lemvig";"west";0;0;0;56,548333;8,31
1717;"Lemvig";"west";0;0;0;56,548333;8,31
1718;"Lemvig";"west";0;0;0;56,548333;8,31
1719;"Lemvig";"west";0;0;0;56,548333;8,31
1720;"Lemvig";"west";0;0;0;56,548333;8,31
1721;"Lemvig";"west";0;0;0;56,548333;8,31
1722;"Lemvig";"west";0;0;0;56,548333;8,31
1723;"Lemvig";"west";0;0;0;56,548333;8,31
1724;"Lemvig";"west";0;0;0;56,548333;8,31
1725;"Lemvig";"west";0;0;0;56,548333;8,31
1726;"Lemvig";"west";0;0;0;56,548333;8,31
1727;"Lemvig";"west";0;0;0;56,548333;8,31
1728;"Lemvig";"west";0;0;0;56,548333;8,31
1729;"Lemvig";"west";0;0;0;56,548333;8,31
1730;"Lemvig";"west";0;0;0;56,548333;8,31
1731;"Lemvig";"west";0;0;0;56,548333;8,31
1732;"Lemvig";"west";0;0;0;56,548333;8,31
1733;"Lemvig";"west";0;0;0;56,548333;8,31
1734;"Lemvig";"west";0;0;0;56,548333;8,31
1735;"Lemvig";"west";0;0;0;56,548333;8,31
1736;"Lemvig";"west";0;0;0;56,548333;8,31
1737;"Lemvig";"west";0;0;0;56,548333;8,31
1738;"Lemvig";"west";0;0;0;56,548333;8,31
1739;"Lemvig";"west";0;0;0;56,548333;8,31
1740;"Lemvig";"west";0;0;0;56,548333;8,31
1741;"Lemvig";"west";0;0;0;56,548333;8,31
1742;"Lemvig";"west";0;0;0;56,548333;8,31
1743;"Lemvig";"west";0;0;0;56,548333;8,31
1744;"Lemvig";"west";0;0;0;56,548333;8,31
1745;"Lemvig";"west";0;0;0;56,548333;8,31
1746;"Lemvig";"west";0;0;0;56,548333;8,31
1747;"Lemvig";"west";0;0;0;56,548333;8,31
1748;"Lemvig";"west";0;0;0;56,548333;8,31
1749;"Lemvig";"west";0;0;0;56,548333;8,31
1750;"Lemvig";"west";0;0;0;56,548333;8,31
1751;"Lemvig";"west";0;0;0;56,548333;8,31
1752;"Lemvig";"west";0;0;0;56,548333;8,31
1753;"Lemvig";"west";0;0;0;56,548333;8,31
1754;"Lemvig";"west";0;0;0;56,548333;8,31
1755;"Lemvig";"west";0;0;0;56,548333;8,31
1756;"Lemvig";"west";0;0;0;56,548333;8,31
1757;"Lemvig";"west";0;0;0;56,548333;8,31
1758;"Lemvig";"west";0;0;0;56,548333;8,31
1759;"Lemvig";"west";0;0;0;56,548333;8,31
1760;"Lemvig";"west";0;0;0;56,548333;8,31
1761;"Lemvig";"west";0;0;0;56,548333;8,31
1762;"Lemvig";"west";0;0;0;56,548333;8,31
1763;"Lemvig";"west";0;0;0;56,548333;8,31
1764;"Lemvig";"west";0;0;0;56,548333;8,31
1765;"Lemvig";"west";0;0;0;56,548333;8,31
1766;"Lemvig";"west";0;0;0;56,548333;8,31
1767;"Lemvig";"west";0;0;0;56,548333;8,31
1768;"Lemvig";"west";0;0;0;56,548333;8,31
1769;"Lemvig";"west";0;0;0;56,548333;8,31
1770;"Lemvig";"west";0;0;0;56,548333;8,31
1771;"Lemvig";"west";0;0;0;56,548333;8,31
1772;"Lemvig";"west";0;0;0;56,548333;8,31
1773;"Lemvig";"west";0;0;0;56,548333;8,31
1774;"Lemvig";"west";0;0;0;56,548333;8,31
1775;"Lemvig";"west";0;0;0;56,548333;8,31
1776;"Lemvig";"west";0;0;0;56,548333;8,31
1777;"Lemvig";"west";0;0;0;56,548333;8,31
1778;"Lemvig";"west";0;0;0;56,548333;8,31
1779;"Lemvig";"west";0;0;0;56,548333;8,31
1780;"Lemvig";"west";0;0;0;56,548333;8,31
1781;"Lemvig";"west";0;0;0;56,548333;8,31
1782;"Lemvig";"west";0;0;0;56,548333;8,31
1783;"Lemvig";"west";0;0;0;56,548333;8,31
1784;"Lemvig";"west";0;0;0;56,548333;8,31
1785;"Lemvig";"west";0;0;0;56,548333;8,31
1786;"Lemvig";"west";0;0;0;56,548333;8,31
1787;"Lemvig";"west";0;0;0;56,548333;8,31
1788;"Lemvig";"west";0;0;0;56,548333;8,31
1789;"Lemvig";"west";0;0;0;56,548333;8,31
1790;"Lemvig";"west";0;0;0;56,548333;8,31
1791;"Lemvig";"west";0;0;0;56,548333;8,31
1792;"Lemvig";"west";0;0;0;56,548333;8,31
1793;"Lemvig";"west";0;0;0;56,548333;8,31
1794;"Lemvig";"west";0;0;0;56,548333;8,31
1795;"Lemvig";"west";0;0;0;56,548333;8,31
1796;"Lemvig";"west";0;0;0;56,548333;8,31
1797;"Lemvig";"west";0;0;0;56,548333;8,31
1798;"Lemvig";"west";0;0;0;56,548333;8,31
1799;"Lemvig";"west";0;0;0;56,548333;8,31
1800;"Lemvig";"west";0;0;0;56,548333;8,31
1801;"Lemvig";"west";0;0;0;56,548333;8,31
1802;"Lemvig";"west";0;0;0;56,548333;8,31
1803;"Lemvig";"west";0;0;0;56,548333;8,31
1804;"Lemvig";"west";0;0;0;56,548333;8,31
1805;"Lemvig";"west";0;0;0;56,548333;8,31
1806;"Lemvig";"west";0;0;0;56,548333;8,31
1807;"Lemvig";"west";0;0;0;56,548333;8,31
1808;"Lemvig";"west";0;0;0;56,548333;8,31
1809;"Lemvig";"west";0;0;0;56,548333;8,31
1810;"Lemvig";"west";0;0;0;56,548333;8,31
1811;"Lemvig";"west";0;0;0;56,548333;8,31
1812;"Lemvig";"west";0;0;0;56,548333;8,31
1813;"Lemvig";"west";0;0;0;56,548333;8,31
1814;"Lemvig";"west";0;0;0;56,548333;8,31
1815;"Lemvig";"west";0;0;0;56,548333;8,31
1816;"Lemvig";"west";0;0;0;56,548333;8,31
1817;"Lemvig";"west";0;0;0;56,548333;8,31
1818;"Lemvig";"west";0;0;0;56,548333;8,31
1819;"Lemvig";"west";0;0;0;56,548333;8,31
1820;"Lemvig";"west";0;0;0;56,548333;8,31
1821;"Lemvig";"west";0;0;0;56,548333;8,31
1822;"Lemvig";"west";0;0;0;56,548333;8,31
1823;"Lemvig";"west";0;0;0;56,548333;8,31
1824;"Lemvig";"west";0;0;0;56,548333;8,31
1825;"Lemvig";"west";0;0;0;56,548333;8,31
1826;"Lemvig";"west";0;0;0;56,548333;8,31
1827;"Lemvig";"west";0;0;0;56,548333;8,31
1828;"Lemvig";"west";0;0;0;56,548333;8,31
1829;"Lemvig";"west";0;0;0;56,548333;8,31
1830;"Lemvig";"west";0;0;0;56,548333;8,31
1831;"Lemvig";"west";0;0;0;56,548333;8,31
1832;"Lemvig";"west";0;0;0;56,548333;8,31
1833;"Lemvig";"west";0;0;0;56,548333;8,31
1834;"Lemvig";"west";0;0;0;56,548333;8,31
1835;"Lemvig";"west";0;0;0;56,548333;8,31
1836;"Lemvig";"west";0;0;0;56,548333;8,31
1837;"Lemvig";"west";0;0;0;56,548333;8,31
1838;"Lemvig";"west";0;1;1;56,548333;8,31
1839;"Lemvig";"west";1;0;1;56,548333;8,31
1840;"Lemvig";"west";0;0;0;56,548333;8,31
1841;"Lemvig";"west";1;1;2;56,548333;8,31
1842;"Lemvig";"west";1;1;2;56,548333;8,31
1843;"Lemvig";"west";2;1;3;56,548333;8,31
1844;"Lemvig";"west";7;2;9;56,548333;8,31
1845;"Lemvig";"west";1;0;1;56,548333;8,31
1846;"Lemvig";"west";8;0;8;56,548333;8,31
1847;"Lemvig";"west";6;2;8;56,548333;8,31
1848;"Lemvig";"west";3;2;5;56,548333;8,31
1849;"Lemvig";"west";6;1;7;56,548333;8,31
1850;"Lemvig";"west";1;2;3;56,548333;8,31
1851;"Lemvig";"west";5;1;6;56,548333;8,31
1852;"Lemvig";"west";8;0;8;56,548333;8,31
1853;"Lemvig";"west";4;1;5;56,548333;8,31
1854;"Lemvig";"west";2;0;2;56,548333;8,31
1855;"Lemvig";"west";2;0;2;56,548333;8,31
1856;"Lemvig";"west";8;0;8;56,548333;8,31
1857;"Lemvig";"west";0;0;0;56,548333;8,31
1634;"Nykøbing Mors";"west";0;0;0;56,793333;8,852777
1635;"Nykøbing Mors";"west";0;0;0;56,793333;8,852777
1636;"Nykøbing Mors";"west";0;0;0;56,793333;8,852777
1637;"Nykøbing Mors";"west";0;0;0;56,793333;8,852777
1638;"Nykøbing Mors";"west";1;0;1;56,793333;8,852777
1639;"Nykøbing Mors";"west";0;0;0;56,793333;8,852777
1640;"Nykøbing Mors";"west";0;0;0;56,793333;8,852777
1641;"Nykøbing Mors";"west";0;0;0;56,793333;8,852777
1642;"Nykøbing Mors";"west";1;0;1;56,793333;8,852777
1643;"Nykøbing Mors";"west";2;0;2;56,793333;8,852777
1644;"Nykøbing Mors";"west";0;0;0;56,793333;8,852777
1645;"Nykøbing Mors";"west";0;0;0;56,793333;8,852777
1646;"Nykøbing Mors";"west";0;0;0;56,793333;8,852777
1647;"Nykøbing Mors";"west";0;0;0;56,793333;8,852777
1648;"Nykøbing Mors";"west";0;0;0;56,793333;8,852777
1649;"Nykøbing Mors";"west";0;0;0;56,793333;8,852777
1650;"Nykøbing Mors";"west";0;0;0;56,793333;8,852777
1651;"Nykøbing Mors";"west";0;0;0;56,793333;8,852777
1652;"Nykøbing Mors";"west";0;0;0;56,793333;8,852777
1653;"Nykøbing Mors";"west";0;0;0;56,793333;8,852777
1654;"Nykøbing Mors";"west";0;0;0;56,793333;8,852777
1655;"Nykøbing Mors";"west";0;0;0;56,793333;8,852777
1656;"Nykøbing Mors";"west";0;0;0;56,793333;8,852777
1657;"Nykøbing Mors";"west";0;0;0;56,793333;8,852777
1658;"Nykøbing Mors";"west";1;0;1;56,793333;8,852777
1659;"Nykøbing Mors";"west";0;0;0;56,793333;8,852777
1660;"Nykøbing Mors";"west";0;0;0;56,793333;8,852777
1661;"Nykøbing Mors";"west";0;0;0;56,793333;8,852777
1662;"Nykøbing Mors";"west";1;0;1;56,793333;8,852777
1663;"Nykøbing Mors";"west";0;0;0;56,793333;8,852777
1664;"Nykøbing Mors";"west";0;0;0;56,793333;8,852777
1665;"Nykøbing Mors";"west";0;0;0;56,793333;8,852777
1666;"Nykøbing Mors";"west";0;0;0;56,793333;8,852777
1667;"Nykøbing Mors";"west";0;0;0;56,793333;8,852777
1668;"Nykøbing Mors";"west";0;0;0;56,793333;8,852777
1669;"Nykøbing Mors";"west";0;1;1;56,793333;8,852777
1670;"Nykøbing Mors";"west";0;0;0;56,793333;8,852777
1671;"Nykøbing Mors";"west";1;0;1;56,793333;8,852777
1672;"Nykøbing Mors";"west";0;0;0;56,793333;8,852777
1673;"Nykøbing Mors";"west";1;0;1;56,793333;8,852777
1674;"Nykøbing Mors";"west";0;0;0;56,793333;8,852777
1675;"Nykøbing Mors";"west";0;0;0;56,793333;8,852777
1676;"Nykøbing Mors";"west";0;0;0;56,793333;8,852777
1677;"Nykøbing Mors";"west";0;0;0;56,793333;8,852777
1678;"Nykøbing Mors";"west";0;0;0;56,793333;8,852777
1679;"Nykøbing Mors";"west";0;0;0;56,793333;8,852777
1680;"Nykøbing Mors";"west";0;0;0;56,793333;8,852777
1681;"Nykøbing Mors";"west";0;3;3;56,793333;8,852777
1682;"Nykøbing Mors";"west";0;2;2;56,793333;8,852777
1683;"Nykøbing Mors";"west";0;0;0;56,793333;8,852777
1684;"Nykøbing Mors";"west";2;0;2;56,793333;8,852777
1685;"Nykøbing Mors";"west";0;0;0;56,793333;8,852777
1686;"Nykøbing Mors";"west";1;0;1;56,793333;8,852777
1687;"Nykøbing Mors";"west";0;0;0;56,793333;8,852777
1688;"Nykøbing Mors";"west";0;0;0;56,793333;8,852777
1689;"Nykøbing Mors";"west";0;0;0;56,793333;8,852777
1690;"Nykøbing Mors";"west";0;0;0;56,793333;8,852777
1691;"Nykøbing Mors";"west";0;0;0;56,793333;8,852777
1692;"Nykøbing Mors";"west";0;0;0;56,793333;8,852777
1693;"Nykøbing Mors";"west";0;0;0;56,793333;8,852777
1694;"Nykøbing Mors";"west";0;0;0;56,793333;8,852777
1695;"Nykøbing Mors";"west";0;0;0;56,793333;8,852777
1696;"Nykøbing Mors";"west";0;0;0;56,793333;8,852777
1697;"Nykøbing Mors";"west";0;0;0;56,793333;8,852777
1698;"Nykøbing Mors";"west";0;0;0;56,793333;8,852777
1699;"Nykøbing Mors";"west";0;0;0;56,793333;8,852777
1700;"Nykøbing Mors";"west";0;0;0;56,793333;8,852777
1701;"Nykøbing Mors";"west";0;0;0;56,793333;8,852777
1702;"Nykøbing Mors";"west";0;0;0;56,793333;8,852777
1703;"Nykøbing Mors";"west";0;0;0;56,793333;8,852777
1704;"Nykøbing Mors";"west";0;0;0;56,793333;8,852777
1705;"Nykøbing Mors";"west";0;0;0;56,793333;8,852777
1706;"Nykøbing Mors";"west";0;0;0;56,793333;8,852777
1707;"Nykøbing Mors";"west";0;0;0;56,793333;8,852777
1708;"Nykøbing Mors";"west";0;0;0;56,793333;8,852777
1709;"Nykøbing Mors";"west";0;0;0;56,793333;8,852777
1710;"Nykøbing Mors";"west";0;0;0;56,793333;8,852777
1711;"Nykøbing Mors";"west";0;0;0;56,793333;8,852777
1712;"Nykøbing Mors";"west";0;0;0;56,793333;8,852777
1713;"Nykøbing Mors";"west";0;0;0;56,793333;8,852777
1714;"Nykøbing Mors";"west";0;0;0;56,793333;8,852777
1715;"Nykøbing Mors";"west";0;0;0;56,793333;8,852777
1716;"Nykøbing Mors";"west";0;0;0;56,793333;8,852777
1717;"Nykøbing Mors";"west";0;0;0;56,793333;8,852777
1718;"Nykøbing Mors";"west";0;0;0;56,793333;8,852777
1719;"Nykøbing Mors";"west";0;0;0;56,793333;8,852777
1720;"Nykøbing Mors";"west";0;0;0;56,793333;8,852777
1721;"Nykøbing Mors";"west";0;0;0;56,793333;8,852777
1722;"Nykøbing Mors";"west";0;0;0;56,793333;8,852777
1723;"Nykøbing Mors";"west";0;0;0;56,793333;8,852777
1724;"Nykøbing Mors";"west";0;0;0;56,793333;8,852777
1725;"Nykøbing Mors";"west";0;0;0;56,793333;8,852777
1726;"Nykøbing Mors";"west";0;0;0;56,793333;8,852777
1727;"Nykøbing Mors";"west";0;0;0;56,793333;8,852777
1728;"Nykøbing Mors";"west";0;0;0;56,793333;8,852777
1729;"Nykøbing Mors";"west";0;0;0;56,793333;8,852777
1730;"Nykøbing Mors";"west";0;0;0;56,793333;8,852777
1731;"Nykøbing Mors";"west";0;0;0;56,793333;8,852777
1732;"Nykøbing Mors";"west";0;0;0;56,793333;8,852777
1733;"Nykøbing Mors";"west";0;0;0;56,793333;8,852777
1734;"Nykøbing Mors";"west";0;0;0;56,793333;8,852777
1735;"Nykøbing Mors";"west";0;0;0;56,793333;8,852777
1736;"Nykøbing Mors";"west";0;0;0;56,793333;8,852777
1737;"Nykøbing Mors";"west";0;0;0;56,793333;8,852777
1738;"Nykøbing Mors";"west";0;0;0;56,793333;8,852777
1739;"Nykøbing Mors";"west";0;0;0;56,793333;8,852777
1740;"Nykøbing Mors";"west";0;0;0;56,793333;8,852777
1741;"Nykøbing Mors";"west";0;0;0;56,793333;8,852777
1742;"Nykøbing Mors";"west";0;0;0;56,793333;8,852777
1743;"Nykøbing Mors";"west";0;0;0;56,793333;8,852777
1744;"Nykøbing Mors";"west";0;0;0;56,793333;8,852777
1745;"Nykøbing Mors";"west";0;0;0;56,793333;8,852777
1746;"Nykøbing Mors";"west";0;0;0;56,793333;8,852777
1747;"Nykøbing Mors";"west";0;0;0;56,793333;8,852777
1748;"Nykøbing Mors";"west";0;0;0;56,793333;8,852777
1749;"Nykøbing Mors";"west";0;0;0;56,793333;8,852777
1750;"Nykøbing Mors";"west";0;0;0;56,793333;8,852777
1751;"Nykøbing Mors";"west";0;0;0;56,793333;8,852777
1752;"Nykøbing Mors";"west";0;0;0;56,793333;8,852777
1753;"Nykøbing Mors";"west";0;0;0;56,793333;8,852777
1754;"Nykøbing Mors";"west";0;0;0;56,793333;8,852777
1755;"Nykøbing Mors";"west";0;0;0;56,793333;8,852777
1756;"Nykøbing Mors";"west";0;0;0;56,793333;8,852777
1757;"Nykøbing Mors";"west";0;0;0;56,793333;8,852777
1758;"Nykøbing Mors";"west";0;1;1;56,793333;8,852777
1759;"Nykøbing Mors";"west";0;0;0;56,793333;8,852777
1760;"Nykøbing Mors";"west";0;0;0;56,793333;8,852777
1761;"Nykøbing Mors";"west";0;0;0;56,793333;8,852777
1762;"Nykøbing Mors";"west";0;0;0;56,793333;8,852777
1763;"Nykøbing Mors";"west";0;0;0;56,793333;8,852777
1764;"Nykøbing Mors";"west";0;0;0;56,793333;8,852777
1765;"Nykøbing Mors";"west";0;0;0;56,793333;8,852777
1766;"Nykøbing Mors";"west";0;0;0;56,793333;8,852777
1767;"Nykøbing Mors";"west";0;0;0;56,793333;8,852777
1768;"Nykøbing Mors";"west";0;0;0;56,793333;8,852777
1769;"Nykøbing Mors";"west";0;0;0;56,793333;8,852777
1770;"Nykøbing Mors";"west";0;0;0;56,793333;8,852777
1771;"Nykøbing Mors";"west";0;0;0;56,793333;8,852777
1772;"Nykøbing Mors";"west";0;0;0;56,793333;8,852777
1773;"Nykøbing Mors";"west";0;0;0;56,793333;8,852777
1774;"Nykøbing Mors";"west";0;0;0;56,793333;8,852777
1775;"Nykøbing Mors";"west";0;0;0;56,793333;8,852777
1776;"Nykøbing Mors";"west";0;0;0;56,793333;8,852777
1777;"Nykøbing Mors";"west";0;0;0;56,793333;8,852777
1778;"Nykøbing Mors";"west";0;0;0;56,793333;8,852777
1779;"Nykøbing Mors";"west";0;0;0;56,793333;8,852777
1780;"Nykøbing Mors";"west";0;0;0;56,793333;8,852777
1781;"Nykøbing Mors";"west";0;0;0;56,793333;8,852777
1782;"Nykøbing Mors";"west";0;0;0;56,793333;8,852777
1783;"Nykøbing Mors";"west";0;0;0;56,793333;8,852777
1784;"Nykøbing Mors";"west";0;0;0;56,793333;8,852777
1785;"Nykøbing Mors";"west";0;0;0;56,793333;8,852777
1786;"Nykøbing Mors";"west";0;0;0;56,793333;8,852777
1787;"Nykøbing Mors";"west";0;0;0;56,793333;8,852777
1788;"Nykøbing Mors";"west";0;0;0;56,793333;8,852777
1789;"Nykøbing Mors";"west";0;0;0;56,793333;8,852777
1790;"Nykøbing Mors";"west";0;0;0;56,793333;8,852777
1791;"Nykøbing Mors";"west";0;0;0;56,793333;8,852777
1792;"Nykøbing Mors";"west";0;0;0;56,793333;8,852777
1793;"Nykøbing Mors";"west";0;0;0;56,793333;8,852777
1794;"Nykøbing Mors";"west";0;0;0;56,793333;8,852777
1795;"Nykøbing Mors";"west";0;0;0;56,793333;8,852777
1796;"Nykøbing Mors";"west";0;0;0;56,793333;8,852777
1797;"Nykøbing Mors";"west";0;0;0;56,793333;8,852777
1798;"Nykøbing Mors";"west";0;0;0;56,793333;8,852777
1799;"Nykøbing Mors";"west";0;0;0;56,793333;8,852777
1800;"Nykøbing Mors";"west";0;0;0;56,793333;8,852777
1801;"Nykøbing Mors";"west";0;0;0;56,793333;8,852777
1802;"Nykøbing Mors";"west";0;0;0;56,793333;8,852777
1803;"Nykøbing Mors";"west";0;0;0;56,793333;8,852777
1804;"Nykøbing Mors";"west";0;0;0;56,793333;8,852777
1805;"Nykøbing Mors";"west";0;0;0;56,793333;8,852777
1806;"Nykøbing Mors";"west";0;0;0;56,793333;8,852777
1807;"Nykøbing Mors";"west";0;0;0;56,793333;8,852777
1808;"Nykøbing Mors";"west";0;0;0;56,793333;8,852777
1809;"Nykøbing Mors";"west";0;0;0;56,793333;8,852777
1810;"Nykøbing Mors";"west";0;0;0;56,793333;8,852777
1811;"Nykøbing Mors";"west";0;0;0;56,793333;8,852777
1812;"Nykøbing Mors";"west";0;0;0;56,793333;8,852777
1813;"Nykøbing Mors";"west";0;0;0;56,793333;8,852777
1814;"Nykøbing Mors";"west";0;0;0;56,793333;8,852777
1815;"Nykøbing Mors";"west";0;0;0;56,793333;8,852777
1816;"Nykøbing Mors";"west";0;0;0;56,793333;8,852777
1817;"Nykøbing Mors";"west";0;0;0;56,793333;8,852777
1818;"Nykøbing Mors";"west";0;0;0;56,793333;8,852777
1819;"Nykøbing Mors";"west";0;0;0;56,793333;8,852777
1820;"Nykøbing Mors";"west";0;0;0;56,793333;8,852777
1821;"Nykøbing Mors";"west";0;0;0;56,793333;8,852777
1822;"Nykøbing Mors";"west";0;0;0;56,793333;8,852777
1823;"Nykøbing Mors";"west";0;0;0;56,793333;8,852777
1824;"Nykøbing Mors";"west";0;0;0;56,793333;8,852777
1825;"Nykøbing Mors";"west";0;0;0;56,793333;8,852777
1826;"Nykøbing Mors";"west";0;0;0;56,793333;8,852777
1827;"Nykøbing Mors";"west";0;0;0;56,793333;8,852777
1828;"Nykøbing Mors";"west";0;0;0;56,793333;8,852777
1829;"Nykøbing Mors";"west";0;0;0;56,793333;8,852777
1830;"Nykøbing Mors";"west";0;0;0;56,793333;8,852777
1831;"Nykøbing Mors";"west";0;0;0;56,793333;8,852777
1832;"Nykøbing Mors";"west";0;0;0;56,793333;8,852777
1833;"Nykøbing Mors";"west";0;0;0;56,793333;8,852777
1834;"Nykøbing Mors";"west";0;0;0;56,793333;8,852777
1835;"Nykøbing Mors";"west";0;0;0;56,793333;8,852777
1836;"Nykøbing Mors";"west";0;0;0;56,793333;8,852777
1837;"Nykøbing Mors";"west";0;0;0;56,793333;8,852777
1838;"Nykøbing Mors";"west";0;0;0;56,793333;8,852777
1839;"Nykøbing Mors";"west";0;0;0;56,793333;8,852777
1840;"Nykøbing Mors";"west";0;0;0;56,793333;8,852777
1841;"Nykøbing Mors";"west";0;0;0;56,793333;8,852777
1842;"Nykøbing Mors";"west";0;0;0;56,793333;8,852777
1843;"Nykøbing Mors";"west";1;0;1;56,793333;8,852777
1844;"Nykøbing Mors";"west";0;0;0;56,793333;8,852777
1845;"Nykøbing Mors";"west";1;0;1;56,793333;8,852777
1846;"Nykøbing Mors";"west";2;3;5;56,793333;8,852777
1847;"Nykøbing Mors";"west";1;2;3;56,793333;8,852777
1848;"Nykøbing Mors";"west";1;0;1;56,793333;8,852777
1849;"Nykøbing Mors";"west";0;0;0;56,793333;8,852777
1850;"Nykøbing Mors";"west";3;0;3;56,793333;8,852777
1851;"Nykøbing Mors";"west";0;0;0;56,793333;8,852777
1852;"Nykøbing Mors";"west";2;0;2;56,793333;8,852777
1853;"Nykøbing Mors";"west";4;0;4;56,793333;8,852777
1854;"Nykøbing Mors";"west";2;0;2;56,793333;8,852777
1855;"Nykøbing Mors";"west";1;0;1;56,793333;8,852777
1856;"Nykøbing Mors";"west";10;0;10;56,793333;8,852777
1857;"Nykøbing Mors";"west";0;0;0;56,793333;8,852777
1634;"Stubbekøbing";"no";0;0;0;54,888611;12,040833
1635;"Stubbekøbing";"no";0;1;1;54,888611;12,040833
1636;"Stubbekøbing";"no";0;0;0;54,888611;12,040833
1637;"Stubbekøbing";"no";0;0;0;54,888611;12,040833
1638;"Stubbekøbing";"no";3;1;4;54,888611;12,040833
1639;"Stubbekøbing";"no";1;0;1;54,888611;12,040833
1640;"Stubbekøbing";"no";0;0;0;54,888611;12,040833
1641;"Stubbekøbing";"no";0;0;0;54,888611;12,040833
1642;"Stubbekøbing";"no";0;0;0;54,888611;12,040833
1643;"Stubbekøbing";"no";1;0;1;54,888611;12,040833
1644;"Stubbekøbing";"no";0;0;0;54,888611;12,040833
1645;"Stubbekøbing";"no";0;0;0;54,888611;12,040833
1646;"Stubbekøbing";"no";0;0;0;54,888611;12,040833
1647;"Stubbekøbing";"no";1;0;1;54,888611;12,040833
1648;"Stubbekøbing";"no";0;0;0;54,888611;12,040833
1649;"Stubbekøbing";"no";2;0;2;54,888611;12,040833
1650;"Stubbekøbing";"no";2;1;3;54,888611;12,040833
1651;"Stubbekøbing";"no";0;0;0;54,888611;12,040833
1652;"Stubbekøbing";"no";0;0;0;54,888611;12,040833
1653;"Stubbekøbing";"no";0;0;0;54,888611;12,040833
1654;"Stubbekøbing";"no";0;0;0;54,888611;12,040833
1655;"Stubbekøbing";"no";0;0;0;54,888611;12,040833
1656;"Stubbekøbing";"no";0;0;0;54,888611;12,040833
1657;"Stubbekøbing";"no";0;0;0;54,888611;12,040833
1658;"Stubbekøbing";"no";0;0;0;54,888611;12,040833
1659;"Stubbekøbing";"no";0;0;0;54,888611;12,040833
1660;"Stubbekøbing";"no";0;0;0;54,888611;12,040833
1661;"Stubbekøbing";"no";0;0;0;54,888611;12,040833
1662;"Stubbekøbing";"no";0;0;0;54,888611;12,040833
1663;"Stubbekøbing";"no";0;0;0;54,888611;12,040833
1664;"Stubbekøbing";"no";0;0;0;54,888611;12,040833
1665;"Stubbekøbing";"no";1;0;1;54,888611;12,040833
1666;"Stubbekøbing";"no";0;1;1;54,888611;12,040833
1667;"Stubbekøbing";"no";0;0;0;54,888611;12,040833
1668;"Stubbekøbing";"no";2;1;3;54,888611;12,040833
1669;"Stubbekøbing";"no";5;1;6;54,888611;12,040833
1670;"Stubbekøbing";"no";6;1;7;54,888611;12,040833
1671;"Stubbekøbing";"no";1;0;1;54,888611;12,040833
1672;"Stubbekøbing";"no";4;2;6;54,888611;12,040833
1673;"Stubbekøbing";"no";1;0;1;54,888611;12,040833
1674;"Stubbekøbing";"no";0;0;0;54,888611;12,040833
1675;"Stubbekøbing";"no";0;0;0;54,888611;12,040833
1676;"Stubbekøbing";"no";1;0;1;54,888611;12,040833
1677;"Stubbekøbing";"no";1;0;1;54,888611;12,040833
1678;"Stubbekøbing";"no";0;0;0;54,888611;12,040833
1679;"Stubbekøbing";"no";0;0;0;54,888611;12,040833
1680;"Stubbekøbing";"no";0;1;1;54,888611;12,040833
1681;"Stubbekøbing";"no";0;0;0;54,888611;12,040833
1682;"Stubbekøbing";"no";1;0;1;54,888611;12,040833
1683;"Stubbekøbing";"no";0;0;0;54,888611;12,040833
1684;"Stubbekøbing";"no";1;0;1;54,888611;12,040833
1685;"Stubbekøbing";"no";0;0;0;54,888611;12,040833
1686;"Stubbekøbing";"no";1;2;3;54,888611;12,040833
1687;"Stubbekøbing";"no";1;0;1;54,888611;12,040833
1688;"Stubbekøbing";"no";2;0;2;54,888611;12,040833
1689;"Stubbekøbing";"no";0;0;0;54,888611;12,040833
1690;"Stubbekøbing";"no";1;0;1;54,888611;12,040833
1691;"Stubbekøbing";"no";0;0;0;54,888611;12,040833
1692;"Stubbekøbing";"no";0;0;0;54,888611;12,040833
1693;"Stubbekøbing";"no";0;0;0;54,888611;12,040833
1694;"Stubbekøbing";"no";0;0;0;54,888611;12,040833
1695;"Stubbekøbing";"no";1;0;1;54,888611;12,040833
1696;"Stubbekøbing";"no";0;0;0;54,888611;12,040833
1697;"Stubbekøbing";"no";0;0;0;54,888611;12,040833
1698;"Stubbekøbing";"no";1;0;1;54,888611;12,040833
1699;"Stubbekøbing";"no";0;0;0;54,888611;12,040833
1700;"Stubbekøbing";"no";1;0;1;54,888611;12,040833
1701;"Stubbekøbing";"no";1;0;1;54,888611;12,040833
1702;"Stubbekøbing";"no";0;1;1;54,888611;12,040833
1703;"Stubbekøbing";"no";0;0;0;54,888611;12,040833
1704;"Stubbekøbing";"no";1;0;1;54,888611;12,040833
1705;"Stubbekøbing";"no";1;0;1;54,888611;12,040833
1706;"Stubbekøbing";"no";1;0;1;54,888611;12,040833
1707;"Stubbekøbing";"no";1;0;1;54,888611;12,040833
1708;"Stubbekøbing";"no";2;0;2;54,888611;12,040833
1709;"Stubbekøbing";"no";1;1;2;54,888611;12,040833
1710;"Stubbekøbing";"no";2;0;2;54,888611;12,040833
1711;"Stubbekøbing";"no";0;0;0;54,888611;12,040833
1712;"Stubbekøbing";"no";2;0;2;54,888611;12,040833
1713;"Stubbekøbing";"no";0;0;0;54,888611;12,040833
1714;"Stubbekøbing";"no";1;0;1;54,888611;12,040833
1715;"Stubbekøbing";"no";0;0;0;54,888611;12,040833
1716;"Stubbekøbing";"no";0;0;0;54,888611;12,040833
1717;"Stubbekøbing";"no";0;0;0;54,888611;12,040833
1718;"Stubbekøbing";"no";1;0;1;54,888611;12,040833
1719;"Stubbekøbing";"no";0;0;0;54,888611;12,040833
1720;"Stubbekøbing";"no";0;1;1;54,888611;12,040833
1721;"Stubbekøbing";"no";0;0;0;54,888611;12,040833
1722;"Stubbekøbing";"no";0;0;0;54,888611;12,040833
1723;"Stubbekøbing";"no";0;0;0;54,888611;12,040833
1724;"Stubbekøbing";"no";0;0;0;54,888611;12,040833
1725;"Stubbekøbing";"no";0;1;1;54,888611;12,040833
1726;"Stubbekøbing";"no";0;0;0;54,888611;12,040833
1727;"Stubbekøbing";"no";0;0;0;54,888611;12,040833
1728;"Stubbekøbing";"no";0;0;0;54,888611;12,040833
1729;"Stubbekøbing";"no";0;1;1;54,888611;12,040833
1730;"Stubbekøbing";"no";0;0;0;54,888611;12,040833
1731;"Stubbekøbing";"no";0;0;0;54,888611;12,040833
1732;"Stubbekøbing";"no";0;0;0;54,888611;12,040833
1733;"Stubbekøbing";"no";0;0;0;54,888611;12,040833
1734;"Stubbekøbing";"no";0;0;0;54,888611;12,040833
1735;"Stubbekøbing";"no";0;0;0;54,888611;12,040833
1736;"Stubbekøbing";"no";2;0;2;54,888611;12,040833
1737;"Stubbekøbing";"no";0;0;0;54,888611;12,040833
1738;"Stubbekøbing";"no";0;1;1;54,888611;12,040833
1739;"Stubbekøbing";"no";0;1;1;54,888611;12,040833
1740;"Stubbekøbing";"no";0;2;2;54,888611;12,040833
1741;"Stubbekøbing";"no";0;1;1;54,888611;12,040833
1742;"Stubbekøbing";"no";0;0;0;54,888611;12,040833
1743;"Stubbekøbing";"no";0;0;0;54,888611;12,040833
1744;"Stubbekøbing";"no";1;0;1;54,888611;12,040833
1745;"Stubbekøbing";"no";0;0;0;54,888611;12,040833
1746;"Stubbekøbing";"no";0;0;0;54,888611;12,040833
1747;"Stubbekøbing";"no";0;0;0;54,888611;12,040833
1748;"Stubbekøbing";"no";0;1;1;54,888611;12,040833
1749;"Stubbekøbing";"no";0;0;0;54,888611;12,040833
1750;"Stubbekøbing";"no";2;2;4;54,888611;12,040833
1751;"Stubbekøbing";"no";1;0;1;54,888611;12,040833
1752;"Stubbekøbing";"no";0;0;0;54,888611;12,040833
1753;"Stubbekøbing";"no";1;0;1;54,888611;12,040833
1754;"Stubbekøbing";"no";1;1;2;54,888611;12,040833
1755;"Stubbekøbing";"no";1;0;1;54,888611;12,040833
1756;"Stubbekøbing";"no";1;0;1;54,888611;12,040833
1757;"Stubbekøbing";"no";0;0;0;54,888611;12,040833
1758;"Stubbekøbing";"no";1;0;1;54,888611;12,040833
1759;"Stubbekøbing";"no";1;0;1;54,888611;12,040833
1760;"Stubbekøbing";"no";0;0;0;54,888611;12,040833
1761;"Stubbekøbing";"no";0;0;0;54,888611;12,040833
1762;"Stubbekøbing";"no";0;0;0;54,888611;12,040833
1763;"Stubbekøbing";"no";1;0;1;54,888611;12,040833
1764;"Stubbekøbing";"no";0;0;0;54,888611;12,040833
1765;"Stubbekøbing";"no";0;0;0;54,888611;12,040833
1766;"Stubbekøbing";"no";1;0;1;54,888611;12,040833
1767;"Stubbekøbing";"no";2;0;2;54,888611;12,040833
1768;"Stubbekøbing";"no";1;0;1;54,888611;12,040833
1769;"Stubbekøbing";"no";0;1;1;54,888611;12,040833
1770;"Stubbekøbing";"no";3;2;5;54,888611;12,040833
1771;"Stubbekøbing";"no";0;2;2;54,888611;12,040833
1772;"Stubbekøbing";"no";3;1;4;54,888611;12,040833
1773;"Stubbekøbing";"no";0;0;0;54,888611;12,040833
1774;"Stubbekøbing";"no";2;0;2;54,888611;12,040833
1775;"Stubbekøbing";"no";2;2;4;54,888611;12,040833
1776;"Stubbekøbing";"no";2;2;4;54,888611;12,040833
1777;"Stubbekøbing";"no";3;3;6;54,888611;12,040833
1778;"Stubbekøbing";"no";5;1;6;54,888611;12,040833
1779;"Stubbekøbing";"no";3;1;4;54,888611;12,040833
1780;"Stubbekøbing";"no";1;0;1;54,888611;12,040833
1781;"Stubbekøbing";"no";3;2;5;54,888611;12,040833
1782;"Stubbekøbing";"no";3;2;5;54,888611;12,040833
1783;"Stubbekøbing";"no";3;2;5;54,888611;12,040833
1784;"Stubbekøbing";"no";2;1;3;54,888611;12,040833
1785;"Stubbekøbing";"no";2;2;4;54,888611;12,040833
1786;"Stubbekøbing";"no";2;2;4;54,888611;12,040833
1787;"Stubbekøbing";"no";3;3;6;54,888611;12,040833
1788;"Stubbekøbing";"no";4;2;6;54,888611;12,040833
1789;"Stubbekøbing";"no";2;1;3;54,888611;12,040833
1790;"Stubbekøbing";"no";1;0;1;54,888611;12,040833
1791;"Stubbekøbing";"no";3;4;7;54,888611;12,040833
1792;"Stubbekøbing";"no";2;0;2;54,888611;12,040833
1793;"Stubbekøbing";"no";0;2;2;54,888611;12,040833
1794;"Stubbekøbing";"no";0;0;0;54,888611;12,040833
1795;"Stubbekøbing";"no";0;0;0;54,888611;12,040833
1796;"Stubbekøbing";"no";0;2;2;54,888611;12,040833
1797;"Stubbekøbing";"no";0;1;1;54,888611;12,040833
1798;"Stubbekøbing";"no";2;5;7;54,888611;12,040833
1799;"Stubbekøbing";"no";0;1;1;54,888611;12,040833
1800;"Stubbekøbing";"no";0;2;2;54,888611;12,040833
1801;"Stubbekøbing";"no";2;1;3;54,888611;12,040833
1802;"Stubbekøbing";"no";0;2;2;54,888611;12,040833
1803;"Stubbekøbing";"no";1;3;4;54,888611;12,040833
1804;"Stubbekøbing";"no";1;2;3;54,888611;12,040833
1805;"Stubbekøbing";"no";1;1;2;54,888611;12,040833
1806;"Stubbekøbing";"no";0;4;4;54,888611;12,040833
1807;"Stubbekøbing";"no";0;0;0;54,888611;12,040833
1808;"Stubbekøbing";"no";0;0;0;54,888611;12,040833
1809;"Stubbekøbing";"no";0;0;0;54,888611;12,040833
1810;"Stubbekøbing";"no";0;0;0;54,888611;12,040833
1811;"Stubbekøbing";"no";0;0;0;54,888611;12,040833
1812;"Stubbekøbing";"no";0;1;1;54,888611;12,040833
1813;"Stubbekøbing";"no";0;0;0;54,888611;12,040833
1814;"Stubbekøbing";"no";0;0;0;54,888611;12,040833
1815;"Stubbekøbing";"no";2;1;3;54,888611;12,040833
1816;"Stubbekøbing";"no";1;1;2;54,888611;12,040833
1817;"Stubbekøbing";"no";1;0;1;54,888611;12,040833
1818;"Stubbekøbing";"no";5;2;7;54,888611;12,040833
1819;"Stubbekøbing";"no";6;0;6;54,888611;12,040833
1820;"Stubbekøbing";"no";8;2;10;54,888611;12,040833
1821;"Stubbekøbing";"no";3;1;4;54,888611;12,040833
1822;"Stubbekøbing";"no";3;0;3;54,888611;12,040833
1823;"Stubbekøbing";"no";3;0;3;54,888611;12,040833
1824;"Stubbekøbing";"no";11;5;16;54,888611;12,040833
1825;"Stubbekøbing";"no";8;1;9;54,888611;12,040833
1826;"Stubbekøbing";"no";8;2;10;54,888611;12,040833
1827;"Stubbekøbing";"no";7;3;10;54,888611;12,040833
1828;"Stubbekøbing";"no";11;5;16;54,888611;12,040833
1829;"Stubbekøbing";"no";6;2;8;54,888611;12,040833
1830;"Stubbekøbing";"no";3;0;3;54,888611;12,040833
1831;"Stubbekøbing";"no";4;8;12;54,888611;12,040833
1832;"Stubbekøbing";"no";7;6;13;54,888611;12,040833
1833;"Stubbekøbing";"no";9;1;10;54,888611;12,040833
1834;"Stubbekøbing";"no";12;5;17;54,888611;12,040833
1835;"Stubbekøbing";"no";10;2;12;54,888611;12,040833
1836;"Stubbekøbing";"no";11;2;13;54,888611;12,040833
1837;"Stubbekøbing";"no";10;8;18;54,888611;12,040833
1838;"Stubbekøbing";"no";4;5;9;54,888611;12,040833
1839;"Stubbekøbing";"no";2;7;9;54,888611;12,040833
1840;"Stubbekøbing";"no";9;11;20;54,888611;12,040833
1841;"Stubbekøbing";"no";6;11;17;54,888611;12,040833
1842;"Stubbekøbing";"no";3;10;13;54,888611;12,040833
1843;"Stubbekøbing";"no";4;3;7;54,888611;12,040833
1844;"Stubbekøbing";"no";3;6;9;54,888611;12,040833
1845;"Stubbekøbing";"no";11;2;13;54,888611;12,040833
1846;"Stubbekøbing";"no";10;6;16;54,888611;12,040833
1847;"Stubbekøbing";"no";12;10;22;54,888611;12,040833
1848;"Stubbekøbing";"no";7;14;21;54,888611;12,040833
1849;"Stubbekøbing";"no";10;5;15;54,888611;12,040833
1850;"Stubbekøbing";"no";6;5;11;54,888611;12,040833
1851;"Stubbekøbing";"no";6;4;10;54,888611;12,040833
1852;"Stubbekøbing";"no";7;4;11;54,888611;12,040833
1853;"Stubbekøbing";"no";9;1;10;54,888611;12,040833
1854;"Stubbekøbing";"no";6;4;10;54,888611;12,040833
1855;"Stubbekøbing";"no";5;6;11;54,888611;12,040833
1856;"Stubbekøbing";"no";3;4;7;54,888611;12,040833
1857;"Stubbekøbing";"no";0;0;0;54,888611;12,040833
1634;"Falster";"no";0;0;0;54,8622;11,9109
1635;"Falster";"no";0;0;0;54,8622;11,9109
1636;"Falster";"no";0;0;0;54,8622;11,9109
1637;"Falster";"no";0;0;0;54,8622;11,9109
1638;"Falster";"no";0;0;0;54,8622;11,9109
1639;"Falster";"no";1;0;1;54,8622;11,9109
1640;"Falster";"no";0;0;0;54,8622;11,9109
1641;"Falster";"no";0;0;0;54,8622;11,9109
1642;"Falster";"no";0;0;0;54,8622;11,9109
1643;"Falster";"no";0;0;0;54,8622;11,9109
1644;"Falster";"no";0;0;0;54,8622;11,9109
1645;"Falster";"no";0;0;0;54,8622;11,9109
1646;"Falster";"no";0;0;0;54,8622;11,9109
1647;"Falster";"no";0;0;0;54,8622;11,9109
1648;"Falster";"no";0;0;0;54,8622;11,9109
1649;"Falster";"no";0;0;0;54,8622;11,9109
1650;"Falster";"no";0;0;0;54,8622;11,9109
1651;"Falster";"no";0;0;0;54,8622;11,9109
1652;"Falster";"no";0;0;0;54,8622;11,9109
1653;"Falster";"no";0;0;0;54,8622;11,9109
1654;"Falster";"no";0;0;0;54,8622;11,9109
1655;"Falster";"no";0;0;0;54,8622;11,9109
1656;"Falster";"no";0;0;0;54,8622;11,9109
1657;"Falster";"no";0;0;0;54,8622;11,9109
1658;"Falster";"no";0;0;0;54,8622;11,9109
1659;"Falster";"no";0;0;0;54,8622;11,9109
1660;"Falster";"no";0;0;0;54,8622;11,9109
1661;"Falster";"no";0;0;0;54,8622;11,9109
1662;"Falster";"no";0;0;0;54,8622;11,9109
1663;"Falster";"no";0;0;0;54,8622;11,9109
1664;"Falster";"no";0;0;0;54,8622;11,9109
1665;"Falster";"no";0;0;0;54,8622;11,9109
1666;"Falster";"no";0;0;0;54,8622;11,9109
1667;"Falster";"no";0;0;0;54,8622;11,9109
1668;"Falster";"no";0;0;0;54,8622;11,9109
1669;"Falster";"no";0;0;0;54,8622;11,9109
1670;"Falster";"no";0;0;0;54,8622;11,9109
1671;"Falster";"no";0;1;1;54,8622;11,9109
1672;"Falster";"no";0;0;0;54,8622;11,9109
1673;"Falster";"no";0;0;0;54,8622;11,9109
1674;"Falster";"no";0;0;0;54,8622;11,9109
1675;"Falster";"no";0;0;0;54,8622;11,9109
1676;"Falster";"no";0;0;0;54,8622;11,9109
1677;"Falster";"no";0;0;0;54,8622;11,9109
1678;"Falster";"no";0;0;0;54,8622;11,9109
1679;"Falster";"no";0;0;0;54,8622;11,9109
1680;"Falster";"no";1;1;2;54,8622;11,9109
1681;"Falster";"no";0;0;0;54,8622;11,9109
1682;"Falster";"no";0;0;0;54,8622;11,9109
1683;"Falster";"no";0;0;0;54,8622;11,9109
1684;"Falster";"no";0;0;0;54,8622;11,9109
1685;"Falster";"no";0;0;0;54,8622;11,9109
1686;"Falster";"no";0;0;0;54,8622;11,9109
1687;"Falster";"no";0;0;0;54,8622;11,9109
1688;"Falster";"no";0;0;0;54,8622;11,9109
1689;"Falster";"no";0;0;0;54,8622;11,9109
1690;"Falster";"no";0;0;0;54,8622;11,9109
1691;"Falster";"no";0;0;0;54,8622;11,9109
1692;"Falster";"no";0;0;0;54,8622;11,9109
1693;"Falster";"no";0;0;0;54,8622;11,9109
1694;"Falster";"no";0;0;0;54,8622;11,9109
1695;"Falster";"no";0;0;0;54,8622;11,9109
1696;"Falster";"no";0;0;0;54,8622;11,9109
1697;"Falster";"no";0;0;0;54,8622;11,9109
1698;"Falster";"no";0;0;0;54,8622;11,9109
1699;"Falster";"no";0;0;0;54,8622;11,9109
1700;"Falster";"no";0;0;0;54,8622;11,9109
1701;"Falster";"no";0;0;0;54,8622;11,9109
1702;"Falster";"no";0;0;0;54,8622;11,9109
1703;"Falster";"no";0;0;0;54,8622;11,9109
1704;"Falster";"no";0;0;0;54,8622;11,9109
1705;"Falster";"no";0;0;0;54,8622;11,9109
1706;"Falster";"no";0;0;0;54,8622;11,9109
1707;"Falster";"no";0;1;1;54,8622;11,9109
1708;"Falster";"no";0;0;0;54,8622;11,9109
1709;"Falster";"no";0;0;0;54,8622;11,9109
1710;"Falster";"no";0;0;0;54,8622;11,9109
1711;"Falster";"no";0;0;0;54,8622;11,9109
1712;"Falster";"no";0;0;0;54,8622;11,9109
1713;"Falster";"no";0;0;0;54,8622;11,9109
1714;"Falster";"no";0;0;0;54,8622;11,9109
1715;"Falster";"no";0;0;0;54,8622;11,9109
1716;"Falster";"no";0;0;0;54,8622;11,9109
1717;"Falster";"no";0;0;0;54,8622;11,9109
1718;"Falster";"no";0;0;0;54,8622;11,9109
1719;"Falster";"no";0;0;0;54,8622;11,9109
1720;"Falster";"no";0;0;0;54,8622;11,9109
1721;"Falster";"no";0;0;0;54,8622;11,9109
1722;"Falster";"no";1;0;1;54,8622;11,9109
1723;"Falster";"no";0;0;0;54,8622;11,9109
1724;"Falster";"no";0;0;0;54,8622;11,9109
1725;"Falster";"no";0;0;0;54,8622;11,9109
1726;"Falster";"no";0;0;0;54,8622;11,9109
1727;"Falster";"no";0;0;0;54,8622;11,9109
1728;"Falster";"no";0;0;0;54,8622;11,9109
1729;"Falster";"no";0;1;1;54,8622;11,9109
1730;"Falster";"no";0;0;0;54,8622;11,9109
1731;"Falster";"no";0;0;0;54,8622;11,9109
1732;"Falster";"no";0;0;0;54,8622;11,9109
1733;"Falster";"no";0;0;0;54,8622;11,9109
1734;"Falster";"no";0;0;0;54,8622;11,9109
1735;"Falster";"no";0;0;0;54,8622;11,9109
1736;"Falster";"no";0;0;0;54,8622;11,9109
1737;"Falster";"no";0;0;0;54,8622;11,9109
1738;"Falster";"no";0;0;0;54,8622;11,9109
1739;"Falster";"no";0;0;0;54,8622;11,9109
1740;"Falster";"no";0;0;0;54,8622;11,9109
1741;"Falster";"no";0;0;0;54,8622;11,9109
1742;"Falster";"no";0;0;0;54,8622;11,9109
1743;"Falster";"no";0;0;0;54,8622;11,9109
1744;"Falster";"no";0;0;0;54,8622;11,9109
1745;"Falster";"no";0;0;0;54,8622;11,9109
1746;"Falster";"no";0;0;0;54,8622;11,9109
1747;"Falster";"no";0;0;0;54,8622;11,9109
1748;"Falster";"no";0;0;0;54,8622;11,9109
1749;"Falster";"no";0;0;0;54,8622;11,9109
1750;"Falster";"no";0;1;1;54,8622;11,9109
1751;"Falster";"no";0;0;0;54,8622;11,9109
1752;"Falster";"no";0;0;0;54,8622;11,9109
1753;"Falster";"no";0;0;0;54,8622;11,9109
1754;"Falster";"no";0;0;0;54,8622;11,9109
1755;"Falster";"no";0;0;0;54,8622;11,9109
1756;"Falster";"no";0;0;0;54,8622;11,9109
1757;"Falster";"no";0;0;0;54,8622;11,9109
1758;"Falster";"no";0;0;0;54,8622;11,9109
1759;"Falster";"no";0;0;0;54,8622;11,9109
1760;"Falster";"no";0;0;0;54,8622;11,9109
1761;"Falster";"no";0;0;0;54,8622;11,9109
1762;"Falster";"no";0;0;0;54,8622;11,9109
1763;"Falster";"no";0;0;0;54,8622;11,9109
1764;"Falster";"no";0;0;0;54,8622;11,9109
1765;"Falster";"no";0;0;0;54,8622;11,9109
1766;"Falster";"no";0;0;0;54,8622;11,9109
1767;"Falster";"no";0;0;0;54,8622;11,9109
1768;"Falster";"no";0;0;0;54,8622;11,9109
1769;"Falster";"no";0;0;0;54,8622;11,9109
1770;"Falster";"no";0;0;0;54,8622;11,9109
1771;"Falster";"no";0;0;0;54,8622;11,9109
1772;"Falster";"no";0;0;0;54,8622;11,9109
1773;"Falster";"no";0;0;0;54,8622;11,9109
1774;"Falster";"no";0;0;0;54,8622;11,9109
1775;"Falster";"no";0;1;1;54,8622;11,9109
1776;"Falster";"no";0;0;0;54,8622;11,9109
1777;"Falster";"no";0;0;0;54,8622;11,9109
1778;"Falster";"no";0;0;0;54,8622;11,9109
1779;"Falster";"no";0;0;0;54,8622;11,9109
1780;"Falster";"no";0;0;0;54,8622;11,9109
1781;"Falster";"no";0;0;0;54,8622;11,9109
1782;"Falster";"no";0;0;0;54,8622;11,9109
1783;"Falster";"no";0;0;0;54,8622;11,9109
1784;"Falster";"no";0;0;0;54,8622;11,9109
1785;"Falster";"no";0;0;0;54,8622;11,9109
1786;"Falster";"no";0;0;0;54,8622;11,9109
1787;"Falster";"no";0;0;0;54,8622;11,9109
1788;"Falster";"no";0;0;0;54,8622;11,9109
1789;"Falster";"no";0;0;0;54,8622;11,9109
1790;"Falster";"no";0;0;0;54,8622;11,9109
1791;"Falster";"no";0;0;0;54,8622;11,9109
1792;"Falster";"no";0;0;0;54,8622;11,9109
1793;"Falster";"no";0;0;0;54,8622;11,9109
1794;"Falster";"no";0;0;0;54,8622;11,9109
1795;"Falster";"no";0;0;0;54,8622;11,9109
1796;"Falster";"no";0;1;1;54,8622;11,9109
1797;"Falster";"no";0;1;1;54,8622;11,9109
1798;"Falster";"no";0;0;0;54,8622;11,9109
1799;"Falster";"no";0;0;0;54,8622;11,9109
1800;"Falster";"no";0;0;0;54,8622;11,9109
1801;"Falster";"no";0;0;0;54,8622;11,9109
1802;"Falster";"no";0;0;0;54,8622;11,9109
1803;"Falster";"no";0;0;0;54,8622;11,9109
1804;"Falster";"no";0;0;0;54,8622;11,9109
1805;"Falster";"no";0;0;0;54,8622;11,9109
1806;"Falster";"no";0;0;0;54,8622;11,9109
1807;"Falster";"no";0;0;0;54,8622;11,9109
1808;"Falster";"no";0;0;0;54,8622;11,9109
1809;"Falster";"no";0;0;0;54,8622;11,9109
1810;"Falster";"no";0;0;0;54,8622;11,9109
1811;"Falster";"no";0;0;0;54,8622;11,9109
1812;"Falster";"no";0;0;0;54,8622;11,9109
1813;"Falster";"no";0;0;0;54,8622;11,9109
1814;"Falster";"no";0;0;0;54,8622;11,9109
1815;"Falster";"no";0;0;0;54,8622;11,9109
1816;"Falster";"no";0;0;0;54,8622;11,9109
1817;"Falster";"no";0;0;0;54,8622;11,9109
1818;"Falster";"no";0;0;0;54,8622;11,9109
1819;"Falster";"no";0;1;1;54,8622;11,9109
1820;"Falster";"no";0;0;0;54,8622;11,9109
1821;"Falster";"no";0;1;1;54,8622;11,9109
1822;"Falster";"no";0;0;0;54,8622;11,9109
1823;"Falster";"no";0;0;0;54,8622;11,9109
1824;"Falster";"no";0;0;0;54,8622;11,9109
1825;"Falster";"no";0;0;0;54,8622;11,9109
1826;"Falster";"no";0;0;0;54,8622;11,9109
1827;"Falster";"no";0;0;0;54,8622;11,9109
1828;"Falster";"no";0;0;0;54,8622;11,9109
1829;"Falster";"no";0;1;1;54,8622;11,9109
1830;"Falster";"no";0;0;0;54,8622;11,9109
1831;"Falster";"no";0;0;0;54,8622;11,9109
1832;"Falster";"no";0;0;0;54,8622;11,9109
1833;"Falster";"no";0;0;0;54,8622;11,9109
1834;"Falster";"no";0;0;0;54,8622;11,9109
1835;"Falster";"no";0;0;0;54,8622;11,9109
1836;"Falster";"no";0;0;0;54,8622;11,9109
1837;"Falster";"no";0;0;0;54,8622;11,9109
1838;"Falster";"no";0;0;0;54,8622;11,9109
1839;"Falster";"no";0;0;0;54,8622;11,9109
1840;"Falster";"no";0;0;0;54,8622;11,9109
1841;"Falster";"no";0;0;0;54,8622;11,9109
1842;"Falster";"no";0;0;0;54,8622;11,9109
1843;"Falster";"no";0;0;0;54,8622;11,9109
1844;"Falster";"no";0;0;0;54,8622;11,9109
1845;"Falster";"no";0;0;0;54,8622;11,9109
1846;"Falster";"no";0;0;0;54,8622;11,9109
1847;"Falster";"no";0;0;0;54,8622;11,9109
1848;"Falster";"no";0;0;0;54,8622;11,9109
1849;"Falster";"no";0;0;0;54,8622;11,9109
1850;"Falster";"no";0;0;0;54,8622;11,9109
1851;"Falster";"no";0;0;0;54,8622;11,9109
1852;"Falster";"no";0;0;0;54,8622;11,9109
1853;"Falster";"no";0;0;0;54,8622;11,9109
1854;"Falster";"no";0;0;0;54,8622;11,9109
1855;"Falster";"no";0;0;0;54,8622;11,9109
1856;"Falster";"no";0;0;0;54,8622;11,9109
1857;"Falster";"no";0;0;0;54,8622;11,9109
1634;"Horsens";"no";0;0;0;55,860555;9,850277
1635;"Horsens";"no";0;0;0;55,860555;9,850277
1636;"Horsens";"no";0;0;0;55,860555;9,850277
1637;"Horsens";"no";0;0;0;55,860555;9,850277
1638;"Horsens";"no";0;0;0;55,860555;9,850277
1639;"Horsens";"no";5;0;5;55,860555;9,850277
1640;"Horsens";"no";0;0;0;55,860555;9,850277
1641;"Horsens";"no";1;0;1;55,860555;9,850277
1642;"Horsens";"no";1;0;1;55,860555;9,850277
1643;"Horsens";"no";0;0;0;55,860555;9,850277
1644;"Horsens";"no";0;0;0;55,860555;9,850277
1645;"Horsens";"no";0;0;0;55,860555;9,850277
1646;"Horsens";"no";0;0;0;55,860555;9,850277
1647;"Horsens";"no";0;0;0;55,860555;9,850277
1648;"Horsens";"no";0;1;1;55,860555;9,850277
1649;"Horsens";"no";0;0;0;55,860555;9,850277
1650;"Horsens";"no";0;0;0;55,860555;9,850277
1651;"Horsens";"no";0;0;0;55,860555;9,850277
1652;"Horsens";"no";0;0;0;55,860555;9,850277
1653;"Horsens";"no";0;0;0;55,860555;9,850277
1654;"Horsens";"no";0;0;0;55,860555;9,850277
1655;"Horsens";"no";0;0;0;55,860555;9,850277
1656;"Horsens";"no";0;0;0;55,860555;9,850277
1657;"Horsens";"no";0;0;0;55,860555;9,850277
1658;"Horsens";"no";0;0;0;55,860555;9,850277
1659;"Horsens";"no";0;0;0;55,860555;9,850277
1660;"Horsens";"no";0;0;0;55,860555;9,850277
1661;"Horsens";"no";0;0;0;55,860555;9,850277
1662;"Horsens";"no";0;0;0;55,860555;9,850277
1663;"Horsens";"no";0;0;0;55,860555;9,850277
1664;"Horsens";"no";1;0;1;55,860555;9,850277
1665;"Horsens";"no";0;0;0;55,860555;9,850277
1666;"Horsens";"no";0;0;0;55,860555;9,850277
1667;"Horsens";"no";0;0;0;55,860555;9,850277
1668;"Horsens";"no";0;0;0;55,860555;9,850277
1669;"Horsens";"no";0;0;0;55,860555;9,850277
1670;"Horsens";"no";0;0;0;55,860555;9,850277
1671;"Horsens";"no";0;0;0;55,860555;9,850277
1672;"Horsens";"no";0;0;0;55,860555;9,850277
1673;"Horsens";"no";0;1;1;55,860555;9,850277
1674;"Horsens";"no";0;1;1;55,860555;9,850277
1675;"Horsens";"no";0;0;0;55,860555;9,850277
1676;"Horsens";"no";0;0;0;55,860555;9,850277
1677;"Horsens";"no";0;0;0;55,860555;9,850277
1678;"Horsens";"no";0;0;0;55,860555;9,850277
1679;"Horsens";"no";0;1;1;55,860555;9,850277
1680;"Horsens";"no";0;2;2;55,860555;9,850277
1681;"Horsens";"no";0;0;0;55,860555;9,850277
1682;"Horsens";"no";0;0;0;55,860555;9,850277
1683;"Horsens";"no";0;0;0;55,860555;9,850277
1684;"Horsens";"no";0;0;0;55,860555;9,850277
1685;"Horsens";"no";0;0;0;55,860555;9,850277
1686;"Horsens";"no";0;0;0;55,860555;9,850277
1687;"Horsens";"no";0;0;0;55,860555;9,850277
1688;"Horsens";"no";0;0;0;55,860555;9,850277
1689;"Horsens";"no";0;0;0;55,860555;9,850277
1690;"Horsens";"no";1;0;1;55,860555;9,850277
1691;"Horsens";"no";0;0;0;55,860555;9,850277
1692;"Horsens";"no";0;0;0;55,860555;9,850277
1693;"Horsens";"no";0;0;0;55,860555;9,850277
1694;"Horsens";"no";0;0;0;55,860555;9,850277
1695;"Horsens";"no";0;0;0;55,860555;9,850277
1696;"Horsens";"no";0;0;0;55,860555;9,850277
1697;"Horsens";"no";0;1;1;55,860555;9,850277
1698;"Horsens";"no";0;1;1;55,860555;9,850277
1699;"Horsens";"no";0;0;0;55,860555;9,850277
1700;"Horsens";"no";0;0;0;55,860555;9,850277
1701;"Horsens";"no";0;0;0;55,860555;9,850277
1702;"Horsens";"no";0;0;0;55,860555;9,850277
1703;"Horsens";"no";0;0;0;55,860555;9,850277
1704;"Horsens";"no";0;0;0;55,860555;9,850277
1705;"Horsens";"no";0;0;0;55,860555;9,850277
1706;"Horsens";"no";0;0;0;55,860555;9,850277
1707;"Horsens";"no";0;0;0;55,860555;9,850277
1708;"Horsens";"no";0;0;0;55,860555;9,850277
1709;"Horsens";"no";0;0;0;55,860555;9,850277
1710;"Horsens";"no";0;0;0;55,860555;9,850277
1711;"Horsens";"no";0;0;0;55,860555;9,850277
1712;"Horsens";"no";0;0;0;55,860555;9,850277
1713;"Horsens";"no";0;0;0;55,860555;9,850277
1714;"Horsens";"no";0;0;0;55,860555;9,850277
1715;"Horsens";"no";0;0;0;55,860555;9,850277
1716;"Horsens";"no";0;0;0;55,860555;9,850277
1717;"Horsens";"no";0;0;0;55,860555;9,850277
1718;"Horsens";"no";0;0;0;55,860555;9,850277
1719;"Horsens";"no";0;0;0;55,860555;9,850277
1720;"Horsens";"no";0;0;0;55,860555;9,850277
1721;"Horsens";"no";0;0;0;55,860555;9,850277
1722;"Horsens";"no";0;0;0;55,860555;9,850277
1723;"Horsens";"no";0;0;0;55,860555;9,850277
1724;"Horsens";"no";0;0;0;55,860555;9,850277
1725;"Horsens";"no";0;0;0;55,860555;9,850277
1726;"Horsens";"no";0;0;0;55,860555;9,850277
1727;"Horsens";"no";0;0;0;55,860555;9,850277
1728;"Horsens";"no";0;0;0;55,860555;9,850277
1729;"Horsens";"no";0;0;0;55,860555;9,850277
1730;"Horsens";"no";0;0;0;55,860555;9,850277
1731;"Horsens";"no";0;0;0;55,860555;9,850277
1732;"Horsens";"no";0;0;0;55,860555;9,850277
1733;"Horsens";"no";0;0;0;55,860555;9,850277
1734;"Horsens";"no";0;0;0;55,860555;9,850277
1735;"Horsens";"no";0;0;0;55,860555;9,850277
1736;"Horsens";"no";0;0;0;55,860555;9,850277
1737;"Horsens";"no";0;0;0;55,860555;9,850277
1738;"Horsens";"no";0;0;0;55,860555;9,850277
1739;"Horsens";"no";0;0;0;55,860555;9,850277
1740;"Horsens";"no";0;0;0;55,860555;9,850277
1741;"Horsens";"no";0;0;0;55,860555;9,850277
1742;"Horsens";"no";0;0;0;55,860555;9,850277
1743;"Horsens";"no";0;0;0;55,860555;9,850277
1744;"Horsens";"no";0;0;0;55,860555;9,850277
1745;"Horsens";"no";0;1;1;55,860555;9,850277
1746;"Horsens";"no";0;0;0;55,860555;9,850277
1747;"Horsens";"no";1;1;2;55,860555;9,850277
1748;"Horsens";"no";1;1;2;55,860555;9,850277
1749;"Horsens";"no";1;1;2;55,860555;9,850277
1750;"Horsens";"no";1;2;3;55,860555;9,850277
1751;"Horsens";"no";0;2;2;55,860555;9,850277
1752;"Horsens";"no";0;2;2;55,860555;9,850277
1753;"Horsens";"no";1;1;2;55,860555;9,850277
1754;"Horsens";"no";1;4;5;55,860555;9,850277
1755;"Horsens";"no";3;2;5;55,860555;9,850277
1756;"Horsens";"no";2;2;4;55,860555;9,850277
1757;"Horsens";"no";2;2;4;55,860555;9,850277
1758;"Horsens";"no";2;2;4;55,860555;9,850277
1759;"Horsens";"no";2;2;4;55,860555;9,850277
1760;"Horsens";"no";2;1;3;55,860555;9,850277
1761;"Horsens";"no";1;1;2;55,860555;9,850277
1762;"Horsens";"no";0;0;0;55,860555;9,850277
1763;"Horsens";"no";0;1;1;55,860555;9,850277
1764;"Horsens";"no";1;3;4;55,860555;9,850277
1765;"Horsens";"no";1;2;3;55,860555;9,850277
1766;"Horsens";"no";2;2;4;55,860555;9,850277
1767;"Horsens";"no";2;4;6;55,860555;9,850277
1768;"Horsens";"no";1;2;3;55,860555;9,850277
1769;"Horsens";"no";1;1;2;55,860555;9,850277
1770;"Horsens";"no";2;2;4;55,860555;9,850277
1771;"Horsens";"no";1;2;3;55,860555;9,850277
1772;"Horsens";"no";0;1;1;55,860555;9,850277
1773;"Horsens";"no";1;2;3;55,860555;9,850277
1774;"Horsens";"no";2;2;4;55,860555;9,850277
1775;"Horsens";"no";0;1;1;55,860555;9,850277
1776;"Horsens";"no";2;2;4;55,860555;9,850277
1777;"Horsens";"no";1;1;2;55,860555;9,850277
1778;"Horsens";"no";1;1;2;55,860555;9,850277
1779;"Horsens";"no";2;1;3;55,860555;9,850277
1780;"Horsens";"no";0;2;2;55,860555;9,850277
1781;"Horsens";"no";0;2;2;55,860555;9,850277
1782;"Horsens";"no";0;2;2;55,860555;9,850277
1783;"Horsens";"no";1;1;2;55,860555;9,850277
1784;"Horsens";"no";1;3;4;55,860555;9,850277
1785;"Horsens";"no";1;1;2;55,860555;9,850277
1786;"Horsens";"no";5;7;12;55,860555;9,850277
1787;"Horsens";"no";4;5;9;55,860555;9,850277
1788;"Horsens";"no";0;1;1;55,860555;9,850277
1789;"Horsens";"no";0;1;1;55,860555;9,850277
1790;"Horsens";"no";0;0;0;55,860555;9,850277
1791;"Horsens";"no";0;2;2;55,860555;9,850277
1792;"Horsens";"no";4;4;8;55,860555;9,850277
1793;"Horsens";"no";2;2;4;55,860555;9,850277
1794;"Horsens";"no";0;2;2;55,860555;9,850277
1795;"Horsens";"no";0;0;0;55,860555;9,850277
1796;"Horsens";"no";0;2;2;55,860555;9,850277
1797;"Horsens";"no";5;1;6;55,860555;9,850277
1798;"Horsens";"no";2;6;8;55,860555;9,850277
1799;"Horsens";"no";5;7;12;55,860555;9,850277
1800;"Horsens";"no";1;4;5;55,860555;9,850277
1801;"Horsens";"no";7;5;12;55,860555;9,850277
1802;"Horsens";"no";1;1;2;55,860555;9,850277
1803;"Horsens";"no";3;6;9;55,860555;9,850277
1804;"Horsens";"no";6;2;8;55,860555;9,850277
1805;"Horsens";"no";7;8;15;55,860555;9,850277
1806;"Horsens";"no";3;6;9;55,860555;9,850277
1807;"Horsens";"no";2;0;2;55,860555;9,850277
1808;"Horsens";"no";0;0;0;55,860555;9,850277
1809;"Horsens";"no";0;0;0;55,860555;9,850277
1810;"Horsens";"no";0;0;0;55,860555;9,850277
1811;"Horsens";"no";0;0;0;55,860555;9,850277
1812;"Horsens";"no";0;0;0;55,860555;9,850277
1813;"Horsens";"no";0;0;0;55,860555;9,850277
1814;"Horsens";"no";1;1;2;55,860555;9,850277
1815;"Horsens";"no";0;0;0;55,860555;9,850277
1816;"Horsens";"no";1;1;2;55,860555;9,850277
1817;"Horsens";"no";0;1;1;55,860555;9,850277
1818;"Horsens";"no";1;2;3;55,860555;9,850277
1819;"Horsens";"no";2;4;6;55,860555;9,850277
1820;"Horsens";"no";3;2;5;55,860555;9,850277
1821;"Horsens";"no";1;1;2;55,860555;9,850277
1822;"Horsens";"no";0;2;2;55,860555;9,850277
1823;"Horsens";"no";1;1;2;55,860555;9,850277
1824;"Horsens";"no";1;1;2;55,860555;9,850277
1825;"Horsens";"no";1;2;3;55,860555;9,850277
1826;"Horsens";"no";2;2;4;55,860555;9,850277
1827;"Horsens";"no";3;2;5;55,860555;9,850277
1828;"Horsens";"no";2;4;6;55,860555;9,850277
1829;"Horsens";"no";4;2;6;55,860555;9,850277
1830;"Horsens";"no";2;4;6;55,860555;9,850277
1831;"Horsens";"no";3;2;5;55,860555;9,850277
1832;"Horsens";"no";2;4;6;55,860555;9,850277
1833;"Horsens";"no";0;2;2;55,860555;9,850277
1834;"Horsens";"no";6;2;8;55,860555;9,850277
1835;"Horsens";"no";1;1;2;55,860555;9,850277
1836;"Horsens";"no";2;0;2;55,860555;9,850277
1837;"Horsens";"no";1;2;3;55,860555;9,850277
1838;"Horsens";"no";8;0;8;55,860555;9,850277
1839;"Horsens";"no";5;1;6;55,860555;9,850277
1840;"Horsens";"no";5;0;5;55,860555;9,850277
1841;"Horsens";"no";1;2;3;55,860555;9,850277
1842;"Horsens";"no";9;3;12;55,860555;9,850277
1843;"Horsens";"no";10;8;18;55,860555;9,850277
1844;"Horsens";"no";10;11;21;55,860555;9,850277
1845;"Horsens";"no";8;8;16;55,860555;9,850277
1846;"Horsens";"no";6;9;15;55,860555;9,850277
1847;"Horsens";"no";18;16;34;55,860555;9,850277
1848;"Horsens";"no";12;4;16;55,860555;9,850277
1849;"Horsens";"no";5;11;16;55,860555;9,850277
1850;"Horsens";"no";18;9;27;55,860555;9,850277
1851;"Horsens";"no";24;11;35;55,860555;9,850277
1852;"Horsens";"no";23;11;34;55,860555;9,850277
1853;"Horsens";"no";8;13;21;55,860555;9,850277
1854;"Horsens";"no";12;8;20;55,860555;9,850277
1855;"Horsens";"no";18;14;32;55,860555;9,850277
1856;"Horsens";"no";40;16;56;55,860555;9,850277
1857;"Horsens";"no";0;1;1;55,860555;9,850277
1634;"Kartemunde";"no";0;0;0;55,45304;10,66094
1635;"Kartemunde";"no";0;0;0;55,45304;10,66094
1636;"Kartemunde";"no";0;0;0;55,45304;10,66094
1637;"Kartemunde";"no";0;0;0;55,45304;10,66094
1638;"Kartemunde";"no";0;0;0;55,45304;10,66094
1639;"Kartemunde";"no";3;0;3;55,45304;10,66094
1640;"Kartemunde";"no";1;0;1;55,45304;10,66094
1641;"Kartemunde";"no";0;0;0;55,45304;10,66094
1642;"Kartemunde";"no";0;0;0;55,45304;10,66094
1643;"Kartemunde";"no";1;1;2;55,45304;10,66094
1644;"Kartemunde";"no";0;0;0;55,45304;10,66094
1645;"Kartemunde";"no";0;0;0;55,45304;10,66094
1646;"Kartemunde";"no";0;0;0;55,45304;10,66094
1647;"Kartemunde";"no";1;0;1;55,45304;10,66094
1648;"Kartemunde";"no";0;0;0;55,45304;10,66094
1649;"Kartemunde";"no";0;1;1;55,45304;10,66094
1650;"Kartemunde";"no";0;1;1;55,45304;10,66094
1651;"Kartemunde";"no";0;1;1;55,45304;10,66094
1652;"Kartemunde";"no";0;0;0;55,45304;10,66094
1653;"Kartemunde";"no";0;0;0;55,45304;10,66094
1654;"Kartemunde";"no";0;0;0;55,45304;10,66094
1655;"Kartemunde";"no";0;0;0;55,45304;10,66094
1656;"Kartemunde";"no";0;0;0;55,45304;10,66094
1657;"Kartemunde";"no";0;0;0;55,45304;10,66094
1658;"Kartemunde";"no";0;0;0;55,45304;10,66094
1659;"Kartemunde";"no";0;0;0;55,45304;10,66094
1660;"Kartemunde";"no";0;0;0;55,45304;10,66094
1661;"Kartemunde";"no";0;0;0;55,45304;10,66094
1662;"Kartemunde";"no";0;0;0;55,45304;10,66094
1663;"Kartemunde";"no";0;0;0;55,45304;10,66094
1664;"Kartemunde";"no";0;0;0;55,45304;10,66094
1665;"Kartemunde";"no";0;0;0;55,45304;10,66094
1666;"Kartemunde";"no";0;0;0;55,45304;10,66094
1667;"Kartemunde";"no";0;0;0;55,45304;10,66094
1668;"Kartemunde";"no";0;1;1;55,45304;10,66094
1669;"Kartemunde";"no";0;0;0;55,45304;10,66094
1670;"Kartemunde";"no";0;4;4;55,45304;10,66094
1671;"Kartemunde";"no";0;3;3;55,45304;10,66094
1672;"Kartemunde";"no";0;0;0;55,45304;10,66094
1673;"Kartemunde";"no";0;0;0;55,45304;10,66094
1674;"Kartemunde";"no";1;2;3;55,45304;10,66094
1675;"Kartemunde";"no";0;0;0;55,45304;10,66094
1676;"Kartemunde";"no";0;0;0;55,45304;10,66094
1677;"Kartemunde";"no";0;0;0;55,45304;10,66094
1678;"Kartemunde";"no";2;1;3;55,45304;10,66094
1679;"Kartemunde";"no";1;1;2;55,45304;10,66094
1680;"Kartemunde";"no";0;1;1;55,45304;10,66094
1681;"Kartemunde";"no";0;0;0;55,45304;10,66094
1682;"Kartemunde";"no";0;0;0;55,45304;10,66094
1683;"Kartemunde";"no";0;0;0;55,45304;10,66094
1684;"Kartemunde";"no";0;0;0;55,45304;10,66094
1685;"Kartemunde";"no";0;0;0;55,45304;10,66094
1686;"Kartemunde";"no";0;0;0;55,45304;10,66094
1687;"Kartemunde";"no";0;0;0;55,45304;10,66094
1688;"Kartemunde";"no";0;1;1;55,45304;10,66094
1689;"Kartemunde";"no";0;0;0;55,45304;10,66094
1690;"Kartemunde";"no";0;0;0;55,45304;10,66094
1691;"Kartemunde";"no";0;0;0;55,45304;10,66094
1692;"Kartemunde";"no";0;0;0;55,45304;10,66094
1693;"Kartemunde";"no";0;0;0;55,45304;10,66094
1694;"Kartemunde";"no";0;0;0;55,45304;10,66094
1695;"Kartemunde";"no";0;0;0;55,45304;10,66094
1696;"Kartemunde";"no";0;0;0;55,45304;10,66094
1697;"Kartemunde";"no";0;0;0;55,45304;10,66094
1698;"Kartemunde";"no";0;0;0;55,45304;10,66094
1699;"Kartemunde";"no";0;0;0;55,45304;10,66094
1700;"Kartemunde";"no";0;0;0;55,45304;10,66094
1701;"Kartemunde";"no";0;0;0;55,45304;10,66094
1702;"Kartemunde";"no";0;0;0;55,45304;10,66094
1703;"Kartemunde";"no";0;0;0;55,45304;10,66094
1704;"Kartemunde";"no";0;0;0;55,45304;10,66094
1705;"Kartemunde";"no";0;0;0;55,45304;10,66094
1706;"Kartemunde";"no";0;0;0;55,45304;10,66094
1707;"Kartemunde";"no";0;0;0;55,45304;10,66094
1708;"Kartemunde";"no";0;0;0;55,45304;10,66094
1709;"Kartemunde";"no";0;0;0;55,45304;10,66094
1710;"Kartemunde";"no";0;0;0;55,45304;10,66094
1711;"Kartemunde";"no";0;1;1;55,45304;10,66094
1712;"Kartemunde";"no";0;0;0;55,45304;10,66094
1713;"Kartemunde";"no";0;0;0;55,45304;10,66094
1714;"Kartemunde";"no";0;0;0;55,45304;10,66094
1715;"Kartemunde";"no";0;0;0;55,45304;10,66094
1716;"Kartemunde";"no";0;0;0;55,45304;10,66094
1717;"Kartemunde";"no";0;1;1;55,45304;10,66094
1718;"Kartemunde";"no";0;0;0;55,45304;10,66094
1719;"Kartemunde";"no";0;0;0;55,45304;10,66094
1720;"Kartemunde";"no";0;0;0;55,45304;10,66094
1721;"Kartemunde";"no";0;0;0;55,45304;10,66094
1722;"Kartemunde";"no";0;0;0;55,45304;10,66094
1723;"Kartemunde";"no";0;0;0;55,45304;10,66094
1724;"Kartemunde";"no";0;0;0;55,45304;10,66094
1725;"Kartemunde";"no";1;0;1;55,45304;10,66094
1726;"Kartemunde";"no";0;0;0;55,45304;10,66094
1727;"Kartemunde";"no";0;0;0;55,45304;10,66094
1728;"Kartemunde";"no";0;0;0;55,45304;10,66094
1729;"Kartemunde";"no";0;0;0;55,45304;10,66094
1730;"Kartemunde";"no";0;0;0;55,45304;10,66094
1731;"Kartemunde";"no";0;0;0;55,45304;10,66094
1732;"Kartemunde";"no";0;0;0;55,45304;10,66094
1733;"Kartemunde";"no";0;0;0;55,45304;10,66094
1734;"Kartemunde";"no";0;0;0;55,45304;10,66094
1735;"Kartemunde";"no";0;0;0;55,45304;10,66094
1736;"Kartemunde";"no";0;0;0;55,45304;10,66094
1737;"Kartemunde";"no";0;0;0;55,45304;10,66094
1738;"Kartemunde";"no";0;0;0;55,45304;10,66094
1739;"Kartemunde";"no";0;0;0;55,45304;10,66094
1740;"Kartemunde";"no";0;0;0;55,45304;10,66094
1741;"Kartemunde";"no";0;0;0;55,45304;10,66094
1742;"Kartemunde";"no";0;0;0;55,45304;10,66094
1743;"Kartemunde";"no";0;0;0;55,45304;10,66094
1744;"Kartemunde";"no";0;0;0;55,45304;10,66094
1745;"Kartemunde";"no";0;0;0;55,45304;10,66094
1746;"Kartemunde";"no";0;0;0;55,45304;10,66094
1747;"Kartemunde";"no";0;0;0;55,45304;10,66094
1748;"Kartemunde";"no";0;0;0;55,45304;10,66094
1749;"Kartemunde";"no";0;0;0;55,45304;10,66094
1750;"Kartemunde";"no";0;0;0;55,45304;10,66094
1751;"Kartemunde";"no";0;0;0;55,45304;10,66094
1752;"Kartemunde";"no";0;0;0;55,45304;10,66094
1753;"Kartemunde";"no";0;0;0;55,45304;10,66094
1754;"Kartemunde";"no";0;0;0;55,45304;10,66094
1755;"Kartemunde";"no";0;0;0;55,45304;10,66094
1756;"Kartemunde";"no";0;0;0;55,45304;10,66094
1757;"Kartemunde";"no";0;0;0;55,45304;10,66094
1758;"Kartemunde";"no";0;0;0;55,45304;10,66094
1759;"Kartemunde";"no";0;0;0;55,45304;10,66094
1760;"Kartemunde";"no";0;0;0;55,45304;10,66094
1761;"Kartemunde";"no";0;0;0;55,45304;10,66094
1762;"Kartemunde";"no";0;0;0;55,45304;10,66094
1763;"Kartemunde";"no";0;0;0;55,45304;10,66094
1764;"Kartemunde";"no";0;0;0;55,45304;10,66094
1765;"Kartemunde";"no";0;0;0;55,45304;10,66094
1766;"Kartemunde";"no";0;0;0;55,45304;10,66094
1767;"Kartemunde";"no";0;0;0;55,45304;10,66094
1768;"Kartemunde";"no";0;0;0;55,45304;10,66094
1769;"Kartemunde";"no";0;0;0;55,45304;10,66094
1770;"Kartemunde";"no";0;0;0;55,45304;10,66094
1771;"Kartemunde";"no";0;0;0;55,45304;10,66094
1772;"Kartemunde";"no";0;0;0;55,45304;10,66094
1773;"Kartemunde";"no";0;1;1;55,45304;10,66094
1774;"Kartemunde";"no";0;0;0;55,45304;10,66094
1775;"Kartemunde";"no";0;0;0;55,45304;10,66094
1776;"Kartemunde";"no";0;0;0;55,45304;10,66094
1777;"Kartemunde";"no";0;0;0;55,45304;10,66094
1778;"Kartemunde";"no";0;0;0;55,45304;10,66094
1779;"Kartemunde";"no";0;0;0;55,45304;10,66094
1780;"Kartemunde";"no";0;0;0;55,45304;10,66094
1781;"Kartemunde";"no";0;0;0;55,45304;10,66094
1782;"Kartemunde";"no";0;0;0;55,45304;10,66094
1783;"Kartemunde";"no";0;0;0;55,45304;10,66094
1784;"Kartemunde";"no";0;0;0;55,45304;10,66094
1785;"Kartemunde";"no";0;0;0;55,45304;10,66094
1786;"Kartemunde";"no";0;0;0;55,45304;10,66094
1787;"Kartemunde";"no";0;0;0;55,45304;10,66094
1788;"Kartemunde";"no";0;0;0;55,45304;10,66094
1789;"Kartemunde";"no";0;0;0;55,45304;10,66094
1790;"Kartemunde";"no";0;0;0;55,45304;10,66094
1791;"Kartemunde";"no";0;0;0;55,45304;10,66094
1792;"Kartemunde";"no";0;0;0;55,45304;10,66094
1793;"Kartemunde";"no";0;0;0;55,45304;10,66094
1794;"Kartemunde";"no";0;0;0;55,45304;10,66094
1795;"Kartemunde";"no";0;0;0;55,45304;10,66094
1796;"Kartemunde";"no";0;0;0;55,45304;10,66094
1797;"Kartemunde";"no";0;1;1;55,45304;10,66094
1798;"Kartemunde";"no";0;0;0;55,45304;10,66094
1799;"Kartemunde";"no";0;0;0;55,45304;10,66094
1800;"Kartemunde";"no";0;0;0;55,45304;10,66094
1801;"Kartemunde";"no";2;0;2;55,45304;10,66094
1802;"Kartemunde";"no";0;0;0;55,45304;10,66094
1803;"Kartemunde";"no";0;0;0;55,45304;10,66094
1804;"Kartemunde";"no";0;0;0;55,45304;10,66094
1805;"Kartemunde";"no";0;0;0;55,45304;10,66094
1806;"Kartemunde";"no";0;0;0;55,45304;10,66094
1807;"Kartemunde";"no";0;0;0;55,45304;10,66094
1808;"Kartemunde";"no";0;0;0;55,45304;10,66094
1809;"Kartemunde";"no";0;0;0;55,45304;10,66094
1810;"Kartemunde";"no";0;0;0;55,45304;10,66094
1811;"Kartemunde";"no";0;0;0;55,45304;10,66094
1812;"Kartemunde";"no";0;0;0;55,45304;10,66094
1813;"Kartemunde";"no";0;0;0;55,45304;10,66094
1814;"Kartemunde";"no";0;0;0;55,45304;10,66094
1815;"Kartemunde";"no";0;0;0;55,45304;10,66094
1816;"Kartemunde";"no";0;0;0;55,45304;10,66094
1817;"Kartemunde";"no";0;0;0;55,45304;10,66094
1818;"Kartemunde";"no";2;2;4;55,45304;10,66094
1819;"Kartemunde";"no";0;0;0;55,45304;10,66094
1820;"Kartemunde";"no";0;0;0;55,45304;10,66094
1821;"Kartemunde";"no";0;0;0;55,45304;10,66094
1822;"Kartemunde";"no";0;0;0;55,45304;10,66094
1823;"Kartemunde";"no";0;0;0;55,45304;10,66094
1824;"Kartemunde";"no";0;0;0;55,45304;10,66094
1825;"Kartemunde";"no";0;0;0;55,45304;10,66094
1826;"Kartemunde";"no";0;1;1;55,45304;10,66094
1827;"Kartemunde";"no";0;1;1;55,45304;10,66094
1828;"Kartemunde";"no";0;0;0;55,45304;10,66094
1829;"Kartemunde";"no";0;0;0;55,45304;10,66094
1830;"Kartemunde";"no";0;0;0;55,45304;10,66094
1831;"Kartemunde";"no";0;0;0;55,45304;10,66094
1832;"Kartemunde";"no";0;0;0;55,45304;10,66094
1833;"Kartemunde";"no";0;0;0;55,45304;10,66094
1834;"Kartemunde";"no";0;0;0;55,45304;10,66094
1835;"Kartemunde";"no";0;1;1;55,45304;10,66094
1836;"Kartemunde";"no";0;0;0;55,45304;10,66094
1837;"Kartemunde";"no";0;1;1;55,45304;10,66094
1838;"Kartemunde";"no";0;0;0;55,45304;10,66094
1839;"Kartemunde";"no";1;0;1;55,45304;10,66094
1840;"Kartemunde";"no";0;0;0;55,45304;10,66094
1841;"Kartemunde";"no";0;2;2;55,45304;10,66094
1842;"Kartemunde";"no";0;0;0;55,45304;10,66094
1843;"Kartemunde";"no";0;0;0;55,45304;10,66094
1844;"Kartemunde";"no";1;1;2;55,45304;10,66094
1845;"Kartemunde";"no";0;0;0;55,45304;10,66094
1846;"Kartemunde";"no";1;1;2;55,45304;10,66094
1847;"Kartemunde";"no";1;0;1;55,45304;10,66094
1848;"Kartemunde";"no";0;1;1;55,45304;10,66094
1849;"Kartemunde";"no";0;1;1;55,45304;10,66094
1850;"Kartemunde";"no";0;2;2;55,45304;10,66094
1851;"Kartemunde";"no";0;3;3;55,45304;10,66094
1852;"Kartemunde";"no";0;2;2;55,45304;10,66094
1853;"Kartemunde";"no";3;1;4;55,45304;10,66094
1854;"Kartemunde";"no";0;0;0;55,45304;10,66094
1855;"Kartemunde";"no";0;0;0;55,45304;10,66094
1856;"Kartemunde";"no";2;1;3;55,45304;10,66094
1857;"Kartemunde";"no";0;0;0;55,45304;10,66094
1634;"Slesvig";"no";0;0;0;55;9
1635;"Slesvig";"no";0;0;0;55;9
1636;"Slesvig";"no";0;0;0;55;9
1637;"Slesvig";"no";0;0;0;55;9
1638;"Slesvig";"no";0;0;0;55;9
1639;"Slesvig";"no";1;0;1;55;9
1640;"Slesvig";"no";0;0;0;55;9
1641;"Slesvig";"no";0;0;0;55;9
1642;"Slesvig";"no";0;0;0;55;9
1643;"Slesvig";"no";0;0;0;55;9
1644;"Slesvig";"no";0;0;0;55;9
1645;"Slesvig";"no";0;0;0;55;9
1646;"Slesvig";"no";0;0;0;55;9
1647;"Slesvig";"no";0;0;0;55;9
1648;"Slesvig";"no";2;0;2;55;9
1649;"Slesvig";"no";0;0;0;55;9
1650;"Slesvig";"no";0;0;0;55;9
1651;"Slesvig";"no";0;0;0;55;9
1652;"Slesvig";"no";0;0;0;55;9
1653;"Slesvig";"no";0;0;0;55;9
1654;"Slesvig";"no";0;0;0;55;9
1655;"Slesvig";"no";0;0;0;55;9
1656;"Slesvig";"no";0;0;0;55;9
1657;"Slesvig";"no";0;0;0;55;9
1658;"Slesvig";"no";0;0;0;55;9
1659;"Slesvig";"no";0;0;0;55;9
1660;"Slesvig";"no";0;0;0;55;9
1661;"Slesvig";"no";0;0;0;55;9
1662;"Slesvig";"no";0;0;0;55;9
1663;"Slesvig";"no";0;0;0;55;9
1664;"Slesvig";"no";0;0;0;55;9
1665;"Slesvig";"no";0;0;0;55;9
1666;"Slesvig";"no";0;0;0;55;9
1667;"Slesvig";"no";0;0;0;55;9
1668;"Slesvig";"no";1;0;1;55;9
1669;"Slesvig";"no";0;0;0;55;9
1670;"Slesvig";"no";0;0;0;55;9
1671;"Slesvig";"no";0;0;0;55;9
1672;"Slesvig";"no";0;0;0;55;9
1673;"Slesvig";"no";0;0;0;55;9
1674;"Slesvig";"no";0;0;0;55;9
1675;"Slesvig";"no";0;0;0;55;9
1676;"Slesvig";"no";0;0;0;55;9
1677;"Slesvig";"no";0;0;0;55;9
1678;"Slesvig";"no";0;0;0;55;9
1679;"Slesvig";"no";0;0;0;55;9
1680;"Slesvig";"no";0;0;0;55;9
1681;"Slesvig";"no";0;0;0;55;9
1682;"Slesvig";"no";0;0;0;55;9
1683;"Slesvig";"no";0;0;0;55;9
1684;"Slesvig";"no";0;0;0;55;9
1685;"Slesvig";"no";1;0;1;55;9
1686;"Slesvig";"no";0;0;0;55;9
1687;"Slesvig";"no";0;0;0;55;9
1688;"Slesvig";"no";0;0;0;55;9
1689;"Slesvig";"no";0;0;0;55;9
1690;"Slesvig";"no";0;0;0;55;9
1691;"Slesvig";"no";0;0;0;55;9
1692;"Slesvig";"no";0;0;0;55;9
1693;"Slesvig";"no";0;0;0;55;9
1694;"Slesvig";"no";0;0;0;55;9
1695;"Slesvig";"no";0;0;0;55;9
1696;"Slesvig";"no";0;0;0;55;9
1697;"Slesvig";"no";0;0;0;55;9
1698;"Slesvig";"no";0;0;0;55;9
1699;"Slesvig";"no";0;0;0;55;9
1700;"Slesvig";"no";0;0;0;55;9
1701;"Slesvig";"no";0;0;0;55;9
1702;"Slesvig";"no";0;0;0;55;9
1703;"Slesvig";"no";0;0;0;55;9
1704;"Slesvig";"no";0;0;0;55;9
1705;"Slesvig";"no";0;0;0;55;9
1706;"Slesvig";"no";0;0;0;55;9
1707;"Slesvig";"no";0;1;1;55;9
1708;"Slesvig";"no";0;0;0;55;9
1709;"Slesvig";"no";0;0;0;55;9
1710;"Slesvig";"no";1;0;1;55;9
1711;"Slesvig";"no";0;0;0;55;9
1712;"Slesvig";"no";0;0;0;55;9
1713;"Slesvig";"no";0;0;0;55;9
1714;"Slesvig";"no";0;0;0;55;9
1715;"Slesvig";"no";0;0;0;55;9
1716;"Slesvig";"no";0;0;0;55;9
1717;"Slesvig";"no";0;0;0;55;9
1718;"Slesvig";"no";0;0;0;55;9
1719;"Slesvig";"no";0;0;0;55;9
1720;"Slesvig";"no";0;0;0;55;9
1721;"Slesvig";"no";0;1;1;55;9
1722;"Slesvig";"no";0;0;0;55;9
1723;"Slesvig";"no";0;0;0;55;9
1724;"Slesvig";"no";0;0;0;55;9
1725;"Slesvig";"no";0;0;0;55;9
1726;"Slesvig";"no";0;0;0;55;9
1727;"Slesvig";"no";0;0;0;55;9
1728;"Slesvig";"no";0;0;0;55;9
1729;"Slesvig";"no";0;0;0;55;9
1730;"Slesvig";"no";0;0;0;55;9
1731;"Slesvig";"no";0;0;0;55;9
1732;"Slesvig";"no";0;0;0;55;9
1733;"Slesvig";"no";0;0;0;55;9
1734;"Slesvig";"no";0;0;0;55;9
1735;"Slesvig";"no";0;0;0;55;9
1736;"Slesvig";"no";0;0;0;55;9
1737;"Slesvig";"no";0;0;0;55;9
1738;"Slesvig";"no";0;0;0;55;9
1739;"Slesvig";"no";0;0;0;55;9
1740;"Slesvig";"no";0;0;0;55;9
1741;"Slesvig";"no";0;0;0;55;9
1742;"Slesvig";"no";0;0;0;55;9
1743;"Slesvig";"no";0;0;0;55;9
1744;"Slesvig";"no";0;0;0;55;9
1745;"Slesvig";"no";0;0;0;55;9
1746;"Slesvig";"no";0;0;0;55;9
1747;"Slesvig";"no";0;0;0;55;9
1748;"Slesvig";"no";0;0;0;55;9
1749;"Slesvig";"no";0;0;0;55;9
1750;"Slesvig";"no";0;0;0;55;9
1751;"Slesvig";"no";0;0;0;55;9
1752;"Slesvig";"no";0;0;0;55;9
1753;"Slesvig";"no";0;0;0;55;9
1754;"Slesvig";"no";0;0;0;55;9
1755;"Slesvig";"no";0;0;0;55;9
1756;"Slesvig";"no";0;0;0;55;9
1757;"Slesvig";"no";0;0;0;55;9
1758;"Slesvig";"no";0;0;0;55;9
1759;"Slesvig";"no";0;0;0;55;9
1760;"Slesvig";"no";0;0;0;55;9
1761;"Slesvig";"no";0;0;0;55;9
1762;"Slesvig";"no";0;0;0;55;9
1763;"Slesvig";"no";0;0;0;55;9
1764;"Slesvig";"no";0;0;0;55;9
1765;"Slesvig";"no";0;0;0;55;9
1766;"Slesvig";"no";0;0;0;55;9
1767;"Slesvig";"no";0;0;0;55;9
1768;"Slesvig";"no";0;0;0;55;9
1769;"Slesvig";"no";0;0;0;55;9
1770;"Slesvig";"no";0;0;0;55;9
1771;"Slesvig";"no";0;0;0;55;9
1772;"Slesvig";"no";0;0;0;55;9
1773;"Slesvig";"no";0;0;0;55;9
1774;"Slesvig";"no";0;0;0;55;9
1775;"Slesvig";"no";0;0;0;55;9
1776;"Slesvig";"no";0;0;0;55;9
1777;"Slesvig";"no";0;0;0;55;9
1778;"Slesvig";"no";0;0;0;55;9
1779;"Slesvig";"no";0;0;0;55;9
1780;"Slesvig";"no";0;0;0;55;9
1781;"Slesvig";"no";0;0;0;55;9
1782;"Slesvig";"no";0;0;0;55;9
1783;"Slesvig";"no";0;0;0;55;9
1784;"Slesvig";"no";0;0;0;55;9
1785;"Slesvig";"no";0;0;0;55;9
1786;"Slesvig";"no";0;0;0;55;9
1787;"Slesvig";"no";0;0;0;55;9
1788;"Slesvig";"no";0;1;1;55;9
1789;"Slesvig";"no";0;0;0;55;9
1790;"Slesvig";"no";0;0;0;55;9
1791;"Slesvig";"no";0;0;0;55;9
1792;"Slesvig";"no";0;0;0;55;9
1793;"Slesvig";"no";0;0;0;55;9
1794;"Slesvig";"no";0;0;0;55;9
1795;"Slesvig";"no";0;0;0;55;9
1796;"Slesvig";"no";0;0;0;55;9
1797;"Slesvig";"no";0;0;0;55;9
1798;"Slesvig";"no";0;0;0;55;9
1799;"Slesvig";"no";0;0;0;55;9
1800;"Slesvig";"no";0;0;0;55;9
1801;"Slesvig";"no";0;0;0;55;9
1802;"Slesvig";"no";0;0;0;55;9
1803;"Slesvig";"no";0;0;0;55;9
1804;"Slesvig";"no";0;0;0;55;9
1805;"Slesvig";"no";0;0;0;55;9
1806;"Slesvig";"no";0;0;0;55;9
1807;"Slesvig";"no";0;0;0;55;9
1808;"Slesvig";"no";0;0;0;55;9
1809;"Slesvig";"no";0;0;0;55;9
1810;"Slesvig";"no";0;0;0;55;9
1811;"Slesvig";"no";0;0;0;55;9
1812;"Slesvig";"no";0;0;0;55;9
1813;"Slesvig";"no";0;0;0;55;9
1814;"Slesvig";"no";0;0;0;55;9
1815;"Slesvig";"no";0;0;0;55;9
1816;"Slesvig";"no";0;0;0;55;9
1817;"Slesvig";"no";0;0;0;55;9
1818;"Slesvig";"no";0;0;0;55;9
1819;"Slesvig";"no";0;0;0;55;9
1820;"Slesvig";"no";0;0;0;55;9
1821;"Slesvig";"no";0;0;0;55;9
1822;"Slesvig";"no";0;1;1;55;9
1823;"Slesvig";"no";0;0;0;55;9
1824;"Slesvig";"no";0;0;0;55;9
1825;"Slesvig";"no";0;0;0;55;9
1826;"Slesvig";"no";0;0;0;55;9
1827;"Slesvig";"no";0;0;0;55;9
1828;"Slesvig";"no";0;0;0;55;9
1829;"Slesvig";"no";0;0;0;55;9
1830;"Slesvig";"no";0;1;1;55;9
1831;"Slesvig";"no";0;0;0;55;9
1832;"Slesvig";"no";0;0;0;55;9
1833;"Slesvig";"no";0;0;0;55;9
1834;"Slesvig";"no";0;0;0;55;9
1835;"Slesvig";"no";0;0;0;55;9
1836;"Slesvig";"no";0;0;0;55;9
1837;"Slesvig";"no";0;0;0;55;9
1838;"Slesvig";"no";0;0;0;55;9
1839;"Slesvig";"no";0;0;0;55;9
1840;"Slesvig";"no";0;0;0;55;9
1841;"Slesvig";"no";0;0;0;55;9
1842;"Slesvig";"no";0;1;1;55;9
1843;"Slesvig";"no";0;0;0;55;9
1844;"Slesvig";"no";0;0;0;55;9
1845;"Slesvig";"no";0;0;0;55;9
1846;"Slesvig";"no";0;0;0;55;9
1847;"Slesvig";"no";0;0;0;55;9
1848;"Slesvig";"no";0;0;0;55;9
1849;"Slesvig";"no";0;0;0;55;9
1850;"Slesvig";"no";0;0;0;55;9
1851;"Slesvig";"no";0;1;1;55;9
1852;"Slesvig";"no";0;2;2;55;9
1853;"Slesvig";"no";0;0;0;55;9
1854;"Slesvig";"no";0;0;0;55;9
1855;"Slesvig";"no";0;1;1;55;9
1856;"Slesvig";"no";0;0;0;55;9
1857;"Slesvig";"no";0;0;0;55;9
1634;"Dragør";"no";0;0;0;55,594444;12,666111
1635;"Dragør";"no";0;0;0;55,594444;12,666111
1636;"Dragør";"no";0;0;0;55,594444;12,666111
1637;"Dragør";"no";0;0;0;55,594444;12,666111
1638;"Dragør";"no";0;0;0;55,594444;12,666111
1639;"Dragør";"no";0;0;0;55,594444;12,666111
1640;"Dragør";"no";1;0;1;55,594444;12,666111
1641;"Dragør";"no";0;0;0;55,594444;12,666111
1642;"Dragør";"no";0;0;0;55,594444;12,666111
1643;"Dragør";"no";0;1;1;55,594444;12,666111
1644;"Dragør";"no";0;0;0;55,594444;12,666111
1645;"Dragør";"no";0;0;0;55,594444;12,666111
1646;"Dragør";"no";0;0;0;55,594444;12,666111
1647;"Dragør";"no";0;0;0;55,594444;12,666111
1648;"Dragør";"no";0;0;0;55,594444;12,666111
1649;"Dragør";"no";0;0;0;55,594444;12,666111
1650;"Dragør";"no";3;0;3;55,594444;12,666111
1651;"Dragør";"no";0;0;0;55,594444;12,666111
1652;"Dragør";"no";0;0;0;55,594444;12,666111
1653;"Dragør";"no";0;0;0;55,594444;12,666111
1654;"Dragør";"no";0;0;0;55,594444;12,666111
1655;"Dragør";"no";0;0;0;55,594444;12,666111
1656;"Dragør";"no";1;0;1;55,594444;12,666111
1657;"Dragør";"no";1;0;1;55,594444;12,666111
1658;"Dragør";"no";0;0;0;55,594444;12,666111
1659;"Dragør";"no";0;0;0;55,594444;12,666111
1660;"Dragør";"no";1;0;1;55,594444;12,666111
1661;"Dragør";"no";1;0;1;55,594444;12,666111
1662;"Dragør";"no";1;0;1;55,594444;12,666111
1663;"Dragør";"no";1;0;1;55,594444;12,666111
1664;"Dragør";"no";2;0;2;55,594444;12,666111
1665;"Dragør";"no";0;0;0;55,594444;12,666111
1666;"Dragør";"no";0;0;0;55,594444;12,666111
1667;"Dragør";"no";0;0;0;55,594444;12,666111
1668;"Dragør";"no";0;0;0;55,594444;12,666111
1669;"Dragør";"no";0;0;0;55,594444;12,666111
1670;"Dragør";"no";0;0;0;55,594444;12,666111
1671;"Dragør";"no";0;0;0;55,594444;12,666111
1672;"Dragør";"no";0;0;0;55,594444;12,666111
1673;"Dragør";"no";0;0;0;55,594444;12,666111
1674;"Dragør";"no";0;0;0;55,594444;12,666111
1675;"Dragør";"no";0;0;0;55,594444;12,666111
1676;"Dragør";"no";0;0;0;55,594444;12,666111
1677;"Dragør";"no";0;0;0;55,594444;12,666111
1678;"Dragør";"no";0;0;0;55,594444;12,666111
1679;"Dragør";"no";0;0;0;55,594444;12,666111
1680;"Dragør";"no";1;0;1;55,594444;12,666111
1681;"Dragør";"no";1;0;1;55,594444;12,666111
1682;"Dragør";"no";1;0;1;55,594444;12,666111
1683;"Dragør";"no";1;0;1;55,594444;12,666111
1684;"Dragør";"no";0;0;0;55,594444;12,666111
1685;"Dragør";"no";0;1;1;55,594444;12,666111
1686;"Dragør";"no";1;0;1;55,594444;12,666111
1687;"Dragør";"no";0;0;0;55,594444;12,666111
1688;"Dragør";"no";0;0;0;55,594444;12,666111
1689;"Dragør";"no";0;0;0;55,594444;12,666111
1690;"Dragør";"no";1;0;1;55,594444;12,666111
1691;"Dragør";"no";1;0;1;55,594444;12,666111
1692;"Dragør";"no";0;1;1;55,594444;12,666111
1693;"Dragør";"no";1;0;1;55,594444;12,666111
1694;"Dragør";"no";0;0;0;55,594444;12,666111
1695;"Dragør";"no";0;0;0;55,594444;12,666111
1696;"Dragør";"no";0;0;0;55,594444;12,666111
1697;"Dragør";"no";0;0;0;55,594444;12,666111
1698;"Dragør";"no";0;0;0;55,594444;12,666111
1699;"Dragør";"no";0;0;0;55,594444;12,666111
1700;"Dragør";"no";0;0;0;55,594444;12,666111
1701;"Dragør";"no";2;0;2;55,594444;12,666111
1702;"Dragør";"no";0;0;0;55,594444;12,666111
1703;"Dragør";"no";0;0;0;55,594444;12,666111
1704;"Dragør";"no";0;0;0;55,594444;12,666111
1705;"Dragør";"no";0;0;0;55,594444;12,666111
1706;"Dragør";"no";0;0;0;55,594444;12,666111
1707;"Dragør";"no";0;0;0;55,594444;12,666111
1708;"Dragør";"no";0;0;0;55,594444;12,666111
1709;"Dragør";"no";0;1;1;55,594444;12,666111
1710;"Dragør";"no";0;0;0;55,594444;12,666111
1711;"Dragør";"no";0;0;0;55,594444;12,666111
1712;"Dragør";"no";0;0;0;55,594444;12,666111
1713;"Dragør";"no";0;0;0;55,594444;12,666111
1714;"Dragør";"no";0;0;0;55,594444;12,666111
1715;"Dragør";"no";0;0;0;55,594444;12,666111
1716;"Dragør";"no";0;0;0;55,594444;12,666111
1717;"Dragør";"no";0;0;0;55,594444;12,666111
1718;"Dragør";"no";0;0;0;55,594444;12,666111
1719;"Dragør";"no";0;0;0;55,594444;12,666111
1720;"Dragør";"no";0;0;0;55,594444;12,666111
1721;"Dragør";"no";0;0;0;55,594444;12,666111
1722;"Dragør";"no";0;0;0;55,594444;12,666111
1723;"Dragør";"no";0;0;0;55,594444;12,666111
1724;"Dragør";"no";0;0;0;55,594444;12,666111
1725;"Dragør";"no";0;0;0;55,594444;12,666111
1726;"Dragør";"no";0;0;0;55,594444;12,666111
1727;"Dragør";"no";0;0;0;55,594444;12,666111
1728;"Dragør";"no";0;0;0;55,594444;12,666111
1729;"Dragør";"no";0;0;0;55,594444;12,666111
1730;"Dragør";"no";0;0;0;55,594444;12,666111
1731;"Dragør";"no";0;0;0;55,594444;12,666111
1732;"Dragør";"no";0;0;0;55,594444;12,666111
1733;"Dragør";"no";0;0;0;55,594444;12,666111
1734;"Dragør";"no";0;0;0;55,594444;12,666111
1735;"Dragør";"no";0;0;0;55,594444;12,666111
1736;"Dragør";"no";0;0;0;55,594444;12,666111
1737;"Dragør";"no";0;0;0;55,594444;12,666111
1738;"Dragør";"no";0;0;0;55,594444;12,666111
1739;"Dragør";"no";0;0;0;55,594444;12,666111
1740;"Dragør";"no";0;0;0;55,594444;12,666111
1741;"Dragør";"no";0;0;0;55,594444;12,666111
1742;"Dragør";"no";0;0;0;55,594444;12,666111
1743;"Dragør";"no";0;0;0;55,594444;12,666111
1744;"Dragør";"no";0;0;0;55,594444;12,666111
1745;"Dragør";"no";0;0;0;55,594444;12,666111
1746;"Dragør";"no";1;0;1;55,594444;12,666111
1747;"Dragør";"no";0;0;0;55,594444;12,666111
1748;"Dragør";"no";0;0;0;55,594444;12,666111
1749;"Dragør";"no";3;0;3;55,594444;12,666111
1750;"Dragør";"no";3;0;3;55,594444;12,666111
1751;"Dragør";"no";0;0;0;55,594444;12,666111
1752;"Dragør";"no";1;2;3;55,594444;12,666111
1753;"Dragør";"no";1;1;2;55,594444;12,666111
1754;"Dragør";"no";2;0;2;55,594444;12,666111
1755;"Dragør";"no";0;0;0;55,594444;12,666111
1756;"Dragør";"no";2;0;2;55,594444;12,666111
1757;"Dragør";"no";0;0;0;55,594444;12,666111
1758;"Dragør";"no";3;1;4;55,594444;12,666111
1759;"Dragør";"no";3;4;7;55,594444;12,666111
1760;"Dragør";"no";4;1;5;55,594444;12,666111
1761;"Dragør";"no";1;1;2;55,594444;12,666111
1762;"Dragør";"no";1;0;1;55,594444;12,666111
1763;"Dragør";"no";0;0;0;55,594444;12,666111
1764;"Dragør";"no";0;1;1;55,594444;12,666111
1765;"Dragør";"no";0;0;0;55,594444;12,666111
1766;"Dragør";"no";0;1;1;55,594444;12,666111
1767;"Dragør";"no";0;0;0;55,594444;12,666111
1768;"Dragør";"no";1;0;1;55,594444;12,666111
1769;"Dragør";"no";1;0;1;55,594444;12,666111
1770;"Dragør";"no";0;0;0;55,594444;12,666111
1771;"Dragør";"no";1;0;1;55,594444;12,666111
1772;"Dragør";"no";1;0;1;55,594444;12,666111
1773;"Dragør";"no";1;0;1;55,594444;12,666111
1774;"Dragør";"no";0;0;0;55,594444;12,666111
1775;"Dragør";"no";1;0;1;55,594444;12,666111
1776;"Dragør";"no";1;0;1;55,594444;12,666111
1777;"Dragør";"no";1;0;1;55,594444;12,666111
1778;"Dragør";"no";0;0;0;55,594444;12,666111
1779;"Dragør";"no";0;0;0;55,594444;12,666111
1780;"Dragør";"no";0;0;0;55,594444;12,666111
1781;"Dragør";"no";2;0;2;55,594444;12,666111
1782;"Dragør";"no";0;0;0;55,594444;12,666111
1783;"Dragør";"no";0;1;1;55,594444;12,666111
1784;"Dragør";"no";0;0;0;55,594444;12,666111
1785;"Dragør";"no";0;0;0;55,594444;12,666111
1786;"Dragør";"no";0;2;2;55,594444;12,666111
1787;"Dragør";"no";1;1;2;55,594444;12,666111
1788;"Dragør";"no";1;0;1;55,594444;12,666111
1789;"Dragør";"no";1;0;1;55,594444;12,666111
1790;"Dragør";"no";0;0;0;55,594444;12,666111
1791;"Dragør";"no";4;0;4;55,594444;12,666111
1792;"Dragør";"no";3;1;4;55,594444;12,666111
1793;"Dragør";"no";3;1;4;55,594444;12,666111
1794;"Dragør";"no";1;1;2;55,594444;12,666111
1795;"Dragør";"no";1;0;1;55,594444;12,666111
1796;"Dragør";"no";0;1;1;55,594444;12,666111
1797;"Dragør";"no";0;1;1;55,594444;12,666111
1798;"Dragør";"no";0;0;0;55,594444;12,666111
1799;"Dragør";"no";0;0;0;55,594444;12,666111
1800;"Dragør";"no";0;0;0;55,594444;12,666111
1801;"Dragør";"no";0;0;0;55,594444;12,666111
1802;"Dragør";"no";3;0;3;55,594444;12,666111
1803;"Dragør";"no";1;0;1;55,594444;12,666111
1804;"Dragør";"no";2;0;2;55,594444;12,666111
1805;"Dragør";"no";0;0;0;55,594444;12,666111
1806;"Dragør";"no";0;0;0;55,594444;12,666111
1807;"Dragør";"no";0;0;0;55,594444;12,666111
1808;"Dragør";"no";0;0;0;55,594444;12,666111
1809;"Dragør";"no";0;0;0;55,594444;12,666111
1810;"Dragør";"no";0;0;0;55,594444;12,666111
1811;"Dragør";"no";0;0;0;55,594444;12,666111
1812;"Dragør";"no";2;0;2;55,594444;12,666111
1813;"Dragør";"no";0;0;0;55,594444;12,666111
1814;"Dragør";"no";0;0;0;55,594444;12,666111
1815;"Dragør";"no";0;0;0;55,594444;12,666111
1816;"Dragør";"no";0;0;0;55,594444;12,666111
1817;"Dragør";"no";0;0;0;55,594444;12,666111
1818;"Dragør";"no";0;0;0;55,594444;12,666111
1819;"Dragør";"no";0;0;0;55,594444;12,666111
1820;"Dragør";"no";0;0;0;55,594444;12,666111
1821;"Dragør";"no";0;0;0;55,594444;12,666111
1822;"Dragør";"no";0;0;0;55,594444;12,666111
1823;"Dragør";"no";0;0;0;55,594444;12,666111
1824;"Dragør";"no";0;6;6;55,594444;12,666111
1825;"Dragør";"no";0;0;0;55,594444;12,666111
1826;"Dragør";"no";0;0;0;55,594444;12,666111
1827;"Dragør";"no";1;0;1;55,594444;12,666111
1828;"Dragør";"no";0;0;0;55,594444;12,666111
1829;"Dragør";"no";0;0;0;55,594444;12,666111
1830;"Dragør";"no";0;0;0;55,594444;12,666111
1831;"Dragør";"no";0;1;1;55,594444;12,666111
1832;"Dragør";"no";0;1;1;55,594444;12,666111
1833;"Dragør";"no";1;4;5;55,594444;12,666111
1834;"Dragør";"no";0;2;2;55,594444;12,666111
1835;"Dragør";"no";0;0;0;55,594444;12,666111
1836;"Dragør";"no";0;0;0;55,594444;12,666111
1837;"Dragør";"no";0;0;0;55,594444;12,666111
1838;"Dragør";"no";0;0;0;55,594444;12,666111
1839;"Dragør";"no";0;1;1;55,594444;12,666111
1840;"Dragør";"no";0;1;1;55,594444;12,666111
1841;"Dragør";"no";0;0;0;55,594444;12,666111
1842;"Dragør";"no";0;0;0;55,594444;12,666111
1843;"Dragør";"no";0;1;1;55,594444;12,666111
1844;"Dragør";"no";1;1;2;55,594444;12,666111
1845;"Dragør";"no";1;1;2;55,594444;12,666111
1846;"Dragør";"no";2;0;2;55,594444;12,666111
1847;"Dragør";"no";0;0;0;55,594444;12,666111
1848;"Dragør";"no";1;0;1;55,594444;12,666111
1849;"Dragør";"no";1;0;1;55,594444;12,666111
1850;"Dragør";"no";0;0;0;55,594444;12,666111
1851;"Dragør";"no";0;0;0;55,594444;12,666111
1852;"Dragør";"no";0;0;0;55,594444;12,666111
1853;"Dragør";"no";0;0;0;55,594444;12,666111
1854;"Dragør";"no";0;0;0;55,594444;12,666111
1855;"Dragør";"no";0;0;0;55,594444;12,666111
1856;"Dragør";"no";0;0;0;55,594444;12,666111
1857;"Dragør";"no";0;0;0;55,594444;12,666111
1634;"Fladstrand";"no";0;0;0;57,440555;10,536388
1635;"Fladstrand";"no";0;0;0;57,440555;10,536388
1636;"Fladstrand";"no";0;0;0;57,440555;10,536388
1637;"Fladstrand";"no";0;0;0;57,440555;10,536388
1638;"Fladstrand";"no";0;0;0;57,440555;10,536388
1639;"Fladstrand";"no";0;0;0;57,440555;10,536388
1640;"Fladstrand";"no";1;0;1;57,440555;10,536388
1641;"Fladstrand";"no";0;0;0;57,440555;10,536388
1642;"Fladstrand";"no";0;0;0;57,440555;10,536388
1643;"Fladstrand";"no";0;0;0;57,440555;10,536388
1644;"Fladstrand";"no";0;0;0;57,440555;10,536388
1645;"Fladstrand";"no";0;0;0;57,440555;10,536388
1646;"Fladstrand";"no";0;0;0;57,440555;10,536388
1647;"Fladstrand";"no";0;0;0;57,440555;10,536388
1648;"Fladstrand";"no";0;0;0;57,440555;10,536388
1649;"Fladstrand";"no";0;0;0;57,440555;10,536388
1650;"Fladstrand";"no";0;0;0;57,440555;10,536388
1651;"Fladstrand";"no";0;0;0;57,440555;10,536388
1652;"Fladstrand";"no";0;0;0;57,440555;10,536388
1653;"Fladstrand";"no";0;0;0;57,440555;10,536388
1654;"Fladstrand";"no";0;0;0;57,440555;10,536388
1655;"Fladstrand";"no";0;0;0;57,440555;10,536388
1656;"Fladstrand";"no";0;0;0;57,440555;10,536388
1657;"Fladstrand";"no";1;0;1;57,440555;10,536388
1658;"Fladstrand";"no";0;0;0;57,440555;10,536388
1659;"Fladstrand";"no";0;0;0;57,440555;10,536388
1660;"Fladstrand";"no";0;0;0;57,440555;10,536388
1661;"Fladstrand";"no";0;0;0;57,440555;10,536388
1662;"Fladstrand";"no";1;0;1;57,440555;10,536388
1663;"Fladstrand";"no";0;0;0;57,440555;10,536388
1664;"Fladstrand";"no";0;0;0;57,440555;10,536388
1665;"Fladstrand";"no";0;0;0;57,440555;10,536388
1666;"Fladstrand";"no";0;0;0;57,440555;10,536388
1667;"Fladstrand";"no";1;1;2;57,440555;10,536388
1668;"Fladstrand";"no";0;0;0;57,440555;10,536388
1669;"Fladstrand";"no";0;0;0;57,440555;10,536388
1670;"Fladstrand";"no";0;0;0;57,440555;10,536388
1671;"Fladstrand";"no";1;0;1;57,440555;10,536388
1672;"Fladstrand";"no";0;0;0;57,440555;10,536388
1673;"Fladstrand";"no";0;0;0;57,440555;10,536388
1674;"Fladstrand";"no";0;0;0;57,440555;10,536388
1675;"Fladstrand";"no";0;1;1;57,440555;10,536388
1676;"Fladstrand";"no";0;0;0;57,440555;10,536388
1677;"Fladstrand";"no";0;0;0;57,440555;10,536388
1678;"Fladstrand";"no";0;0;0;57,440555;10,536388
1679;"Fladstrand";"no";0;1;1;57,440555;10,536388
1680;"Fladstrand";"no";0;0;0;57,440555;10,536388
1681;"Fladstrand";"no";0;1;1;57,440555;10,536388
1682;"Fladstrand";"no";0;1;1;57,440555;10,536388
1683;"Fladstrand";"no";0;0;0;57,440555;10,536388
1684;"Fladstrand";"no";1;3;4;57,440555;10,536388
1685;"Fladstrand";"no";0;2;2;57,440555;10,536388
1686;"Fladstrand";"no";1;0;1;57,440555;10,536388
1687;"Fladstrand";"no";1;1;2;57,440555;10,536388
1688;"Fladstrand";"no";0;0;0;57,440555;10,536388
1689;"Fladstrand";"no";0;0;0;57,440555;10,536388
1690;"Fladstrand";"no";0;3;3;57,440555;10,536388
1691;"Fladstrand";"no";0;0;0;57,440555;10,536388
1692;"Fladstrand";"no";0;0;0;57,440555;10,536388
1693;"Fladstrand";"no";0;1;1;57,440555;10,536388
1694;"Fladstrand";"no";0;0;0;57,440555;10,536388
1695;"Fladstrand";"no";1;0;1;57,440555;10,536388
1696;"Fladstrand";"no";2;0;2;57,440555;10,536388
1697;"Fladstrand";"no";0;0;0;57,440555;10,536388
1698;"Fladstrand";"no";0;0;0;57,440555;10,536388
1699;"Fladstrand";"no";0;1;1;57,440555;10,536388
1700;"Fladstrand";"no";0;0;0;57,440555;10,536388
1701;"Fladstrand";"no";0;0;0;57,440555;10,536388
1702;"Fladstrand";"no";0;0;0;57,440555;10,536388
1703;"Fladstrand";"no";0;3;3;57,440555;10,536388
1704;"Fladstrand";"no";1;0;1;57,440555;10,536388
1705;"Fladstrand";"no";1;1;2;57,440555;10,536388
1706;"Fladstrand";"no";0;0;0;57,440555;10,536388
1707;"Fladstrand";"no";0;0;0;57,440555;10,536388
1708;"Fladstrand";"no";1;0;1;57,440555;10,536388
1709;"Fladstrand";"no";0;1;1;57,440555;10,536388
1710;"Fladstrand";"no";0;0;0;57,440555;10,536388
1711;"Fladstrand";"no";0;0;0;57,440555;10,536388
1712;"Fladstrand";"no";0;0;0;57,440555;10,536388
1713;"Fladstrand";"no";0;0;0;57,440555;10,536388
1714;"Fladstrand";"no";1;0;1;57,440555;10,536388
1715;"Fladstrand";"no";0;1;1;57,440555;10,536388
1716;"Fladstrand";"no";0;2;2;57,440555;10,536388
1717;"Fladstrand";"no";1;0;1;57,440555;10,536388
1718;"Fladstrand";"no";0;0;0;57,440555;10,536388
1719;"Fladstrand";"no";0;0;0;57,440555;10,536388
1720;"Fladstrand";"no";0;1;1;57,440555;10,536388
1721;"Fladstrand";"no";0;0;0;57,440555;10,536388
1722;"Fladstrand";"no";0;0;0;57,440555;10,536388
1723;"Fladstrand";"no";0;0;0;57,440555;10,536388
1724;"Fladstrand";"no";9;6;15;57,440555;10,536388
1725;"Fladstrand";"no";9;2;11;57,440555;10,536388
1726;"Fladstrand";"no";15;8;23;57,440555;10,536388
1727;"Fladstrand";"no";12;6;18;57,440555;10,536388
1728;"Fladstrand";"no";10;6;16;57,440555;10,536388
1729;"Fladstrand";"no";8;9;17;57,440555;10,536388
1730;"Fladstrand";"no";7;6;13;57,440555;10,536388
1731;"Fladstrand";"no";8;5;13;57,440555;10,536388
1732;"Fladstrand";"no";14;7;21;57,440555;10,536388
1733;"Fladstrand";"no";10;8;18;57,440555;10,536388
1734;"Fladstrand";"no";20;11;31;57,440555;10,536388
1735;"Fladstrand";"no";20;5;25;57,440555;10,536388
1736;"Fladstrand";"no";14;6;20;57,440555;10,536388
1737;"Fladstrand";"no";20;13;33;57,440555;10,536388
1738;"Fladstrand";"no";31;10;41;57,440555;10,536388
1739;"Fladstrand";"no";24;9;33;57,440555;10,536388
1740;"Fladstrand";"no";15;5;20;57,440555;10,536388
1741;"Fladstrand";"no";15;7;22;57,440555;10,536388
1742;"Fladstrand";"no";11;6;17;57,440555;10,536388
1743;"Fladstrand";"no";0;1;1;57,440555;10,536388
1744;"Fladstrand";"no";2;1;3;57,440555;10,536388
1745;"Fladstrand";"no";13;7;20;57,440555;10,536388
1746;"Fladstrand";"no";7;4;11;57,440555;10,536388
1747;"Fladstrand";"no";11;7;18;57,440555;10,536388
1748;"Fladstrand";"no";11;5;16;57,440555;10,536388
1749;"Fladstrand";"no";13;6;19;57,440555;10,536388
1750;"Fladstrand";"no";12;6;18;57,440555;10,536388
1751;"Fladstrand";"no";6;2;8;57,440555;10,536388
1752;"Fladstrand";"no";16;6;22;57,440555;10,536388
1753;"Fladstrand";"no";11;8;19;57,440555;10,536388
1754;"Fladstrand";"no";17;13;30;57,440555;10,536388
1755;"Fladstrand";"no";11;7;18;57,440555;10,536388
1756;"Fladstrand";"no";14;7;21;57,440555;10,536388
1757;"Fladstrand";"no";11;7;18;57,440555;10,536388
1758;"Fladstrand";"no";9;4;13;57,440555;10,536388
1759;"Fladstrand";"no";11;14;25;57,440555;10,536388
1760;"Fladstrand";"no";6;3;9;57,440555;10,536388
1761;"Fladstrand";"no";11;4;15;57,440555;10,536388
1762;"Fladstrand";"no";9;4;13;57,440555;10,536388
1763;"Fladstrand";"no";17;8;25;57,440555;10,536388
1764;"Fladstrand";"no";21;10;31;57,440555;10,536388
1765;"Fladstrand";"no";16;6;22;57,440555;10,536388
1766;"Fladstrand";"no";18;6;24;57,440555;10,536388
1767;"Fladstrand";"no";17;9;26;57,440555;10,536388
1768;"Fladstrand";"no";21;11;32;57,440555;10,536388
1769;"Fladstrand";"no";20;13;33;57,440555;10,536388
1770;"Fladstrand";"no";11;8;19;57,440555;10,536388
1771;"Fladstrand";"no";14;13;27;57,440555;10,536388
1772;"Fladstrand";"no";18;10;28;57,440555;10,536388
1773;"Fladstrand";"no";18;8;26;57,440555;10,536388
1774;"Fladstrand";"no";16;11;27;57,440555;10,536388
1775;"Fladstrand";"no";14;12;26;57,440555;10,536388
1776;"Fladstrand";"no";20;14;34;57,440555;10,536388
1777;"Fladstrand";"no";17;12;29;57,440555;10,536388
1778;"Fladstrand";"no";22;16;38;57,440555;10,536388
1779;"Fladstrand";"no";21;16;37;57,440555;10,536388
1780;"Fladstrand";"no";17;13;30;57,440555;10,536388
1781;"Fladstrand";"no";7;8;15;57,440555;10,536388
1782;"Fladstrand";"no";22;7;29;57,440555;10,536388
1783;"Fladstrand";"no";30;15;45;57,440555;10,536388
1784;"Fladstrand";"no";17;12;29;57,440555;10,536388
1785;"Fladstrand";"no";29;16;45;57,440555;10,536388
1786;"Fladstrand";"no";28;19;47;57,440555;10,536388
1787;"Fladstrand";"no";28;14;42;57,440555;10,536388
1788;"Fladstrand";"no";31;14;45;57,440555;10,536388
1789;"Fladstrand";"no";11;6;17;57,440555;10,536388
1790;"Fladstrand";"no";2;2;4;57,440555;10,536388
1791;"Fladstrand";"no";14;14;28;57,440555;10,536388
1792;"Fladstrand";"no";20;13;33;57,440555;10,536388
1793;"Fladstrand";"no";12;8;20;57,440555;10,536388
1794;"Fladstrand";"no";12;6;18;57,440555;10,536388
1795;"Fladstrand";"no";3;3;6;57,440555;10,536388
1796;"Fladstrand";"no";24;7;31;57,440555;10,536388
1797;"Fladstrand";"no";18;4;22;57,440555;10,536388
1798;"Fladstrand";"no";5;5;10;57,440555;10,536388
1799;"Fladstrand";"no";0;0;0;57,440555;10,536388
1800;"Fladstrand";"no";16;7;23;57,440555;10,536388
1801;"Fladstrand";"no";1;2;3;57,440555;10,536388
1802;"Fladstrand";"no";10;3;13;57,440555;10,536388
1803;"Fladstrand";"no";5;2;7;57,440555;10,536388
1804;"Fladstrand";"no";6;4;10;57,440555;10,536388
1805;"Fladstrand";"no";4;0;4;57,440555;10,536388
1806;"Fladstrand";"no";0;0;0;57,440555;10,536388
1807;"Fladstrand";"no";0;0;0;57,440555;10,536388
1808;"Fladstrand";"no";0;0;0;57,440555;10,536388
1809;"Fladstrand";"no";0;0;0;57,440555;10,536388
1810;"Fladstrand";"no";1;0;1;57,440555;10,536388
1811;"Fladstrand";"no";0;0;0;57,440555;10,536388
1812;"Fladstrand";"no";0;0;0;57,440555;10,536388
1813;"Fladstrand";"no";0;1;1;57,440555;10,536388
1814;"Fladstrand";"no";2;1;3;57,440555;10,536388
1815;"Fladstrand";"no";6;4;10;57,440555;10,536388
1816;"Fladstrand";"no";6;5;11;57,440555;10,536388
1817;"Fladstrand";"no";7;5;12;57,440555;10,536388
1818;"Fladstrand";"no";9;8;17;57,440555;10,536388
1819;"Fladstrand";"no";10;14;24;57,440555;10,536388
1820;"Fladstrand";"no";8;7;15;57,440555;10,536388
1821;"Fladstrand";"no";8;6;14;57,440555;10,536388
1822;"Fladstrand";"no";7;9;16;57,440555;10,536388
1823;"Fladstrand";"no";4;6;10;57,440555;10,536388
1824;"Fladstrand";"no";6;6;12;57,440555;10,536388
1825;"Fladstrand";"no";8;7;15;57,440555;10,536388
1826;"Fladstrand";"no";19;14;33;57,440555;10,536388
1827;"Fladstrand";"no";13;22;35;57,440555;10,536388
1828;"Fladstrand";"no";15;18;33;57,440555;10,536388
1829;"Fladstrand";"no";9;18;27;57,440555;10,536388
1830;"Fladstrand";"no";6;6;12;57,440555;10,536388
1831;"Fladstrand";"no";17;6;23;57,440555;10,536388
1832;"Fladstrand";"no";11;10;21;57,440555;10,536388
1833;"Fladstrand";"no";14;10;24;57,440555;10,536388
1834;"Fladstrand";"no";23;9;32;57,440555;10,536388
1835;"Fladstrand";"no";10;6;16;57,440555;10,536388
1836;"Fladstrand";"no";10;5;15;57,440555;10,536388
1837;"Fladstrand";"no";11;15;26;57,440555;10,536388
1838;"Fladstrand";"no";13;5;18;57,440555;10,536388
1839;"Fladstrand";"no";5;1;6;57,440555;10,536388
1840;"Fladstrand";"no";11;0;11;57,440555;10,536388
1841;"Fladstrand";"no";7;3;10;57,440555;10,536388
1842;"Fladstrand";"no";13;6;19;57,440555;10,536388
1843;"Fladstrand";"no";13;6;19;57,440555;10,536388
1844;"Fladstrand";"no";15;6;21;57,440555;10,536388
1845;"Fladstrand";"no";11;0;11;57,440555;10,536388
1846;"Fladstrand";"no";15;3;18;57,440555;10,536388
1847;"Fladstrand";"no";19;8;27;57,440555;10,536388
1848;"Fladstrand";"no";15;8;23;57,440555;10,536388
1849;"Fladstrand";"no";14;8;22;57,440555;10,536388
1850;"Fladstrand";"no";21;9;30;57,440555;10,536388
1851;"Fladstrand";"no";11;7;18;57,440555;10,536388
1852;"Fladstrand";"no";20;5;25;57,440555;10,536388
1853;"Fladstrand";"no";14;4;18;57,440555;10,536388
1854;"Fladstrand";"no";27;11;38;57,440555;10,536388
1855;"Fladstrand";"no";19;4;23;57,440555;10,536388
1856;"Fladstrand";"no";38;12;50;57,440555;10,536388
1857;"Fladstrand";"no";2;0;2;57,440555;10,536388
1634;"Hobro";"no";0;0;0;56,643055;9,790277
1635;"Hobro";"no";0;0;0;56,643055;9,790277
1636;"Hobro";"no";0;0;0;56,643055;9,790277
1637;"Hobro";"no";0;0;0;56,643055;9,790277
1638;"Hobro";"no";0;0;0;56,643055;9,790277
1639;"Hobro";"no";0;0;0;56,643055;9,790277
1640;"Hobro";"no";1;0;1;56,643055;9,790277
1641;"Hobro";"no";0;0;0;56,643055;9,790277
1642;"Hobro";"no";0;0;0;56,643055;9,790277
1643;"Hobro";"no";0;0;0;56,643055;9,790277
1644;"Hobro";"no";0;0;0;56,643055;9,790277
1645;"Hobro";"no";0;0;0;56,643055;9,790277
1646;"Hobro";"no";1;0;1;56,643055;9,790277
1647;"Hobro";"no";0;0;0;56,643055;9,790277
1648;"Hobro";"no";0;0;0;56,643055;9,790277
1649;"Hobro";"no";1;0;1;56,643055;9,790277
1650;"Hobro";"no";0;0;0;56,643055;9,790277
1651;"Hobro";"no";0;0;0;56,643055;9,790277
1652;"Hobro";"no";0;0;0;56,643055;9,790277
1653;"Hobro";"no";0;0;0;56,643055;9,790277
1654;"Hobro";"no";0;0;0;56,643055;9,790277
1655;"Hobro";"no";0;0;0;56,643055;9,790277
1656;"Hobro";"no";0;0;0;56,643055;9,790277
1657;"Hobro";"no";0;0;0;56,643055;9,790277
1658;"Hobro";"no";0;0;0;56,643055;9,790277
1659;"Hobro";"no";0;0;0;56,643055;9,790277
1660;"Hobro";"no";0;0;0;56,643055;9,790277
1661;"Hobro";"no";0;0;0;56,643055;9,790277
1662;"Hobro";"no";0;0;0;56,643055;9,790277
1663;"Hobro";"no";0;0;0;56,643055;9,790277
1664;"Hobro";"no";0;0;0;56,643055;9,790277
1665;"Hobro";"no";0;0;0;56,643055;9,790277
1666;"Hobro";"no";0;0;0;56,643055;9,790277
1667;"Hobro";"no";0;0;0;56,643055;9,790277
1668;"Hobro";"no";0;0;0;56,643055;9,790277
1669;"Hobro";"no";0;0;0;56,643055;9,790277
1670;"Hobro";"no";0;0;0;56,643055;9,790277
1671;"Hobro";"no";0;0;0;56,643055;9,790277
1672;"Hobro";"no";0;0;0;56,643055;9,790277
1673;"Hobro";"no";0;0;0;56,643055;9,790277
1674;"Hobro";"no";0;0;0;56,643055;9,790277
1675;"Hobro";"no";0;0;0;56,643055;9,790277
1676;"Hobro";"no";0;0;0;56,643055;9,790277
1677;"Hobro";"no";0;0;0;56,643055;9,790277
1678;"Hobro";"no";0;0;0;56,643055;9,790277
1679;"Hobro";"no";0;0;0;56,643055;9,790277
1680;"Hobro";"no";0;0;0;56,643055;9,790277
1681;"Hobro";"no";0;0;0;56,643055;9,790277
1682;"Hobro";"no";0;0;0;56,643055;9,790277
1683;"Hobro";"no";0;0;0;56,643055;9,790277
1684;"Hobro";"no";0;0;0;56,643055;9,790277
1685;"Hobro";"no";0;0;0;56,643055;9,790277
1686;"Hobro";"no";0;0;0;56,643055;9,790277
1687;"Hobro";"no";0;0;0;56,643055;9,790277
1688;"Hobro";"no";0;0;0;56,643055;9,790277
1689;"Hobro";"no";0;0;0;56,643055;9,790277
1690;"Hobro";"no";0;0;0;56,643055;9,790277
1691;"Hobro";"no";0;0;0;56,643055;9,790277
1692;"Hobro";"no";0;0;0;56,643055;9,790277
1693;"Hobro";"no";0;0;0;56,643055;9,790277
1694;"Hobro";"no";0;0;0;56,643055;9,790277
1695;"Hobro";"no";0;0;0;56,643055;9,790277
1696;"Hobro";"no";0;0;0;56,643055;9,790277
1697;"Hobro";"no";0;0;0;56,643055;9,790277
1698;"Hobro";"no";0;0;0;56,643055;9,790277
1699;"Hobro";"no";0;0;0;56,643055;9,790277
1700;"Hobro";"no";0;0;0;56,643055;9,790277
1701;"Hobro";"no";0;0;0;56,643055;9,790277
1702;"Hobro";"no";0;0;0;56,643055;9,790277
1703;"Hobro";"no";0;0;0;56,643055;9,790277
1704;"Hobro";"no";0;0;0;56,643055;9,790277
1705;"Hobro";"no";0;0;0;56,643055;9,790277
1706;"Hobro";"no";0;0;0;56,643055;9,790277
1707;"Hobro";"no";0;0;0;56,643055;9,790277
1708;"Hobro";"no";0;0;0;56,643055;9,790277
1709;"Hobro";"no";0;0;0;56,643055;9,790277
1710;"Hobro";"no";0;0;0;56,643055;9,790277
1711;"Hobro";"no";0;0;0;56,643055;9,790277
1712;"Hobro";"no";0;0;0;56,643055;9,790277
1713;"Hobro";"no";0;0;0;56,643055;9,790277
1714;"Hobro";"no";0;0;0;56,643055;9,790277
1715;"Hobro";"no";0;0;0;56,643055;9,790277
1716;"Hobro";"no";0;0;0;56,643055;9,790277
1717;"Hobro";"no";0;0;0;56,643055;9,790277
1718;"Hobro";"no";0;0;0;56,643055;9,790277
1719;"Hobro";"no";0;0;0;56,643055;9,790277
1720;"Hobro";"no";0;0;0;56,643055;9,790277
1721;"Hobro";"no";0;0;0;56,643055;9,790277
1722;"Hobro";"no";0;0;0;56,643055;9,790277
1723;"Hobro";"no";0;0;0;56,643055;9,790277
1724;"Hobro";"no";0;0;0;56,643055;9,790277
1725;"Hobro";"no";0;0;0;56,643055;9,790277
1726;"Hobro";"no";0;0;0;56,643055;9,790277
1727;"Hobro";"no";0;0;0;56,643055;9,790277
1728;"Hobro";"no";0;0;0;56,643055;9,790277
1729;"Hobro";"no";0;0;0;56,643055;9,790277
1730;"Hobro";"no";0;0;0;56,643055;9,790277
1731;"Hobro";"no";0;0;0;56,643055;9,790277
1732;"Hobro";"no";0;0;0;56,643055;9,790277
1733;"Hobro";"no";0;0;0;56,643055;9,790277
1734;"Hobro";"no";0;0;0;56,643055;9,790277
1735;"Hobro";"no";0;0;0;56,643055;9,790277
1736;"Hobro";"no";0;0;0;56,643055;9,790277
1737;"Hobro";"no";0;0;0;56,643055;9,790277
1738;"Hobro";"no";0;0;0;56,643055;9,790277
1739;"Hobro";"no";0;0;0;56,643055;9,790277
1740;"Hobro";"no";0;0;0;56,643055;9,790277
1741;"Hobro";"no";0;0;0;56,643055;9,790277
1742;"Hobro";"no";0;0;0;56,643055;9,790277
1743;"Hobro";"no";0;0;0;56,643055;9,790277
1744;"Hobro";"no";0;0;0;56,643055;9,790277
1745;"Hobro";"no";0;0;0;56,643055;9,790277
1746;"Hobro";"no";0;0;0;56,643055;9,790277
1747;"Hobro";"no";0;0;0;56,643055;9,790277
1748;"Hobro";"no";0;0;0;56,643055;9,790277
1749;"Hobro";"no";0;0;0;56,643055;9,790277
1750;"Hobro";"no";0;1;1;56,643055;9,790277
1751;"Hobro";"no";0;0;0;56,643055;9,790277
1752;"Hobro";"no";0;1;1;56,643055;9,790277
1753;"Hobro";"no";0;1;1;56,643055;9,790277
1754;"Hobro";"no";0;1;1;56,643055;9,790277
1755;"Hobro";"no";0;1;1;56,643055;9,790277
1756;"Hobro";"no";0;1;1;56,643055;9,790277
1757;"Hobro";"no";0;0;0;56,643055;9,790277
1758;"Hobro";"no";0;2;2;56,643055;9,790277
1759;"Hobro";"no";0;0;0;56,643055;9,790277
1760;"Hobro";"no";0;1;1;56,643055;9,790277
1761;"Hobro";"no";0;1;1;56,643055;9,790277
1762;"Hobro";"no";0;4;4;56,643055;9,790277
1763;"Hobro";"no";0;4;4;56,643055;9,790277
1764;"Hobro";"no";0;1;1;56,643055;9,790277
1765;"Hobro";"no";0;3;3;56,643055;9,790277
1766;"Hobro";"no";0;3;3;56,643055;9,790277
1767;"Hobro";"no";0;4;4;56,643055;9,790277
1768;"Hobro";"no";0;3;3;56,643055;9,790277
1769;"Hobro";"no";0;0;0;56,643055;9,790277
1770;"Hobro";"no";0;3;3;56,643055;9,790277
1771;"Hobro";"no";0;2;2;56,643055;9,790277
1772;"Hobro";"no";0;2;2;56,643055;9,790277
1773;"Hobro";"no";0;2;2;56,643055;9,790277
1774;"Hobro";"no";0;3;3;56,643055;9,790277
1775;"Hobro";"no";0;1;1;56,643055;9,790277
1776;"Hobro";"no";0;2;2;56,643055;9,790277
1777;"Hobro";"no";0;2;2;56,643055;9,790277
1778;"Hobro";"no";0;1;1;56,643055;9,790277
1779;"Hobro";"no";0;0;0;56,643055;9,790277
1780;"Hobro";"no";0;0;0;56,643055;9,790277
1781;"Hobro";"no";0;0;0;56,643055;9,790277
1782;"Hobro";"no";0;0;0;56,643055;9,790277
1783;"Hobro";"no";0;0;0;56,643055;9,790277
1784;"Hobro";"no";0;0;0;56,643055;9,790277
1785;"Hobro";"no";0;0;0;56,643055;9,790277
1786;"Hobro";"no";0;1;1;56,643055;9,790277
1787;"Hobro";"no";0;0;0;56,643055;9,790277
1788;"Hobro";"no";0;0;0;56,643055;9,790277
1789;"Hobro";"no";0;0;0;56,643055;9,790277
1790;"Hobro";"no";0;0;0;56,643055;9,790277
1791;"Hobro";"no";0;0;0;56,643055;9,790277
1792;"Hobro";"no";0;0;0;56,643055;9,790277
1793;"Hobro";"no";0;0;0;56,643055;9,790277
1794;"Hobro";"no";0;0;0;56,643055;9,790277
1795;"Hobro";"no";0;0;0;56,643055;9,790277
1796;"Hobro";"no";0;0;0;56,643055;9,790277
1797;"Hobro";"no";0;0;0;56,643055;9,790277
1798;"Hobro";"no";0;0;0;56,643055;9,790277
1799;"Hobro";"no";0;0;0;56,643055;9,790277
1800;"Hobro";"no";0;0;0;56,643055;9,790277
1801;"Hobro";"no";0;0;0;56,643055;9,790277
1802;"Hobro";"no";0;0;0;56,643055;9,790277
1803;"Hobro";"no";0;1;1;56,643055;9,790277
1804;"Hobro";"no";0;1;1;56,643055;9,790277
1805;"Hobro";"no";0;1;1;56,643055;9,790277
1806;"Hobro";"no";0;0;0;56,643055;9,790277
1807;"Hobro";"no";0;0;0;56,643055;9,790277
1808;"Hobro";"no";0;0;0;56,643055;9,790277
1809;"Hobro";"no";0;0;0;56,643055;9,790277
1810;"Hobro";"no";0;0;0;56,643055;9,790277
1811;"Hobro";"no";0;0;0;56,643055;9,790277
1812;"Hobro";"no";0;0;0;56,643055;9,790277
1813;"Hobro";"no";0;0;0;56,643055;9,790277
1814;"Hobro";"no";0;0;0;56,643055;9,790277
1815;"Hobro";"no";0;0;0;56,643055;9,790277
1816;"Hobro";"no";0;0;0;56,643055;9,790277
1817;"Hobro";"no";0;0;0;56,643055;9,790277
1818;"Hobro";"no";0;0;0;56,643055;9,790277
1819;"Hobro";"no";0;0;0;56,643055;9,790277
1820;"Hobro";"no";0;0;0;56,643055;9,790277
1821;"Hobro";"no";0;0;0;56,643055;9,790277
1822;"Hobro";"no";0;0;0;56,643055;9,790277
1823;"Hobro";"no";0;0;0;56,643055;9,790277
1824;"Hobro";"no";0;0;0;56,643055;9,790277
1825;"Hobro";"no";0;0;0;56,643055;9,790277
1826;"Hobro";"no";0;0;0;56,643055;9,790277
1827;"Hobro";"no";0;0;0;56,643055;9,790277
1828;"Hobro";"no";0;1;1;56,643055;9,790277
1829;"Hobro";"no";0;0;0;56,643055;9,790277
1830;"Hobro";"no";0;0;0;56,643055;9,790277
1831;"Hobro";"no";0;0;0;56,643055;9,790277
1832;"Hobro";"no";0;0;0;56,643055;9,790277
1833;"Hobro";"no";0;0;0;56,643055;9,790277
1834;"Hobro";"no";0;0;0;56,643055;9,790277
1835;"Hobro";"no";0;0;0;56,643055;9,790277
1836;"Hobro";"no";0;0;0;56,643055;9,790277
1837;"Hobro";"no";0;0;0;56,643055;9,790277
1838;"Hobro";"no";0;0;0;56,643055;9,790277
1839;"Hobro";"no";0;0;0;56,643055;9,790277
1840;"Hobro";"no";1;0;1;56,643055;9,790277
1841;"Hobro";"no";1;0;1;56,643055;9,790277
1842;"Hobro";"no";2;3;5;56,643055;9,790277
1843;"Hobro";"no";1;4;5;56,643055;9,790277
1844;"Hobro";"no";1;4;5;56,643055;9,790277
1845;"Hobro";"no";1;1;2;56,643055;9,790277
1846;"Hobro";"no";3;2;5;56,643055;9,790277
1847;"Hobro";"no";2;4;6;56,643055;9,790277
1848;"Hobro";"no";2;1;3;56,643055;9,790277
1849;"Hobro";"no";3;5;8;56,643055;9,790277
1850;"Hobro";"no";7;2;9;56,643055;9,790277
1851;"Hobro";"no";9;1;10;56,643055;9,790277
1852;"Hobro";"no";3;0;3;56,643055;9,790277
1853;"Hobro";"no";4;2;6;56,643055;9,790277
1854;"Hobro";"no";7;0;7;56,643055;9,790277
1855;"Hobro";"no";3;2;5;56,643055;9,790277
1856;"Hobro";"no";9;3;12;56,643055;9,790277
1857;"Hobro";"no";0;0;0;56,643055;9,790277
1634;"Roskilde";"no";0;0;0;55,641388;12,080277
1635;"Roskilde";"no";0;0;0;55,641388;12,080277
1636;"Roskilde";"no";0;0;0;55,641388;12,080277
1637;"Roskilde";"no";0;0;0;55,641388;12,080277
1638;"Roskilde";"no";0;0;0;55,641388;12,080277
1639;"Roskilde";"no";0;0;0;55,641388;12,080277
1640;"Roskilde";"no";2;0;2;55,641388;12,080277
1641;"Roskilde";"no";0;0;0;55,641388;12,080277
1642;"Roskilde";"no";0;0;0;55,641388;12,080277
1643;"Roskilde";"no";0;0;0;55,641388;12,080277
1644;"Roskilde";"no";0;0;0;55,641388;12,080277
1645;"Roskilde";"no";0;0;0;55,641388;12,080277
1646;"Roskilde";"no";0;0;0;55,641388;12,080277
1647;"Roskilde";"no";0;0;0;55,641388;12,080277
1648;"Roskilde";"no";0;0;0;55,641388;12,080277
1649;"Roskilde";"no";0;0;0;55,641388;12,080277
1650;"Roskilde";"no";0;0;0;55,641388;12,080277
1651;"Roskilde";"no";0;0;0;55,641388;12,080277
1652;"Roskilde";"no";0;0;0;55,641388;12,080277
1653;"Roskilde";"no";0;0;0;55,641388;12,080277
1654;"Roskilde";"no";0;0;0;55,641388;12,080277
1655;"Roskilde";"no";0;0;0;55,641388;12,080277
1656;"Roskilde";"no";0;0;0;55,641388;12,080277
1657;"Roskilde";"no";0;0;0;55,641388;12,080277
1658;"Roskilde";"no";0;0;0;55,641388;12,080277
1659;"Roskilde";"no";0;0;0;55,641388;12,080277
1660;"Roskilde";"no";0;0;0;55,641388;12,080277
1661;"Roskilde";"no";0;0;0;55,641388;12,080277
1662;"Roskilde";"no";0;0;0;55,641388;12,080277
1663;"Roskilde";"no";0;1;1;55,641388;12,080277
1664;"Roskilde";"no";0;0;0;55,641388;12,080277
1665;"Roskilde";"no";0;0;0;55,641388;12,080277
1666;"Roskilde";"no";0;0;0;55,641388;12,080277
1667;"Roskilde";"no";0;0;0;55,641388;12,080277
1668;"Roskilde";"no";1;0;1;55,641388;12,080277
1669;"Roskilde";"no";0;0;0;55,641388;12,080277
1670;"Roskilde";"no";0;0;0;55,641388;12,080277
1671;"Roskilde";"no";0;1;1;55,641388;12,080277
1672;"Roskilde";"no";0;0;0;55,641388;12,080277
1673;"Roskilde";"no";0;0;0;55,641388;12,080277
1674;"Roskilde";"no";0;0;0;55,641388;12,080277
1675;"Roskilde";"no";0;0;0;55,641388;12,080277
1676;"Roskilde";"no";0;1;1;55,641388;12,080277
1677;"Roskilde";"no";0;0;0;55,641388;12,080277
1678;"Roskilde";"no";0;0;0;55,641388;12,080277
1679;"Roskilde";"no";0;0;0;55,641388;12,080277
1680;"Roskilde";"no";1;0;1;55,641388;12,080277
1681;"Roskilde";"no";0;0;0;55,641388;12,080277
1682;"Roskilde";"no";0;0;0;55,641388;12,080277
1683;"Roskilde";"no";0;0;0;55,641388;12,080277
1684;"Roskilde";"no";0;0;0;55,641388;12,080277
1685;"Roskilde";"no";0;0;0;55,641388;12,080277
1686;"Roskilde";"no";0;0;0;55,641388;12,080277
1687;"Roskilde";"no";0;0;0;55,641388;12,080277
1688;"Roskilde";"no";0;0;0;55,641388;12,080277
1689;"Roskilde";"no";0;0;0;55,641388;12,080277
1690;"Roskilde";"no";0;0;0;55,641388;12,080277
1691;"Roskilde";"no";0;0;0;55,641388;12,080277
1692;"Roskilde";"no";0;0;0;55,641388;12,080277
1693;"Roskilde";"no";0;0;0;55,641388;12,080277
1694;"Roskilde";"no";0;0;0;55,641388;12,080277
1695;"Roskilde";"no";0;0;0;55,641388;12,080277
1696;"Roskilde";"no";0;0;0;55,641388;12,080277
1697;"Roskilde";"no";0;0;0;55,641388;12,080277
1698;"Roskilde";"no";0;0;0;55,641388;12,080277
1699;"Roskilde";"no";0;0;0;55,641388;12,080277
1700;"Roskilde";"no";0;0;0;55,641388;12,080277
1701;"Roskilde";"no";0;0;0;55,641388;12,080277
1702;"Roskilde";"no";0;0;0;55,641388;12,080277
1703;"Roskilde";"no";0;0;0;55,641388;12,080277
1704;"Roskilde";"no";0;0;0;55,641388;12,080277
1705;"Roskilde";"no";0;0;0;55,641388;12,080277
1706;"Roskilde";"no";0;0;0;55,641388;12,080277
1707;"Roskilde";"no";0;0;0;55,641388;12,080277
1708;"Roskilde";"no";0;0;0;55,641388;12,080277
1709;"Roskilde";"no";0;0;0;55,641388;12,080277
1710;"Roskilde";"no";0;0;0;55,641388;12,080277
1711;"Roskilde";"no";0;0;0;55,641388;12,080277
1712;"Roskilde";"no";0;0;0;55,641388;12,080277
1713;"Roskilde";"no";0;1;1;55,641388;12,080277
1714;"Roskilde";"no";0;0;0;55,641388;12,080277
1715;"Roskilde";"no";0;0;0;55,641388;12,080277
1716;"Roskilde";"no";0;0;0;55,641388;12,080277
1717;"Roskilde";"no";0;0;0;55,641388;12,080277
1718;"Roskilde";"no";0;0;0;55,641388;12,080277
1719;"Roskilde";"no";0;0;0;55,641388;12,080277
1720;"Roskilde";"no";0;1;1;55,641388;12,080277
1721;"Roskilde";"no";0;2;2;55,641388;12,080277
1722;"Roskilde";"no";0;3;3;55,641388;12,080277
1723;"Roskilde";"no";0;0;0;55,641388;12,080277
1724;"Roskilde";"no";0;1;1;55,641388;12,080277
1725;"Roskilde";"no";0;0;0;55,641388;12,080277
1726;"Roskilde";"no";0;2;2;55,641388;12,080277
1727;"Roskilde";"no";0;2;2;55,641388;12,080277
1728;"Roskilde";"no";0;0;0;55,641388;12,080277
1729;"Roskilde";"no";0;0;0;55,641388;12,080277
1730;"Roskilde";"no";0;0;0;55,641388;12,080277
1731;"Roskilde";"no";0;1;1;55,641388;12,080277
1732;"Roskilde";"no";0;0;0;55,641388;12,080277
1733;"Roskilde";"no";0;0;0;55,641388;12,080277
1734;"Roskilde";"no";0;1;1;55,641388;12,080277
1735;"Roskilde";"no";0;0;0;55,641388;12,080277
1736;"Roskilde";"no";0;0;0;55,641388;12,080277
1737;"Roskilde";"no";0;0;0;55,641388;12,080277
1738;"Roskilde";"no";0;0;0;55,641388;12,080277
1739;"Roskilde";"no";0;0;0;55,641388;12,080277
1740;"Roskilde";"no";0;0;0;55,641388;12,080277
1741;"Roskilde";"no";0;0;0;55,641388;12,080277
1742;"Roskilde";"no";0;0;0;55,641388;12,080277
1743;"Roskilde";"no";0;0;0;55,641388;12,080277
1744;"Roskilde";"no";0;0;0;55,641388;12,080277
1745;"Roskilde";"no";0;0;0;55,641388;12,080277
1746;"Roskilde";"no";1;0;1;55,641388;12,080277
1747;"Roskilde";"no";0;0;0;55,641388;12,080277
1748;"Roskilde";"no";0;0;0;55,641388;12,080277
1749;"Roskilde";"no";0;0;0;55,641388;12,080277
1750;"Roskilde";"no";0;0;0;55,641388;12,080277
1751;"Roskilde";"no";0;0;0;55,641388;12,080277
1752;"Roskilde";"no";0;0;0;55,641388;12,080277
1753;"Roskilde";"no";0;0;0;55,641388;12,080277
1754;"Roskilde";"no";0;0;0;55,641388;12,080277
1755;"Roskilde";"no";0;0;0;55,641388;12,080277
1756;"Roskilde";"no";0;0;0;55,641388;12,080277
1757;"Roskilde";"no";0;0;0;55,641388;12,080277
1758;"Roskilde";"no";0;0;0;55,641388;12,080277
1759;"Roskilde";"no";0;0;0;55,641388;12,080277
1760;"Roskilde";"no";0;0;0;55,641388;12,080277
1761;"Roskilde";"no";0;0;0;55,641388;12,080277
1762;"Roskilde";"no";0;0;0;55,641388;12,080277
1763;"Roskilde";"no";0;0;0;55,641388;12,080277
1764;"Roskilde";"no";0;0;0;55,641388;12,080277
1765;"Roskilde";"no";0;0;0;55,641388;12,080277
1766;"Roskilde";"no";0;0;0;55,641388;12,080277
1767;"Roskilde";"no";0;0;0;55,641388;12,080277
1768;"Roskilde";"no";0;0;0;55,641388;12,080277
1769;"Roskilde";"no";0;0;0;55,641388;12,080277
1770;"Roskilde";"no";0;0;0;55,641388;12,080277
1771;"Roskilde";"no";0;0;0;55,641388;12,080277
1772;"Roskilde";"no";0;0;0;55,641388;12,080277
1773;"Roskilde";"no";0;0;0;55,641388;12,080277
1774;"Roskilde";"no";0;0;0;55,641388;12,080277
1775;"Roskilde";"no";0;0;0;55,641388;12,080277
1776;"Roskilde";"no";0;0;0;55,641388;12,080277
1777;"Roskilde";"no";0;0;0;55,641388;12,080277
1778;"Roskilde";"no";0;0;0;55,641388;12,080277
1779;"Roskilde";"no";0;0;0;55,641388;12,080277
1780;"Roskilde";"no";0;0;0;55,641388;12,080277
1781;"Roskilde";"no";0;0;0;55,641388;12,080277
1782;"Roskilde";"no";0;0;0;55,641388;12,080277
1783;"Roskilde";"no";0;0;0;55,641388;12,080277
1784;"Roskilde";"no";0;0;0;55,641388;12,080277
1785;"Roskilde";"no";0;0;0;55,641388;12,080277
1786;"Roskilde";"no";0;0;0;55,641388;12,080277
1787;"Roskilde";"no";0;0;0;55,641388;12,080277
1788;"Roskilde";"no";0;0;0;55,641388;12,080277
1789;"Roskilde";"no";0;0;0;55,641388;12,080277
1790;"Roskilde";"no";0;0;0;55,641388;12,080277
1791;"Roskilde";"no";0;0;0;55,641388;12,080277
1792;"Roskilde";"no";0;0;0;55,641388;12,080277
1793;"Roskilde";"no";0;0;0;55,641388;12,080277
1794;"Roskilde";"no";0;0;0;55,641388;12,080277
1795;"Roskilde";"no";0;0;0;55,641388;12,080277
1796;"Roskilde";"no";0;0;0;55,641388;12,080277
1797;"Roskilde";"no";0;0;0;55,641388;12,080277
1798;"Roskilde";"no";0;0;0;55,641388;12,080277
1799;"Roskilde";"no";0;0;0;55,641388;12,080277
1800;"Roskilde";"no";0;0;0;55,641388;12,080277
1801;"Roskilde";"no";0;0;0;55,641388;12,080277
1802;"Roskilde";"no";0;0;0;55,641388;12,080277
1803;"Roskilde";"no";0;0;0;55,641388;12,080277
1804;"Roskilde";"no";0;0;0;55,641388;12,080277
1805;"Roskilde";"no";0;0;0;55,641388;12,080277
1806;"Roskilde";"no";0;0;0;55,641388;12,080277
1807;"Roskilde";"no";0;0;0;55,641388;12,080277
1808;"Roskilde";"no";0;0;0;55,641388;12,080277
1809;"Roskilde";"no";0;0;0;55,641388;12,080277
1810;"Roskilde";"no";0;0;0;55,641388;12,080277
1811;"Roskilde";"no";1;0;1;55,641388;12,080277
1812;"Roskilde";"no";0;0;0;55,641388;12,080277
1813;"Roskilde";"no";0;0;0;55,641388;12,080277
1814;"Roskilde";"no";0;0;0;55,641388;12,080277
1815;"Roskilde";"no";0;0;0;55,641388;12,080277
1816;"Roskilde";"no";0;0;0;55,641388;12,080277
1817;"Roskilde";"no";0;0;0;55,641388;12,080277
1818;"Roskilde";"no";0;0;0;55,641388;12,080277
1819;"Roskilde";"no";0;0;0;55,641388;12,080277
1820;"Roskilde";"no";0;0;0;55,641388;12,080277
1821;"Roskilde";"no";0;0;0;55,641388;12,080277
1822;"Roskilde";"no";0;0;0;55,641388;12,080277
1823;"Roskilde";"no";0;0;0;55,641388;12,080277
1824;"Roskilde";"no";0;0;0;55,641388;12,080277
1825;"Roskilde";"no";0;0;0;55,641388;12,080277
1826;"Roskilde";"no";0;0;0;55,641388;12,080277
1827;"Roskilde";"no";0;0;0;55,641388;12,080277
1828;"Roskilde";"no";0;0;0;55,641388;12,080277
1829;"Roskilde";"no";0;0;0;55,641388;12,080277
1830;"Roskilde";"no";0;0;0;55,641388;12,080277
1831;"Roskilde";"no";0;0;0;55,641388;12,080277
1832;"Roskilde";"no";0;0;0;55,641388;12,080277
1833;"Roskilde";"no";0;0;0;55,641388;12,080277
1834;"Roskilde";"no";0;0;0;55,641388;12,080277
1835;"Roskilde";"no";0;0;0;55,641388;12,080277
1836;"Roskilde";"no";0;0;0;55,641388;12,080277
1837;"Roskilde";"no";0;0;0;55,641388;12,080277
1838;"Roskilde";"no";2;0;2;55,641388;12,080277
1839;"Roskilde";"no";6;1;7;55,641388;12,080277
1840;"Roskilde";"no";2;1;3;55,641388;12,080277
1841;"Roskilde";"no";2;1;3;55,641388;12,080277
1842;"Roskilde";"no";2;0;2;55,641388;12,080277
1843;"Roskilde";"no";1;2;3;55,641388;12,080277
1844;"Roskilde";"no";4;4;8;55,641388;12,080277
1845;"Roskilde";"no";2;3;5;55,641388;12,080277
1846;"Roskilde";"no";3;3;6;55,641388;12,080277
1847;"Roskilde";"no";12;2;14;55,641388;12,080277
1848;"Roskilde";"no";2;2;4;55,641388;12,080277
1849;"Roskilde";"no";2;3;5;55,641388;12,080277
1850;"Roskilde";"no";3;3;6;55,641388;12,080277
1851;"Roskilde";"no";4;1;5;55,641388;12,080277
1852;"Roskilde";"no";1;1;2;55,641388;12,080277
1853;"Roskilde";"no";4;1;5;55,641388;12,080277
1854;"Roskilde";"no";12;1;13;55,641388;12,080277
1855;"Roskilde";"no";4;2;6;55,641388;12,080277
1856;"Roskilde";"no";9;3;12;55,641388;12,080277
1857;"Roskilde";"no";0;0;0;55,641388;12,080277
1634;"Thisted";"west";0;0;0;56,955;8,694722
1635;"Thisted";"west";0;0;0;56,955;8,694722
1636;"Thisted";"west";0;0;0;56,955;8,694722
1637;"Thisted";"west";0;0;0;56,955;8,694722
1638;"Thisted";"west";0;0;0;56,955;8,694722
1639;"Thisted";"west";0;0;0;56,955;8,694722
1640;"Thisted";"west";1;0;1;56,955;8,694722
1641;"Thisted";"west";0;0;0;56,955;8,694722
1642;"Thisted";"west";3;0;3;56,955;8,694722
1643;"Thisted";"west";1;0;1;56,955;8,694722
1644;"Thisted";"west";2;0;2;56,955;8,694722
1645;"Thisted";"west";0;0;0;56,955;8,694722
1646;"Thisted";"west";0;0;0;56,955;8,694722
1647;"Thisted";"west";0;0;0;56,955;8,694722
1648;"Thisted";"west";0;0;0;56,955;8,694722
1649;"Thisted";"west";0;0;0;56,955;8,694722
1650;"Thisted";"west";0;0;0;56,955;8,694722
1651;"Thisted";"west";0;0;0;56,955;8,694722
1652;"Thisted";"west";0;0;0;56,955;8,694722
1653;"Thisted";"west";0;0;0;56,955;8,694722
1654;"Thisted";"west";0;0;0;56,955;8,694722
1655;"Thisted";"west";0;0;0;56,955;8,694722
1656;"Thisted";"west";0;0;0;56,955;8,694722
1657;"Thisted";"west";0;0;0;56,955;8,694722
1658;"Thisted";"west";0;0;0;56,955;8,694722
1659;"Thisted";"west";0;0;0;56,955;8,694722
1660;"Thisted";"west";0;0;0;56,955;8,694722
1661;"Thisted";"west";0;0;0;56,955;8,694722
1662;"Thisted";"west";0;0;0;56,955;8,694722
1663;"Thisted";"west";0;0;0;56,955;8,694722
1664;"Thisted";"west";0;0;0;56,955;8,694722
1665;"Thisted";"west";1;0;1;56,955;8,694722
1666;"Thisted";"west";0;0;0;56,955;8,694722
1667;"Thisted";"west";0;0;0;56,955;8,694722
1668;"Thisted";"west";0;0;0;56,955;8,694722
1669;"Thisted";"west";0;0;0;56,955;8,694722
1670;"Thisted";"west";1;0;1;56,955;8,694722
1671;"Thisted";"west";0;0;0;56,955;8,694722
1672;"Thisted";"west";0;0;0;56,955;8,694722
1673;"Thisted";"west";0;0;0;56,955;8,694722
1674;"Thisted";"west";0;0;0;56,955;8,694722
1675;"Thisted";"west";0;0;0;56,955;8,694722
1676;"Thisted";"west";0;0;0;56,955;8,694722
1677;"Thisted";"west";0;0;0;56,955;8,694722
1678;"Thisted";"west";0;0;0;56,955;8,694722
1679;"Thisted";"west";0;0;0;56,955;8,694722
1680;"Thisted";"west";0;0;0;56,955;8,694722
1681;"Thisted";"west";0;0;0;56,955;8,694722
1682;"Thisted";"west";0;0;0;56,955;8,694722
1683;"Thisted";"west";0;0;0;56,955;8,694722
1684;"Thisted";"west";0;0;0;56,955;8,694722
1685;"Thisted";"west";0;0;0;56,955;8,694722
1686;"Thisted";"west";0;0;0;56,955;8,694722
1687;"Thisted";"west";0;0;0;56,955;8,694722
1688;"Thisted";"west";0;0;0;56,955;8,694722
1689;"Thisted";"west";0;0;0;56,955;8,694722
1690;"Thisted";"west";0;0;0;56,955;8,694722
1691;"Thisted";"west";0;0;0;56,955;8,694722
1692;"Thisted";"west";0;0;0;56,955;8,694722
1693;"Thisted";"west";0;0;0;56,955;8,694722
1694;"Thisted";"west";0;0;0;56,955;8,694722
1695;"Thisted";"west";0;0;0;56,955;8,694722
1696;"Thisted";"west";0;0;0;56,955;8,694722
1697;"Thisted";"west";0;0;0;56,955;8,694722
1698;"Thisted";"west";0;0;0;56,955;8,694722
1699;"Thisted";"west";0;0;0;56,955;8,694722
1700;"Thisted";"west";0;0;0;56,955;8,694722
1701;"Thisted";"west";0;0;0;56,955;8,694722
1702;"Thisted";"west";0;0;0;56,955;8,694722
1703;"Thisted";"west";0;0;0;56,955;8,694722
1704;"Thisted";"west";0;0;0;56,955;8,694722
1705;"Thisted";"west";0;0;0;56,955;8,694722
1706;"Thisted";"west";0;0;0;56,955;8,694722
1707;"Thisted";"west";0;0;0;56,955;8,694722
1708;"Thisted";"west";0;0;0;56,955;8,694722
1709;"Thisted";"west";0;0;0;56,955;8,694722
1710;"Thisted";"west";0;0;0;56,955;8,694722
1711;"Thisted";"west";0;0;0;56,955;8,694722
1712;"Thisted";"west";0;0;0;56,955;8,694722
1713;"Thisted";"west";0;0;0;56,955;8,694722
1714;"Thisted";"west";0;0;0;56,955;8,694722
1715;"Thisted";"west";0;0;0;56,955;8,694722
1716;"Thisted";"west";0;0;0;56,955;8,694722
1717;"Thisted";"west";0;0;0;56,955;8,694722
1718;"Thisted";"west";0;0;0;56,955;8,694722
1719;"Thisted";"west";0;0;0;56,955;8,694722
1720;"Thisted";"west";0;0;0;56,955;8,694722
1721;"Thisted";"west";0;0;0;56,955;8,694722
1722;"Thisted";"west";0;0;0;56,955;8,694722
1723;"Thisted";"west";0;0;0;56,955;8,694722
1724;"Thisted";"west";0;0;0;56,955;8,694722
1725;"Thisted";"west";0;0;0;56,955;8,694722
1726;"Thisted";"west";0;0;0;56,955;8,694722
1727;"Thisted";"west";0;0;0;56,955;8,694722
1728;"Thisted";"west";0;0;0;56,955;8,694722
1729;"Thisted";"west";0;0;0;56,955;8,694722
1730;"Thisted";"west";0;0;0;56,955;8,694722
1731;"Thisted";"west";0;0;0;56,955;8,694722
1732;"Thisted";"west";0;0;0;56,955;8,694722
1733;"Thisted";"west";0;0;0;56,955;8,694722
1734;"Thisted";"west";0;0;0;56,955;8,694722
1735;"Thisted";"west";0;0;0;56,955;8,694722
1736;"Thisted";"west";0;0;0;56,955;8,694722
1737;"Thisted";"west";0;0;0;56,955;8,694722
1738;"Thisted";"west";0;0;0;56,955;8,694722
1739;"Thisted";"west";0;0;0;56,955;8,694722
1740;"Thisted";"west";0;0;0;56,955;8,694722
1741;"Thisted";"west";0;0;0;56,955;8,694722
1742;"Thisted";"west";0;0;0;56,955;8,694722
1743;"Thisted";"west";0;0;0;56,955;8,694722
1744;"Thisted";"west";0;0;0;56,955;8,694722
1745;"Thisted";"west";0;0;0;56,955;8,694722
1746;"Thisted";"west";0;0;0;56,955;8,694722
1747;"Thisted";"west";0;0;0;56,955;8,694722
1748;"Thisted";"west";0;0;0;56,955;8,694722
1749;"Thisted";"west";0;0;0;56,955;8,694722
1750;"Thisted";"west";0;0;0;56,955;8,694722
1751;"Thisted";"west";0;0;0;56,955;8,694722
1752;"Thisted";"west";0;0;0;56,955;8,694722
1753;"Thisted";"west";0;0;0;56,955;8,694722
1754;"Thisted";"west";0;0;0;56,955;8,694722
1755;"Thisted";"west";0;0;0;56,955;8,694722
1756;"Thisted";"west";0;0;0;56,955;8,694722
1757;"Thisted";"west";0;0;0;56,955;8,694722
1758;"Thisted";"west";0;0;0;56,955;8,694722
1759;"Thisted";"west";0;0;0;56,955;8,694722
1760;"Thisted";"west";0;0;0;56,955;8,694722
1761;"Thisted";"west";0;0;0;56,955;8,694722
1762;"Thisted";"west";0;0;0;56,955;8,694722
1763;"Thisted";"west";0;0;0;56,955;8,694722
1764;"Thisted";"west";0;0;0;56,955;8,694722
1765;"Thisted";"west";0;0;0;56,955;8,694722
1766;"Thisted";"west";0;0;0;56,955;8,694722
1767;"Thisted";"west";0;0;0;56,955;8,694722
1768;"Thisted";"west";0;0;0;56,955;8,694722
1769;"Thisted";"west";0;0;0;56,955;8,694722
1770;"Thisted";"west";0;0;0;56,955;8,694722
1771;"Thisted";"west";0;0;0;56,955;8,694722
1772;"Thisted";"west";0;0;0;56,955;8,694722
1773;"Thisted";"west";0;0;0;56,955;8,694722
1774;"Thisted";"west";0;0;0;56,955;8,694722
1775;"Thisted";"west";0;0;0;56,955;8,694722
1776;"Thisted";"west";0;0;0;56,955;8,694722
1777;"Thisted";"west";0;0;0;56,955;8,694722
1778;"Thisted";"west";0;0;0;56,955;8,694722
1779;"Thisted";"west";0;0;0;56,955;8,694722
1780;"Thisted";"west";0;0;0;56,955;8,694722
1781;"Thisted";"west";0;0;0;56,955;8,694722
1782;"Thisted";"west";0;0;0;56,955;8,694722
1783;"Thisted";"west";0;0;0;56,955;8,694722
1784;"Thisted";"west";0;0;0;56,955;8,694722
1785;"Thisted";"west";0;0;0;56,955;8,694722
1786;"Thisted";"west";0;0;0;56,955;8,694722
1787;"Thisted";"west";0;0;0;56,955;8,694722
1788;"Thisted";"west";0;0;0;56,955;8,694722
1789;"Thisted";"west";0;0;0;56,955;8,694722
1790;"Thisted";"west";0;0;0;56,955;8,694722
1791;"Thisted";"west";0;0;0;56,955;8,694722
1792;"Thisted";"west";0;0;0;56,955;8,694722
1793;"Thisted";"west";0;0;0;56,955;8,694722
1794;"Thisted";"west";0;0;0;56,955;8,694722
1795;"Thisted";"west";0;0;0;56,955;8,694722
1796;"Thisted";"west";0;0;0;56,955;8,694722
1797;"Thisted";"west";0;0;0;56,955;8,694722
1798;"Thisted";"west";0;0;0;56,955;8,694722
1799;"Thisted";"west";0;0;0;56,955;8,694722
1800;"Thisted";"west";0;0;0;56,955;8,694722
1801;"Thisted";"west";0;0;0;56,955;8,694722
1802;"Thisted";"west";0;0;0;56,955;8,694722
1803;"Thisted";"west";1;0;1;56,955;8,694722
1804;"Thisted";"west";0;1;1;56,955;8,694722
1805;"Thisted";"west";0;0;0;56,955;8,694722
1806;"Thisted";"west";0;0;0;56,955;8,694722
1807;"Thisted";"west";0;0;0;56,955;8,694722
1808;"Thisted";"west";0;0;0;56,955;8,694722
1809;"Thisted";"west";0;0;0;56,955;8,694722
1810;"Thisted";"west";0;0;0;56,955;8,694722
1811;"Thisted";"west";0;0;0;56,955;8,694722
1812;"Thisted";"west";0;0;0;56,955;8,694722
1813;"Thisted";"west";0;0;0;56,955;8,694722
1814;"Thisted";"west";0;0;0;56,955;8,694722
1815;"Thisted";"west";0;0;0;56,955;8,694722
1816;"Thisted";"west";0;0;0;56,955;8,694722
1817;"Thisted";"west";1;0;1;56,955;8,694722
1818;"Thisted";"west";0;0;0;56,955;8,694722
1819;"Thisted";"west";0;0;0;56,955;8,694722
1820;"Thisted";"west";0;0;0;56,955;8,694722
1821;"Thisted";"west";0;0;0;56,955;8,694722
1822;"Thisted";"west";0;0;0;56,955;8,694722
1823;"Thisted";"west";0;0;0;56,955;8,694722
1824;"Thisted";"west";0;0;0;56,955;8,694722
1825;"Thisted";"west";1;0;1;56,955;8,694722
1826;"Thisted";"west";0;0;0;56,955;8,694722
1827;"Thisted";"west";0;0;0;56,955;8,694722
1828;"Thisted";"west";0;0;0;56,955;8,694722
1829;"Thisted";"west";1;0;1;56,955;8,694722
1830;"Thisted";"west";0;0;0;56,955;8,694722
1831;"Thisted";"west";0;0;0;56,955;8,694722
1832;"Thisted";"west";1;0;1;56,955;8,694722
1833;"Thisted";"west";1;1;2;56,955;8,694722
1834;"Thisted";"west";1;0;1;56,955;8,694722
1835;"Thisted";"west";1;0;1;56,955;8,694722
1836;"Thisted";"west";0;0;0;56,955;8,694722
1837;"Thisted";"west";3;1;4;56,955;8,694722
1838;"Thisted";"west";1;0;1;56,955;8,694722
1839;"Thisted";"west";0;1;1;56,955;8,694722
1840;"Thisted";"west";0;1;1;56,955;8,694722
1841;"Thisted";"west";0;1;1;56,955;8,694722
1842;"Thisted";"west";9;1;10;56,955;8,694722
1843;"Thisted";"west";4;4;8;56,955;8,694722
1844;"Thisted";"west";9;1;10;56,955;8,694722
1845;"Thisted";"west";9;3;12;56,955;8,694722
1846;"Thisted";"west";6;3;9;56,955;8,694722
1847;"Thisted";"west";7;1;8;56,955;8,694722
1848;"Thisted";"west";7;2;9;56,955;8,694722
1849;"Thisted";"west";6;0;6;56,955;8,694722
1850;"Thisted";"west";6;2;8;56,955;8,694722
1851;"Thisted";"west";12;5;17;56,955;8,694722
1852;"Thisted";"west";12;3;15;56,955;8,694722
1853;"Thisted";"west";8;1;9;56,955;8,694722
1854;"Thisted";"west";13;3;16;56,955;8,694722
1855;"Thisted";"west";13;5;18;56,955;8,694722
1856;"Thisted";"west";21;4;25;56,955;8,694722
1857;"Thisted";"west";0;0;0;56,955;8,694722
1634;"Kronborg Gevært";"no";0;1;1;56,038611;12,621388
1635;"Kronborg Gevært";"no";0;1;1;56,038611;12,621388
1636;"Kronborg Gevært";"no";0;0;0;56,038611;12,621388
1637;"Kronborg Gevært";"no";0;1;1;56,038611;12,621388
1638;"Kronborg Gevært";"no";0;0;0;56,038611;12,621388
1639;"Kronborg Gevært";"no";0;0;0;56,038611;12,621388
1640;"Kronborg Gevært";"no";0;0;0;56,038611;12,621388
1641;"Kronborg Gevært";"no";1;0;1;56,038611;12,621388
1642;"Kronborg Gevært";"no";1;0;1;56,038611;12,621388
1643;"Kronborg Gevært";"no";0;0;0;56,038611;12,621388
1644;"Kronborg Gevært";"no";0;0;0;56,038611;12,621388
1645;"Kronborg Gevært";"no";0;0;0;56,038611;12,621388
1646;"Kronborg Gevært";"no";0;0;0;56,038611;12,621388
1647;"Kronborg Gevært";"no";0;0;0;56,038611;12,621388
1648;"Kronborg Gevært";"no";0;0;0;56,038611;12,621388
1649;"Kronborg Gevært";"no";0;0;0;56,038611;12,621388
1650;"Kronborg Gevært";"no";0;0;0;56,038611;12,621388
1651;"Kronborg Gevært";"no";0;0;0;56,038611;12,621388
1652;"Kronborg Gevært";"no";0;0;0;56,038611;12,621388
1653;"Kronborg Gevært";"no";0;0;0;56,038611;12,621388
1654;"Kronborg Gevært";"no";0;0;0;56,038611;12,621388
1655;"Kronborg Gevært";"no";0;0;0;56,038611;12,621388
1656;"Kronborg Gevært";"no";0;0;0;56,038611;12,621388
1657;"Kronborg Gevært";"no";0;0;0;56,038611;12,621388
1658;"Kronborg Gevært";"no";0;0;0;56,038611;12,621388
1659;"Kronborg Gevært";"no";0;0;0;56,038611;12,621388
1660;"Kronborg Gevært";"no";0;0;0;56,038611;12,621388
1661;"Kronborg Gevært";"no";0;0;0;56,038611;12,621388
1662;"Kronborg Gevært";"no";0;0;0;56,038611;12,621388
1663;"Kronborg Gevært";"no";0;0;0;56,038611;12,621388
1664;"Kronborg Gevært";"no";0;0;0;56,038611;12,621388
1665;"Kronborg Gevært";"no";0;0;0;56,038611;12,621388
1666;"Kronborg Gevært";"no";0;0;0;56,038611;12,621388
1667;"Kronborg Gevært";"no";0;0;0;56,038611;12,621388
1668;"Kronborg Gevært";"no";0;0;0;56,038611;12,621388
1669;"Kronborg Gevært";"no";0;0;0;56,038611;12,621388
1670;"Kronborg Gevært";"no";0;0;0;56,038611;12,621388
1671;"Kronborg Gevært";"no";0;0;0;56,038611;12,621388
1672;"Kronborg Gevært";"no";0;1;1;56,038611;12,621388
1673;"Kronborg Gevært";"no";0;0;0;56,038611;12,621388
1674;"Kronborg Gevært";"no";0;0;0;56,038611;12,621388
1675;"Kronborg Gevært";"no";0;0;0;56,038611;12,621388
1676;"Kronborg Gevært";"no";0;0;0;56,038611;12,621388
1677;"Kronborg Gevært";"no";0;0;0;56,038611;12,621388
1678;"Kronborg Gevært";"no";0;0;0;56,038611;12,621388
1679;"Kronborg Gevært";"no";0;0;0;56,038611;12,621388
1680;"Kronborg Gevært";"no";0;0;0;56,038611;12,621388
1681;"Kronborg Gevært";"no";0;0;0;56,038611;12,621388
1682;"Kronborg Gevært";"no";1;1;2;56,038611;12,621388
1683;"Kronborg Gevært";"no";0;2;2;56,038611;12,621388
1684;"Kronborg Gevært";"no";0;0;0;56,038611;12,621388
1685;"Kronborg Gevært";"no";0;1;1;56,038611;12,621388
1686;"Kronborg Gevært";"no";0;0;0;56,038611;12,621388
1687;"Kronborg Gevært";"no";0;0;0;56,038611;12,621388
1688;"Kronborg Gevært";"no";0;1;1;56,038611;12,621388
1689;"Kronborg Gevært";"no";0;1;1;56,038611;12,621388
1690;"Kronborg Gevært";"no";0;0;0;56,038611;12,621388
1691;"Kronborg Gevært";"no";1;0;1;56,038611;12,621388
1692;"Kronborg Gevært";"no";0;0;0;56,038611;12,621388
1693;"Kronborg Gevært";"no";0;0;0;56,038611;12,621388
1694;"Kronborg Gevært";"no";0;0;0;56,038611;12,621388
1695;"Kronborg Gevært";"no";0;0;0;56,038611;12,621388
1696;"Kronborg Gevært";"no";0;0;0;56,038611;12,621388
1697;"Kronborg Gevært";"no";0;0;0;56,038611;12,621388
1698;"Kronborg Gevært";"no";0;0;0;56,038611;12,621388
1699;"Kronborg Gevært";"no";0;0;0;56,038611;12,621388
1700;"Kronborg Gevært";"no";0;0;0;56,038611;12,621388
1701;"Kronborg Gevært";"no";0;0;0;56,038611;12,621388
1702;"Kronborg Gevært";"no";0;0;0;56,038611;12,621388
1703;"Kronborg Gevært";"no";0;0;0;56,038611;12,621388
1704;"Kronborg Gevært";"no";0;0;0;56,038611;12,621388
1705;"Kronborg Gevært";"no";0;0;0;56,038611;12,621388
1706;"Kronborg Gevært";"no";0;0;0;56,038611;12,621388
1707;"Kronborg Gevært";"no";0;0;0;56,038611;12,621388
1708;"Kronborg Gevært";"no";0;0;0;56,038611;12,621388
1709;"Kronborg Gevært";"no";0;0;0;56,038611;12,621388
1710;"Kronborg Gevært";"no";0;0;0;56,038611;12,621388
1711;"Kronborg Gevært";"no";0;0;0;56,038611;12,621388
1712;"Kronborg Gevært";"no";0;0;0;56,038611;12,621388
1713;"Kronborg Gevært";"no";0;0;0;56,038611;12,621388
1714;"Kronborg Gevært";"no";0;0;0;56,038611;12,621388
1715;"Kronborg Gevært";"no";0;0;0;56,038611;12,621388
1716;"Kronborg Gevært";"no";0;0;0;56,038611;12,621388
1717;"Kronborg Gevært";"no";0;0;0;56,038611;12,621388
1718;"Kronborg Gevært";"no";0;0;0;56,038611;12,621388
1719;"Kronborg Gevært";"no";0;0;0;56,038611;12,621388
1720;"Kronborg Gevært";"no";0;0;0;56,038611;12,621388
1721;"Kronborg Gevært";"no";0;0;0;56,038611;12,621388
1722;"Kronborg Gevært";"no";0;0;0;56,038611;12,621388
1723;"Kronborg Gevært";"no";0;0;0;56,038611;12,621388
1724;"Kronborg Gevært";"no";0;0;0;56,038611;12,621388
1725;"Kronborg Gevært";"no";0;0;0;56,038611;12,621388
1726;"Kronborg Gevært";"no";0;0;0;56,038611;12,621388
1727;"Kronborg Gevært";"no";1;0;1;56,038611;12,621388
1728;"Kronborg Gevært";"no";0;0;0;56,038611;12,621388
1729;"Kronborg Gevært";"no";0;0;0;56,038611;12,621388
1730;"Kronborg Gevært";"no";0;0;0;56,038611;12,621388
1731;"Kronborg Gevært";"no";0;0;0;56,038611;12,621388
1732;"Kronborg Gevært";"no";0;0;0;56,038611;12,621388
1733;"Kronborg Gevært";"no";0;0;0;56,038611;12,621388
1734;"Kronborg Gevært";"no";0;0;0;56,038611;12,621388
1735;"Kronborg Gevært";"no";0;0;0;56,038611;12,621388
1736;"Kronborg Gevært";"no";0;0;0;56,038611;12,621388
1737;"Kronborg Gevært";"no";0;0;0;56,038611;12,621388
1738;"Kronborg Gevært";"no";0;0;0;56,038611;12,621388
1739;"Kronborg Gevært";"no";0;0;0;56,038611;12,621388
1740;"Kronborg Gevært";"no";0;0;0;56,038611;12,621388
1741;"Kronborg Gevært";"no";0;0;0;56,038611;12,621388
1742;"Kronborg Gevært";"no";0;0;0;56,038611;12,621388
1743;"Kronborg Gevært";"no";0;0;0;56,038611;12,621388
1744;"Kronborg Gevært";"no";0;0;0;56,038611;12,621388
1745;"Kronborg Gevært";"no";0;0;0;56,038611;12,621388
1746;"Kronborg Gevært";"no";0;0;0;56,038611;12,621388
1747;"Kronborg Gevært";"no";0;0;0;56,038611;12,621388
1748;"Kronborg Gevært";"no";0;0;0;56,038611;12,621388
1749;"Kronborg Gevært";"no";0;0;0;56,038611;12,621388
1750;"Kronborg Gevært";"no";0;0;0;56,038611;12,621388
1751;"Kronborg Gevært";"no";0;0;0;56,038611;12,621388
1752;"Kronborg Gevært";"no";0;0;0;56,038611;12,621388
1753;"Kronborg Gevært";"no";0;0;0;56,038611;12,621388
1754;"Kronborg Gevært";"no";0;0;0;56,038611;12,621388
1755;"Kronborg Gevært";"no";0;0;0;56,038611;12,621388
1756;"Kronborg Gevært";"no";0;0;0;56,038611;12,621388
1757;"Kronborg Gevært";"no";0;0;0;56,038611;12,621388
1758;"Kronborg Gevært";"no";0;0;0;56,038611;12,621388
1759;"Kronborg Gevært";"no";0;0;0;56,038611;12,621388
1760;"Kronborg Gevært";"no";0;0;0;56,038611;12,621388
1761;"Kronborg Gevært";"no";0;0;0;56,038611;12,621388
1762;"Kronborg Gevært";"no";0;0;0;56,038611;12,621388
1763;"Kronborg Gevært";"no";0;0;0;56,038611;12,621388
1764;"Kronborg Gevært";"no";0;0;0;56,038611;12,621388
1765;"Kronborg Gevært";"no";0;0;0;56,038611;12,621388
1766;"Kronborg Gevært";"no";0;0;0;56,038611;12,621388
1767;"Kronborg Gevært";"no";0;0;0;56,038611;12,621388
1768;"Kronborg Gevært";"no";0;0;0;56,038611;12,621388
1769;"Kronborg Gevært";"no";0;0;0;56,038611;12,621388
1770;"Kronborg Gevært";"no";0;0;0;56,038611;12,621388
1771;"Kronborg Gevært";"no";0;0;0;56,038611;12,621388
1772;"Kronborg Gevært";"no";0;0;0;56,038611;12,621388
1773;"Kronborg Gevært";"no";0;0;0;56,038611;12,621388
1774;"Kronborg Gevært";"no";0;0;0;56,038611;12,621388
1775;"Kronborg Gevært";"no";0;0;0;56,038611;12,621388
1776;"Kronborg Gevært";"no";0;0;0;56,038611;12,621388
1777;"Kronborg Gevært";"no";0;0;0;56,038611;12,621388
1778;"Kronborg Gevært";"no";0;0;0;56,038611;12,621388
1779;"Kronborg Gevært";"no";0;0;0;56,038611;12,621388
1780;"Kronborg Gevært";"no";0;0;0;56,038611;12,621388
1781;"Kronborg Gevært";"no";0;0;0;56,038611;12,621388
1782;"Kronborg Gevært";"no";0;0;0;56,038611;12,621388
1783;"Kronborg Gevært";"no";0;0;0;56,038611;12,621388
1784;"Kronborg Gevært";"no";0;0;0;56,038611;12,621388
1785;"Kronborg Gevært";"no";0;0;0;56,038611;12,621388
1786;"Kronborg Gevært";"no";0;0;0;56,038611;12,621388
1787;"Kronborg Gevært";"no";0;0;0;56,038611;12,621388
1788;"Kronborg Gevært";"no";0;0;0;56,038611;12,621388
1789;"Kronborg Gevært";"no";0;0;0;56,038611;12,621388
1790;"Kronborg Gevært";"no";1;1;2;56,038611;12,621388
1791;"Kronborg Gevært";"no";0;0;0;56,038611;12,621388
1792;"Kronborg Gevært";"no";0;0;0;56,038611;12,621388
1793;"Kronborg Gevært";"no";0;0;0;56,038611;12,621388
1794;"Kronborg Gevært";"no";0;0;0;56,038611;12,621388
1795;"Kronborg Gevært";"no";0;0;0;56,038611;12,621388
1796;"Kronborg Gevært";"no";0;0;0;56,038611;12,621388
1797;"Kronborg Gevært";"no";0;1;1;56,038611;12,621388
1798;"Kronborg Gevært";"no";0;0;0;56,038611;12,621388
1799;"Kronborg Gevært";"no";0;0;0;56,038611;12,621388
1800;"Kronborg Gevært";"no";0;0;0;56,038611;12,621388
1801;"Kronborg Gevært";"no";0;0;0;56,038611;12,621388
1802;"Kronborg Gevært";"no";0;0;0;56,038611;12,621388
1803;"Kronborg Gevært";"no";0;0;0;56,038611;12,621388
1804;"Kronborg Gevært";"no";0;0;0;56,038611;12,621388
1805;"Kronborg Gevært";"no";0;0;0;56,038611;12,621388
1806;"Kronborg Gevært";"no";0;0;0;56,038611;12,621388
1807;"Kronborg Gevært";"no";0;0;0;56,038611;12,621388
1808;"Kronborg Gevært";"no";0;0;0;56,038611;12,621388
1809;"Kronborg Gevært";"no";0;0;0;56,038611;12,621388
1810;"Kronborg Gevært";"no";0;0;0;56,038611;12,621388
1811;"Kronborg Gevært";"no";0;0;0;56,038611;12,621388
1812;"Kronborg Gevært";"no";0;0;0;56,038611;12,621388
1813;"Kronborg Gevært";"no";0;0;0;56,038611;12,621388
1814;"Kronborg Gevært";"no";0;0;0;56,038611;12,621388
1815;"Kronborg Gevært";"no";0;0;0;56,038611;12,621388
1816;"Kronborg Gevært";"no";0;0;0;56,038611;12,621388
1817;"Kronborg Gevært";"no";0;0;0;56,038611;12,621388
1818;"Kronborg Gevært";"no";0;0;0;56,038611;12,621388
1819;"Kronborg Gevært";"no";0;0;0;56,038611;12,621388
1820;"Kronborg Gevært";"no";0;0;0;56,038611;12,621388
1821;"Kronborg Gevært";"no";0;0;0;56,038611;12,621388
1822;"Kronborg Gevært";"no";0;0;0;56,038611;12,621388
1823;"Kronborg Gevært";"no";0;0;0;56,038611;12,621388
1824;"Kronborg Gevært";"no";0;0;0;56,038611;12,621388
1825;"Kronborg Gevært";"no";0;0;0;56,038611;12,621388
1826;"Kronborg Gevært";"no";0;0;0;56,038611;12,621388
1827;"Kronborg Gevært";"no";0;0;0;56,038611;12,621388
1828;"Kronborg Gevært";"no";0;0;0;56,038611;12,621388
1829;"Kronborg Gevært";"no";0;0;0;56,038611;12,621388
1830;"Kronborg Gevært";"no";0;0;0;56,038611;12,621388
1831;"Kronborg Gevært";"no";0;0;0;56,038611;12,621388
1832;"Kronborg Gevært";"no";0;0;0;56,038611;12,621388
1833;"Kronborg Gevært";"no";0;0;0;56,038611;12,621388
1834;"Kronborg Gevært";"no";0;0;0;56,038611;12,621388
1835;"Kronborg Gevært";"no";0;0;0;56,038611;12,621388
1836;"Kronborg Gevært";"no";0;0;0;56,038611;12,621388
1837;"Kronborg Gevært";"no";0;0;0;56,038611;12,621388
1838;"Kronborg Gevært";"no";0;0;0;56,038611;12,621388
1839;"Kronborg Gevært";"no";0;0;0;56,038611;12,621388
1840;"Kronborg Gevært";"no";0;0;0;56,038611;12,621388
1841;"Kronborg Gevært";"no";0;0;0;56,038611;12,621388
1842;"Kronborg Gevært";"no";0;0;0;56,038611;12,621388
1843;"Kronborg Gevært";"no";0;0;0;56,038611;12,621388
1844;"Kronborg Gevært";"no";0;0;0;56,038611;12,621388
1845;"Kronborg Gevært";"no";0;0;0;56,038611;12,621388
1846;"Kronborg Gevært";"no";0;0;0;56,038611;12,621388
1847;"Kronborg Gevært";"no";0;0;0;56,038611;12,621388
1848;"Kronborg Gevært";"no";0;0;0;56,038611;12,621388
1849;"Kronborg Gevært";"no";1;0;1;56,038611;12,621388
1850;"Kronborg Gevært";"no";0;0;0;56,038611;12,621388
1851;"Kronborg Gevært";"no";0;0;0;56,038611;12,621388
1852;"Kronborg Gevært";"no";0;0;0;56,038611;12,621388
1853;"Kronborg Gevært";"no";0;0;0;56,038611;12,621388
1854;"Kronborg Gevært";"no";0;0;0;56,038611;12,621388
1855;"Kronborg Gevært";"no";0;0;0;56,038611;12,621388
1856;"Kronborg Gevært";"no";0;0;0;56,038611;12,621388
1857;"Kronborg Gevært";"no";0;0;0;56,038611;12,621388
1634;"Nivå";"no";0;0;0;55,93124;12,516889
1635;"Nivå";"no";0;0;0;55,93124;12,516889
1636;"Nivå";"no";0;0;0;55,93124;12,516889
1637;"Nivå";"no";0;0;0;55,93124;12,516889
1638;"Nivå";"no";0;0;0;55,93124;12,516889
1639;"Nivå";"no";0;0;0;55,93124;12,516889
1640;"Nivå";"no";0;0;0;55,93124;12,516889
1641;"Nivå";"no";1;0;1;55,93124;12,516889
1642;"Nivå";"no";0;0;0;55,93124;12,516889
1643;"Nivå";"no";0;0;0;55,93124;12,516889
1644;"Nivå";"no";0;0;0;55,93124;12,516889
1645;"Nivå";"no";0;0;0;55,93124;12,516889
1646;"Nivå";"no";0;0;0;55,93124;12,516889
1647;"Nivå";"no";0;0;0;55,93124;12,516889
1648;"Nivå";"no";0;0;0;55,93124;12,516889
1649;"Nivå";"no";0;0;0;55,93124;12,516889
1650;"Nivå";"no";0;0;0;55,93124;12,516889
1651;"Nivå";"no";0;0;0;55,93124;12,516889
1652;"Nivå";"no";0;0;0;55,93124;12,516889
1653;"Nivå";"no";0;0;0;55,93124;12,516889
1654;"Nivå";"no";0;0;0;55,93124;12,516889
1655;"Nivå";"no";0;0;0;55,93124;12,516889
1656;"Nivå";"no";0;0;0;55,93124;12,516889
1657;"Nivå";"no";0;0;0;55,93124;12,516889
1658;"Nivå";"no";0;0;0;55,93124;12,516889
1659;"Nivå";"no";0;0;0;55,93124;12,516889
1660;"Nivå";"no";0;0;0;55,93124;12,516889
1661;"Nivå";"no";0;0;0;55,93124;12,516889
1662;"Nivå";"no";0;0;0;55,93124;12,516889
1663;"Nivå";"no";0;0;0;55,93124;12,516889
1664;"Nivå";"no";0;0;0;55,93124;12,516889
1665;"Nivå";"no";0;0;0;55,93124;12,516889
1666;"Nivå";"no";0;0;0;55,93124;12,516889
1667;"Nivå";"no";0;0;0;55,93124;12,516889
1668;"Nivå";"no";0;0;0;55,93124;12,516889
1669;"Nivå";"no";0;0;0;55,93124;12,516889
1670;"Nivå";"no";0;0;0;55,93124;12,516889
1671;"Nivå";"no";0;0;0;55,93124;12,516889
1672;"Nivå";"no";0;0;0;55,93124;12,516889
1673;"Nivå";"no";0;0;0;55,93124;12,516889
1674;"Nivå";"no";0;0;0;55,93124;12,516889
1675;"Nivå";"no";0;0;0;55,93124;12,516889
1676;"Nivå";"no";0;0;0;55,93124;12,516889
1677;"Nivå";"no";0;0;0;55,93124;12,516889
1678;"Nivå";"no";0;0;0;55,93124;12,516889
1679;"Nivå";"no";0;0;0;55,93124;12,516889
1680;"Nivå";"no";0;0;0;55,93124;12,516889
1681;"Nivå";"no";0;0;0;55,93124;12,516889
1682;"Nivå";"no";0;0;0;55,93124;12,516889
1683;"Nivå";"no";0;0;0;55,93124;12,516889
1684;"Nivå";"no";0;0;0;55,93124;12,516889
1685;"Nivå";"no";0;0;0;55,93124;12,516889
1686;"Nivå";"no";0;0;0;55,93124;12,516889
1687;"Nivå";"no";0;0;0;55,93124;12,516889
1688;"Nivå";"no";0;0;0;55,93124;12,516889
1689;"Nivå";"no";0;0;0;55,93124;12,516889
1690;"Nivå";"no";0;0;0;55,93124;12,516889
1691;"Nivå";"no";0;0;0;55,93124;12,516889
1692;"Nivå";"no";0;0;0;55,93124;12,516889
1693;"Nivå";"no";0;0;0;55,93124;12,516889
1694;"Nivå";"no";0;0;0;55,93124;12,516889
1695;"Nivå";"no";0;0;0;55,93124;12,516889
1696;"Nivå";"no";0;0;0;55,93124;12,516889
1697;"Nivå";"no";0;0;0;55,93124;12,516889
1698;"Nivå";"no";0;0;0;55,93124;12,516889
1699;"Nivå";"no";0;0;0;55,93124;12,516889
1700;"Nivå";"no";0;0;0;55,93124;12,516889
1701;"Nivå";"no";0;0;0;55,93124;12,516889
1702;"Nivå";"no";0;0;0;55,93124;12,516889
1703;"Nivå";"no";0;0;0;55,93124;12,516889
1704;"Nivå";"no";0;0;0;55,93124;12,516889
1705;"Nivå";"no";0;0;0;55,93124;12,516889
1706;"Nivå";"no";0;0;0;55,93124;12,516889
1707;"Nivå";"no";0;0;0;55,93124;12,516889
1708;"Nivå";"no";0;0;0;55,93124;12,516889
1709;"Nivå";"no";0;0;0;55,93124;12,516889
1710;"Nivå";"no";0;0;0;55,93124;12,516889
1711;"Nivå";"no";0;0;0;55,93124;12,516889
1712;"Nivå";"no";0;0;0;55,93124;12,516889
1713;"Nivå";"no";0;0;0;55,93124;12,516889
1714;"Nivå";"no";0;0;0;55,93124;12,516889
1715;"Nivå";"no";0;0;0;55,93124;12,516889
1716;"Nivå";"no";0;0;0;55,93124;12,516889
1717;"Nivå";"no";0;0;0;55,93124;12,516889
1718;"Nivå";"no";0;0;0;55,93124;12,516889
1719;"Nivå";"no";0;0;0;55,93124;12,516889
1720;"Nivå";"no";0;0;0;55,93124;12,516889
1721;"Nivå";"no";0;0;0;55,93124;12,516889
1722;"Nivå";"no";0;0;0;55,93124;12,516889
1723;"Nivå";"no";0;0;0;55,93124;12,516889
1724;"Nivå";"no";0;0;0;55,93124;12,516889
1725;"Nivå";"no";0;0;0;55,93124;12,516889
1726;"Nivå";"no";0;0;0;55,93124;12,516889
1727;"Nivå";"no";0;0;0;55,93124;12,516889
1728;"Nivå";"no";0;0;0;55,93124;12,516889
1729;"Nivå";"no";0;0;0;55,93124;12,516889
1730;"Nivå";"no";0;0;0;55,93124;12,516889
1731;"Nivå";"no";0;0;0;55,93124;12,516889
1732;"Nivå";"no";0;0;0;55,93124;12,516889
1733;"Nivå";"no";0;0;0;55,93124;12,516889
1734;"Nivå";"no";0;0;0;55,93124;12,516889
1735;"Nivå";"no";0;0;0;55,93124;12,516889
1736;"Nivå";"no";0;0;0;55,93124;12,516889
1737;"Nivå";"no";0;0;0;55,93124;12,516889
1738;"Nivå";"no";0;0;0;55,93124;12,516889
1739;"Nivå";"no";0;0;0;55,93124;12,516889
1740;"Nivå";"no";0;0;0;55,93124;12,516889
1741;"Nivå";"no";0;0;0;55,93124;12,516889
1742;"Nivå";"no";0;0;0;55,93124;12,516889
1743;"Nivå";"no";0;0;0;55,93124;12,516889
1744;"Nivå";"no";0;0;0;55,93124;12,516889
1745;"Nivå";"no";0;0;0;55,93124;12,516889
1746;"Nivå";"no";0;0;0;55,93124;12,516889
1747;"Nivå";"no";0;0;0;55,93124;12,516889
1748;"Nivå";"no";0;0;0;55,93124;12,516889
1749;"Nivå";"no";0;0;0;55,93124;12,516889
1750;"Nivå";"no";0;0;0;55,93124;12,516889
1751;"Nivå";"no";0;0;0;55,93124;12,516889
1752;"Nivå";"no";0;0;0;55,93124;12,516889
1753;"Nivå";"no";0;0;0;55,93124;12,516889
1754;"Nivå";"no";0;0;0;55,93124;12,516889
1755;"Nivå";"no";0;0;0;55,93124;12,516889
1756;"Nivå";"no";0;0;0;55,93124;12,516889
1757;"Nivå";"no";0;0;0;55,93124;12,516889
1758;"Nivå";"no";0;0;0;55,93124;12,516889
1759;"Nivå";"no";0;0;0;55,93124;12,516889
1760;"Nivå";"no";0;0;0;55,93124;12,516889
1761;"Nivå";"no";0;0;0;55,93124;12,516889
1762;"Nivå";"no";0;0;0;55,93124;12,516889
1763;"Nivå";"no";0;0;0;55,93124;12,516889
1764;"Nivå";"no";0;0;0;55,93124;12,516889
1765;"Nivå";"no";0;0;0;55,93124;12,516889
1766;"Nivå";"no";0;0;0;55,93124;12,516889
1767;"Nivå";"no";0;0;0;55,93124;12,516889
1768;"Nivå";"no";0;0;0;55,93124;12,516889
1769;"Nivå";"no";0;0;0;55,93124;12,516889
1770;"Nivå";"no";0;0;0;55,93124;12,516889
1771;"Nivå";"no";0;0;0;55,93124;12,516889
1772;"Nivå";"no";0;0;0;55,93124;12,516889
1773;"Nivå";"no";0;0;0;55,93124;12,516889
1774;"Nivå";"no";0;0;0;55,93124;12,516889
1775;"Nivå";"no";0;0;0;55,93124;12,516889
1776;"Nivå";"no";0;0;0;55,93124;12,516889
1777;"Nivå";"no";0;0;0;55,93124;12,516889
1778;"Nivå";"no";0;0;0;55,93124;12,516889
1779;"Nivå";"no";0;0;0;55,93124;12,516889
1780;"Nivå";"no";0;0;0;55,93124;12,516889
1781;"Nivå";"no";0;0;0;55,93124;12,516889
1782;"Nivå";"no";0;0;0;55,93124;12,516889
1783;"Nivå";"no";0;0;0;55,93124;12,516889
1784;"Nivå";"no";0;0;0;55,93124;12,516889
1785;"Nivå";"no";0;0;0;55,93124;12,516889
1786;"Nivå";"no";0;0;0;55,93124;12,516889
1787;"Nivå";"no";0;0;0;55,93124;12,516889
1788;"Nivå";"no";0;0;0;55,93124;12,516889
1789;"Nivå";"no";0;0;0;55,93124;12,516889
1790;"Nivå";"no";0;0;0;55,93124;12,516889
1791;"Nivå";"no";0;0;0;55,93124;12,516889
1792;"Nivå";"no";0;0;0;55,93124;12,516889
1793;"Nivå";"no";0;0;0;55,93124;12,516889
1794;"Nivå";"no";0;0;0;55,93124;12,516889
1795;"Nivå";"no";0;0;0;55,93124;12,516889
1796;"Nivå";"no";0;0;0;55,93124;12,516889
1797;"Nivå";"no";0;0;0;55,93124;12,516889
1798;"Nivå";"no";0;0;0;55,93124;12,516889
1799;"Nivå";"no";0;0;0;55,93124;12,516889
1800;"Nivå";"no";0;0;0;55,93124;12,516889
1801;"Nivå";"no";0;0;0;55,93124;12,516889
1802;"Nivå";"no";0;0;0;55,93124;12,516889
1803;"Nivå";"no";0;0;0;55,93124;12,516889
1804;"Nivå";"no";0;1;1;55,93124;12,516889
1805;"Nivå";"no";0;0;0;55,93124;12,516889
1806;"Nivå";"no";0;0;0;55,93124;12,516889
1807;"Nivå";"no";0;0;0;55,93124;12,516889
1808;"Nivå";"no";0;0;0;55,93124;12,516889
1809;"Nivå";"no";0;0;0;55,93124;12,516889
1810;"Nivå";"no";0;0;0;55,93124;12,516889
1811;"Nivå";"no";0;0;0;55,93124;12,516889
1812;"Nivå";"no";0;0;0;55,93124;12,516889
1813;"Nivå";"no";0;0;0;55,93124;12,516889
1814;"Nivå";"no";0;0;0;55,93124;12,516889
1815;"Nivå";"no";0;0;0;55,93124;12,516889
1816;"Nivå";"no";0;0;0;55,93124;12,516889
1817;"Nivå";"no";0;0;0;55,93124;12,516889
1818;"Nivå";"no";0;0;0;55,93124;12,516889
1819;"Nivå";"no";0;0;0;55,93124;12,516889
1820;"Nivå";"no";0;0;0;55,93124;12,516889
1821;"Nivå";"no";0;0;0;55,93124;12,516889
1822;"Nivå";"no";0;0;0;55,93124;12,516889
1823;"Nivå";"no";0;0;0;55,93124;12,516889
1824;"Nivå";"no";0;0;0;55,93124;12,516889
1825;"Nivå";"no";0;0;0;55,93124;12,516889
1826;"Nivå";"no";0;0;0;55,93124;12,516889
1827;"Nivå";"no";0;0;0;55,93124;12,516889
1828;"Nivå";"no";0;0;0;55,93124;12,516889
1829;"Nivå";"no";0;0;0;55,93124;12,516889
1830;"Nivå";"no";0;0;0;55,93124;12,516889
1831;"Nivå";"no";0;0;0;55,93124;12,516889
1832;"Nivå";"no";0;0;0;55,93124;12,516889
1833;"Nivå";"no";0;0;0;55,93124;12,516889
1834;"Nivå";"no";0;0;0;55,93124;12,516889
1835;"Nivå";"no";0;0;0;55,93124;12,516889
1836;"Nivå";"no";0;0;0;55,93124;12,516889
1837;"Nivå";"no";0;0;0;55,93124;12,516889
1838;"Nivå";"no";0;0;0;55,93124;12,516889
1839;"Nivå";"no";0;0;0;55,93124;12,516889
1840;"Nivå";"no";0;0;0;55,93124;12,516889
1841;"Nivå";"no";0;0;0;55,93124;12,516889
1842;"Nivå";"no";0;0;0;55,93124;12,516889
1843;"Nivå";"no";0;0;0;55,93124;12,516889
1844;"Nivå";"no";0;0;0;55,93124;12,516889
1845;"Nivå";"no";0;0;0;55,93124;12,516889
1846;"Nivå";"no";0;0;0;55,93124;12,516889
1847;"Nivå";"no";0;0;0;55,93124;12,516889
1848;"Nivå";"no";0;0;0;55,93124;12,516889
1849;"Nivå";"no";0;0;0;55,93124;12,516889
1850;"Nivå";"no";0;1;1;55,93124;12,516889
1851;"Nivå";"no";0;0;0;55,93124;12,516889
1852;"Nivå";"no";0;1;1;55,93124;12,516889
1853;"Nivå";"no";0;0;0;55,93124;12,516889
1854;"Nivå";"no";0;1;1;55,93124;12,516889
1855;"Nivå";"no";0;0;0;55,93124;12,516889
1856;"Nivå";"no";0;1;1;55,93124;12,516889
1857;"Nivå";"no";0;0;0;55,93124;12,516889
1634;"Nyborg";"no";0;0;0;55,3125;10,789444
1635;"Nyborg";"no";0;0;0;55,3125;10,789444
1636;"Nyborg";"no";0;0;0;55,3125;10,789444
1637;"Nyborg";"no";0;0;0;55,3125;10,789444
1638;"Nyborg";"no";0;0;0;55,3125;10,789444
1639;"Nyborg";"no";0;0;0;55,3125;10,789444
1640;"Nyborg";"no";0;0;0;55,3125;10,789444
1641;"Nyborg";"no";2;0;2;55,3125;10,789444
1642;"Nyborg";"no";0;0;0;55,3125;10,789444
1643;"Nyborg";"no";0;0;0;55,3125;10,789444
1644;"Nyborg";"no";0;0;0;55,3125;10,789444
1645;"Nyborg";"no";0;0;0;55,3125;10,789444
1646;"Nyborg";"no";0;0;0;55,3125;10,789444
1647;"Nyborg";"no";0;0;0;55,3125;10,789444
1648;"Nyborg";"no";0;0;0;55,3125;10,789444
1649;"Nyborg";"no";0;0;0;55,3125;10,789444
1650;"Nyborg";"no";0;0;0;55,3125;10,789444
1651;"Nyborg";"no";0;0;0;55,3125;10,789444
1652;"Nyborg";"no";0;0;0;55,3125;10,789444
1653;"Nyborg";"no";1;0;1;55,3125;10,789444
1654;"Nyborg";"no";0;0;0;55,3125;10,789444
1655;"Nyborg";"no";0;0;0;55,3125;10,789444
1656;"Nyborg";"no";0;0;0;55,3125;10,789444
1657;"Nyborg";"no";1;0;1;55,3125;10,789444
1658;"Nyborg";"no";0;0;0;55,3125;10,789444
1659;"Nyborg";"no";0;0;0;55,3125;10,789444
1660;"Nyborg";"no";0;0;0;55,3125;10,789444
1661;"Nyborg";"no";1;0;1;55,3125;10,789444
1662;"Nyborg";"no";0;0;0;55,3125;10,789444
1663;"Nyborg";"no";0;0;0;55,3125;10,789444
1664;"Nyborg";"no";1;0;1;55,3125;10,789444
1665;"Nyborg";"no";0;0;0;55,3125;10,789444
1666;"Nyborg";"no";0;0;0;55,3125;10,789444
1667;"Nyborg";"no";0;0;0;55,3125;10,789444
1668;"Nyborg";"no";0;0;0;55,3125;10,789444
1669;"Nyborg";"no";0;0;0;55,3125;10,789444
1670;"Nyborg";"no";0;0;0;55,3125;10,789444
1671;"Nyborg";"no";0;0;0;55,3125;10,789444
1672;"Nyborg";"no";0;1;1;55,3125;10,789444
1673;"Nyborg";"no";0;0;0;55,3125;10,789444
1674;"Nyborg";"no";0;0;0;55,3125;10,789444
1675;"Nyborg";"no";0;0;0;55,3125;10,789444
1676;"Nyborg";"no";0;0;0;55,3125;10,789444
1677;"Nyborg";"no";0;0;0;55,3125;10,789444
1678;"Nyborg";"no";0;0;0;55,3125;10,789444
1679;"Nyborg";"no";0;0;0;55,3125;10,789444
1680;"Nyborg";"no";0;0;0;55,3125;10,789444
1681;"Nyborg";"no";0;0;0;55,3125;10,789444
1682;"Nyborg";"no";0;0;0;55,3125;10,789444
1683;"Nyborg";"no";0;0;0;55,3125;10,789444
1684;"Nyborg";"no";0;0;0;55,3125;10,789444
1685;"Nyborg";"no";0;0;0;55,3125;10,789444
1686;"Nyborg";"no";0;0;0;55,3125;10,789444
1687;"Nyborg";"no";0;0;0;55,3125;10,789444
1688;"Nyborg";"no";0;0;0;55,3125;10,789444
1689;"Nyborg";"no";0;0;0;55,3125;10,789444
1690;"Nyborg";"no";0;0;0;55,3125;10,789444
1691;"Nyborg";"no";0;0;0;55,3125;10,789444
1692;"Nyborg";"no";0;0;0;55,3125;10,789444
1693;"Nyborg";"no";0;0;0;55,3125;10,789444
1694;"Nyborg";"no";0;0;0;55,3125;10,789444
1695;"Nyborg";"no";0;0;0;55,3125;10,789444
1696;"Nyborg";"no";0;1;1;55,3125;10,789444
1697;"Nyborg";"no";0;0;0;55,3125;10,789444
1698;"Nyborg";"no";0;0;0;55,3125;10,789444
1699;"Nyborg";"no";0;0;0;55,3125;10,789444
1700;"Nyborg";"no";0;1;1;55,3125;10,789444
1701;"Nyborg";"no";0;0;0;55,3125;10,789444
1702;"Nyborg";"no";0;0;0;55,3125;10,789444
1703;"Nyborg";"no";0;0;0;55,3125;10,789444
1704;"Nyborg";"no";0;0;0;55,3125;10,789444
1705;"Nyborg";"no";0;0;0;55,3125;10,789444
1706;"Nyborg";"no";0;0;0;55,3125;10,789444
1707;"Nyborg";"no";0;0;0;55,3125;10,789444
1708;"Nyborg";"no";0;0;0;55,3125;10,789444
1709;"Nyborg";"no";0;0;0;55,3125;10,789444
1710;"Nyborg";"no";2;0;2;55,3125;10,789444
1711;"Nyborg";"no";0;0;0;55,3125;10,789444
1712;"Nyborg";"no";0;0;0;55,3125;10,789444
1713;"Nyborg";"no";0;0;0;55,3125;10,789444
1714;"Nyborg";"no";0;0;0;55,3125;10,789444
1715;"Nyborg";"no";0;0;0;55,3125;10,789444
1716;"Nyborg";"no";0;0;0;55,3125;10,789444
1717;"Nyborg";"no";0;0;0;55,3125;10,789444
1718;"Nyborg";"no";0;0;0;55,3125;10,789444
1719;"Nyborg";"no";0;0;0;55,3125;10,789444
1720;"Nyborg";"no";0;0;0;55,3125;10,789444
1721;"Nyborg";"no";0;0;0;55,3125;10,789444
1722;"Nyborg";"no";0;0;0;55,3125;10,789444
1723;"Nyborg";"no";0;0;0;55,3125;10,789444
1724;"Nyborg";"no";0;0;0;55,3125;10,789444
1725;"Nyborg";"no";0;0;0;55,3125;10,789444
1726;"Nyborg";"no";0;0;0;55,3125;10,789444
1727;"Nyborg";"no";0;0;0;55,3125;10,789444
1728;"Nyborg";"no";0;1;1;55,3125;10,789444
1729;"Nyborg";"no";0;0;0;55,3125;10,789444
1730;"Nyborg";"no";0;0;0;55,3125;10,789444
1731;"Nyborg";"no";0;0;0;55,3125;10,789444
1732;"Nyborg";"no";0;0;0;55,3125;10,789444
1733;"Nyborg";"no";0;0;0;55,3125;10,789444
1734;"Nyborg";"no";0;0;0;55,3125;10,789444
1735;"Nyborg";"no";0;0;0;55,3125;10,789444
1736;"Nyborg";"no";0;0;0;55,3125;10,789444
1737;"Nyborg";"no";0;0;0;55,3125;10,789444
1738;"Nyborg";"no";0;0;0;55,3125;10,789444
1739;"Nyborg";"no";0;0;0;55,3125;10,789444
1740;"Nyborg";"no";0;0;0;55,3125;10,789444
1741;"Nyborg";"no";0;0;0;55,3125;10,789444
1742;"Nyborg";"no";0;0;0;55,3125;10,789444
1743;"Nyborg";"no";0;0;0;55,3125;10,789444
1744;"Nyborg";"no";0;0;0;55,3125;10,789444
1745;"Nyborg";"no";0;0;0;55,3125;10,789444
1746;"Nyborg";"no";0;0;0;55,3125;10,789444
1747;"Nyborg";"no";0;0;0;55,3125;10,789444
1748;"Nyborg";"no";0;0;0;55,3125;10,789444
1749;"Nyborg";"no";0;0;0;55,3125;10,789444
1750;"Nyborg";"no";0;0;0;55,3125;10,789444
1751;"Nyborg";"no";0;0;0;55,3125;10,789444
1752;"Nyborg";"no";0;0;0;55,3125;10,789444
1753;"Nyborg";"no";0;1;1;55,3125;10,789444
1754;"Nyborg";"no";0;0;0;55,3125;10,789444
1755;"Nyborg";"no";0;0;0;55,3125;10,789444
1756;"Nyborg";"no";0;0;0;55,3125;10,789444
1757;"Nyborg";"no";0;0;0;55,3125;10,789444
1758;"Nyborg";"no";0;0;0;55,3125;10,789444
1759;"Nyborg";"no";0;0;0;55,3125;10,789444
1760;"Nyborg";"no";0;0;0;55,3125;10,789444
1761;"Nyborg";"no";0;0;0;55,3125;10,789444
1762;"Nyborg";"no";0;0;0;55,3125;10,789444
1763;"Nyborg";"no";0;0;0;55,3125;10,789444
1764;"Nyborg";"no";0;0;0;55,3125;10,789444
1765;"Nyborg";"no";0;0;0;55,3125;10,789444
1766;"Nyborg";"no";0;1;1;55,3125;10,789444
1767;"Nyborg";"no";0;0;0;55,3125;10,789444
1768;"Nyborg";"no";0;1;1;55,3125;10,789444
1769;"Nyborg";"no";0;0;0;55,3125;10,789444
1770;"Nyborg";"no";1;0;1;55,3125;10,789444
1771;"Nyborg";"no";0;0;0;55,3125;10,789444
1772;"Nyborg";"no";0;0;0;55,3125;10,789444
1773;"Nyborg";"no";1;0;1;55,3125;10,789444
1774;"Nyborg";"no";0;0;0;55,3125;10,789444
1775;"Nyborg";"no";0;0;0;55,3125;10,789444
1776;"Nyborg";"no";0;0;0;55,3125;10,789444
1777;"Nyborg";"no";0;1;1;55,3125;10,789444
1778;"Nyborg";"no";0;0;0;55,3125;10,789444
1779;"Nyborg";"no";0;2;2;55,3125;10,789444
1780;"Nyborg";"no";0;0;0;55,3125;10,789444
1781;"Nyborg";"no";0;0;0;55,3125;10,789444
1782;"Nyborg";"no";0;0;0;55,3125;10,789444
1783;"Nyborg";"no";0;0;0;55,3125;10,789444
1784;"Nyborg";"no";0;0;0;55,3125;10,789444
1785;"Nyborg";"no";0;0;0;55,3125;10,789444
1786;"Nyborg";"no";0;0;0;55,3125;10,789444
1787;"Nyborg";"no";0;0;0;55,3125;10,789444
1788;"Nyborg";"no";0;0;0;55,3125;10,789444
1789;"Nyborg";"no";0;0;0;55,3125;10,789444
1790;"Nyborg";"no";0;0;0;55,3125;10,789444
1791;"Nyborg";"no";0;0;0;55,3125;10,789444
1792;"Nyborg";"no";0;0;0;55,3125;10,789444
1793;"Nyborg";"no";0;1;1;55,3125;10,789444
1794;"Nyborg";"no";0;0;0;55,3125;10,789444
1795;"Nyborg";"no";0;0;0;55,3125;10,789444
1796;"Nyborg";"no";0;0;0;55,3125;10,789444
1797;"Nyborg";"no";0;0;0;55,3125;10,789444
1798;"Nyborg";"no";0;0;0;55,3125;10,789444
1799;"Nyborg";"no";0;0;0;55,3125;10,789444
1800;"Nyborg";"no";0;0;0;55,3125;10,789444
1801;"Nyborg";"no";0;1;1;55,3125;10,789444
1802;"Nyborg";"no";0;0;0;55,3125;10,789444
1803;"Nyborg";"no";0;1;1;55,3125;10,789444
1804;"Nyborg";"no";0;0;0;55,3125;10,789444
1805;"Nyborg";"no";0;1;1;55,3125;10,789444
1806;"Nyborg";"no";0;0;0;55,3125;10,789444
1807;"Nyborg";"no";0;0;0;55,3125;10,789444
1808;"Nyborg";"no";0;0;0;55,3125;10,789444
1809;"Nyborg";"no";0;1;1;55,3125;10,789444
1810;"Nyborg";"no";1;5;6;55,3125;10,789444
1811;"Nyborg";"no";0;1;1;55,3125;10,789444
1812;"Nyborg";"no";0;5;5;55,3125;10,789444
1813;"Nyborg";"no";0;0;0;55,3125;10,789444
1814;"Nyborg";"no";0;0;0;55,3125;10,789444
1815;"Nyborg";"no";0;1;1;55,3125;10,789444
1816;"Nyborg";"no";0;1;1;55,3125;10,789444
1817;"Nyborg";"no";0;1;1;55,3125;10,789444
1818;"Nyborg";"no";0;1;1;55,3125;10,789444
1819;"Nyborg";"no";0;0;0;55,3125;10,789444
1820;"Nyborg";"no";0;0;0;55,3125;10,789444
1821;"Nyborg";"no";0;0;0;55,3125;10,789444
1822;"Nyborg";"no";1;0;1;55,3125;10,789444
1823;"Nyborg";"no";0;0;0;55,3125;10,789444
1824;"Nyborg";"no";0;0;0;55,3125;10,789444
1825;"Nyborg";"no";0;1;1;55,3125;10,789444
1826;"Nyborg";"no";1;0;1;55,3125;10,789444
1827;"Nyborg";"no";0;5;5;55,3125;10,789444
1828;"Nyborg";"no";0;0;0;55,3125;10,789444
1829;"Nyborg";"no";0;0;0;55,3125;10,789444
1830;"Nyborg";"no";0;1;1;55,3125;10,789444
1831;"Nyborg";"no";0;1;1;55,3125;10,789444
1832;"Nyborg";"no";0;1;1;55,3125;10,789444
1833;"Nyborg";"no";0;0;0;55,3125;10,789444
1834;"Nyborg";"no";0;0;0;55,3125;10,789444
1835;"Nyborg";"no";1;3;4;55,3125;10,789444
1836;"Nyborg";"no";0;0;0;55,3125;10,789444
1837;"Nyborg";"no";0;0;0;55,3125;10,789444
1838;"Nyborg";"no";0;1;1;55,3125;10,789444
1839;"Nyborg";"no";0;0;0;55,3125;10,789444
1840;"Nyborg";"no";0;0;0;55,3125;10,789444
1841;"Nyborg";"no";0;1;1;55,3125;10,789444
1842;"Nyborg";"no";0;1;1;55,3125;10,789444
1843;"Nyborg";"no";0;1;1;55,3125;10,789444
1844;"Nyborg";"no";0;0;0;55,3125;10,789444
1845;"Nyborg";"no";1;0;1;55,3125;10,789444
1846;"Nyborg";"no";0;0;0;55,3125;10,789444
1847;"Nyborg";"no";2;1;3;55,3125;10,789444
1848;"Nyborg";"no";1;1;2;55,3125;10,789444
1849;"Nyborg";"no";0;0;0;55,3125;10,789444
1850;"Nyborg";"no";0;2;2;55,3125;10,789444
1851;"Nyborg";"no";0;1;1;55,3125;10,789444
1852;"Nyborg";"no";0;3;3;55,3125;10,789444
1853;"Nyborg";"no";0;2;2;55,3125;10,789444
1854;"Nyborg";"no";0;0;0;55,3125;10,789444
1855;"Nyborg";"no";1;1;2;55,3125;10,789444
1856;"Nyborg";"no";0;0;0;55,3125;10,789444
1857;"Nyborg";"no";0;0;0;55,3125;10,789444
1634;"Rømø";"no";0;0;0;55,133333;8,516666
1635;"Rømø";"no";0;0;0;55,133333;8,516666
1636;"Rømø";"no";0;0;0;55,133333;8,516666
1637;"Rømø";"no";0;0;0;55,133333;8,516666
1638;"Rømø";"no";0;0;0;55,133333;8,516666
1639;"Rømø";"no";0;0;0;55,133333;8,516666
1640;"Rømø";"no";0;0;0;55,133333;8,516666
1641;"Rømø";"no";1;0;1;55,133333;8,516666
1642;"Rømø";"no";1;0;1;55,133333;8,516666
1643;"Rømø";"no";2;0;2;55,133333;8,516666
1644;"Rømø";"no";0;0;0;55,133333;8,516666
1645;"Rømø";"no";0;0;0;55,133333;8,516666
1646;"Rømø";"no";1;0;1;55,133333;8,516666
1647;"Rømø";"no";0;0;0;55,133333;8,516666
1648;"Rømø";"no";0;0;0;55,133333;8,516666
1649;"Rømø";"no";1;0;1;55,133333;8,516666
1650;"Rømø";"no";1;0;1;55,133333;8,516666
1651;"Rømø";"no";0;0;0;55,133333;8,516666
1652;"Rømø";"no";0;0;0;55,133333;8,516666
1653;"Rømø";"no";1;0;1;55,133333;8,516666
1654;"Rømø";"no";0;0;0;55,133333;8,516666
1655;"Rømø";"no";0;0;0;55,133333;8,516666
1656;"Rømø";"no";0;0;0;55,133333;8,516666
1657;"Rømø";"no";1;0;1;55,133333;8,516666
1658;"Rømø";"no";0;0;0;55,133333;8,516666
1659;"Rømø";"no";0;0;0;55,133333;8,516666
1660;"Rømø";"no";0;0;0;55,133333;8,516666
1661;"Rømø";"no";0;0;0;55,133333;8,516666
1662;"Rømø";"no";2;0;2;55,133333;8,516666
1663;"Rømø";"no";0;0;0;55,133333;8,516666
1664;"Rømø";"no";4;0;4;55,133333;8,516666
1665;"Rømø";"no";3;0;3;55,133333;8,516666
1666;"Rømø";"no";2;0;2;55,133333;8,516666
1667;"Rømø";"no";0;0;0;55,133333;8,516666
1668;"Rømø";"no";0;0;0;55,133333;8,516666
1669;"Rømø";"no";2;1;3;55,133333;8,516666
1670;"Rømø";"no";2;0;2;55,133333;8,516666
1671;"Rømø";"no";1;0;1;55,133333;8,516666
1672;"Rømø";"no";1;0;1;55,133333;8,516666
1673;"Rømø";"no";0;0;0;55,133333;8,516666
1674;"Rømø";"no";0;0;0;55,133333;8,516666
1675;"Rømø";"no";0;0;0;55,133333;8,516666
1676;"Rømø";"no";0;0;0;55,133333;8,516666
1677;"Rømø";"no";0;0;0;55,133333;8,516666
1678;"Rømø";"no";0;0;0;55,133333;8,516666
1679;"Rømø";"no";0;0;0;55,133333;8,516666
1680;"Rømø";"no";0;0;0;55,133333;8,516666
1681;"Rømø";"no";0;0;0;55,133333;8,516666
1682;"Rømø";"no";0;1;1;55,133333;8,516666
1683;"Rømø";"no";0;0;0;55,133333;8,516666
1684;"Rømø";"no";0;0;0;55,133333;8,516666
1685;"Rømø";"no";0;0;0;55,133333;8,516666
1686;"Rømø";"no";1;0;1;55,133333;8,516666
1687;"Rømø";"no";0;0;0;55,133333;8,516666
1688;"Rømø";"no";0;0;0;55,133333;8,516666
1689;"Rømø";"no";0;0;0;55,133333;8,516666
1690;"Rømø";"no";0;0;0;55,133333;8,516666
1691;"Rømø";"no";0;0;0;55,133333;8,516666
1692;"Rømø";"no";0;0;0;55,133333;8,516666
1693;"Rømø";"no";0;0;0;55,133333;8,516666
1694;"Rømø";"no";0;0;0;55,133333;8,516666
1695;"Rømø";"no";0;0;0;55,133333;8,516666
1696;"Rømø";"no";0;0;0;55,133333;8,516666
1697;"Rømø";"no";0;0;0;55,133333;8,516666
1698;"Rømø";"no";0;0;0;55,133333;8,516666
1699;"Rømø";"no";0;0;0;55,133333;8,516666
1700;"Rømø";"no";0;0;0;55,133333;8,516666
1701;"Rømø";"no";0;0;0;55,133333;8,516666
1702;"Rømø";"no";0;0;0;55,133333;8,516666
1703;"Rømø";"no";0;0;0;55,133333;8,516666
1704;"Rømø";"no";0;0;0;55,133333;8,516666
1705;"Rømø";"no";0;0;0;55,133333;8,516666
1706;"Rømø";"no";0;0;0;55,133333;8,516666
1707;"Rømø";"no";0;0;0;55,133333;8,516666
1708;"Rømø";"no";0;0;0;55,133333;8,516666
1709;"Rømø";"no";0;0;0;55,133333;8,516666
1710;"Rømø";"no";0;0;0;55,133333;8,516666
1711;"Rømø";"no";0;0;0;55,133333;8,516666
1712;"Rømø";"no";0;0;0;55,133333;8,516666
1713;"Rømø";"no";0;0;0;55,133333;8,516666
1714;"Rømø";"no";0;0;0;55,133333;8,516666
1715;"Rømø";"no";0;0;0;55,133333;8,516666
1716;"Rømø";"no";0;0;0;55,133333;8,516666
1717;"Rømø";"no";0;0;0;55,133333;8,516666
1718;"Rømø";"no";0;0;0;55,133333;8,516666
1719;"Rømø";"no";0;0;0;55,133333;8,516666
1720;"Rømø";"no";0;0;0;55,133333;8,516666
1721;"Rømø";"no";0;0;0;55,133333;8,516666
1722;"Rømø";"no";0;0;0;55,133333;8,516666
1723;"Rømø";"no";0;0;0;55,133333;8,516666
1724;"Rømø";"no";0;0;0;55,133333;8,516666
1725;"Rømø";"no";0;0;0;55,133333;8,516666
1726;"Rømø";"no";0;0;0;55,133333;8,516666
1727;"Rømø";"no";0;0;0;55,133333;8,516666
1728;"Rømø";"no";0;0;0;55,133333;8,516666
1729;"Rømø";"no";0;0;0;55,133333;8,516666
1730;"Rømø";"no";0;0;0;55,133333;8,516666
1731;"Rømø";"no";0;0;0;55,133333;8,516666
1732;"Rømø";"no";0;0;0;55,133333;8,516666
1733;"Rømø";"no";0;0;0;55,133333;8,516666
1734;"Rømø";"no";0;0;0;55,133333;8,516666
1735;"Rømø";"no";0;0;0;55,133333;8,516666
1736;"Rømø";"no";0;0;0;55,133333;8,516666
1737;"Rømø";"no";0;0;0;55,133333;8,516666
1738;"Rømø";"no";0;0;0;55,133333;8,516666
1739;"Rømø";"no";0;0;0;55,133333;8,516666
1740;"Rømø";"no";0;0;0;55,133333;8,516666
1741;"Rømø";"no";0;0;0;55,133333;8,516666
1742;"Rømø";"no";0;1;1;55,133333;8,516666
1743;"Rømø";"no";0;0;0;55,133333;8,516666
1744;"Rømø";"no";0;0;0;55,133333;8,516666
1745;"Rømø";"no";0;0;0;55,133333;8,516666
1746;"Rømø";"no";0;0;0;55,133333;8,516666
1747;"Rømø";"no";0;0;0;55,133333;8,516666
1748;"Rømø";"no";0;0;0;55,133333;8,516666
1749;"Rømø";"no";0;0;0;55,133333;8,516666
1750;"Rømø";"no";0;0;0;55,133333;8,516666
1751;"Rømø";"no";0;0;0;55,133333;8,516666
1752;"Rømø";"no";0;0;0;55,133333;8,516666
1753;"Rømø";"no";0;0;0;55,133333;8,516666
1754;"Rømø";"no";0;0;0;55,133333;8,516666
1755;"Rømø";"no";0;0;0;55,133333;8,516666
1756;"Rømø";"no";0;0;0;55,133333;8,516666
1757;"Rømø";"no";0;0;0;55,133333;8,516666
1758;"Rømø";"no";0;0;0;55,133333;8,516666
1759;"Rømø";"no";0;0;0;55,133333;8,516666
1760;"Rømø";"no";0;0;0;55,133333;8,516666
1761;"Rømø";"no";0;0;0;55,133333;8,516666
1762;"Rømø";"no";0;0;0;55,133333;8,516666
1763;"Rømø";"no";0;0;0;55,133333;8,516666
1764;"Rømø";"no";0;1;1;55,133333;8,516666
1765;"Rømø";"no";0;0;0;55,133333;8,516666
1766;"Rømø";"no";0;0;0;55,133333;8,516666
1767;"Rømø";"no";0;0;0;55,133333;8,516666
1768;"Rømø";"no";0;0;0;55,133333;8,516666
1769;"Rømø";"no";0;0;0;55,133333;8,516666
1770;"Rømø";"no";0;0;0;55,133333;8,516666
1771;"Rømø";"no";0;0;0;55,133333;8,516666
1772;"Rømø";"no";0;0;0;55,133333;8,516666
1773;"Rømø";"no";0;0;0;55,133333;8,516666
1774;"Rømø";"no";0;0;0;55,133333;8,516666
1775;"Rømø";"no";0;0;0;55,133333;8,516666
1776;"Rømø";"no";0;0;0;55,133333;8,516666
1777;"Rømø";"no";0;0;0;55,133333;8,516666
1778;"Rømø";"no";0;0;0;55,133333;8,516666
1779;"Rømø";"no";0;0;0;55,133333;8,516666
1780;"Rømø";"no";0;0;0;55,133333;8,516666
1781;"Rømø";"no";0;0;0;55,133333;8,516666
1782;"Rømø";"no";0;0;0;55,133333;8,516666
1783;"Rømø";"no";0;0;0;55,133333;8,516666
1784;"Rømø";"no";0;0;0;55,133333;8,516666
1785;"Rømø";"no";0;0;0;55,133333;8,516666
1786;"Rømø";"no";0;0;0;55,133333;8,516666
1787;"Rømø";"no";0;0;0;55,133333;8,516666
1788;"Rømø";"no";0;0;0;55,133333;8,516666
1789;"Rømø";"no";0;0;0;55,133333;8,516666
1790;"Rømø";"no";0;0;0;55,133333;8,516666
1791;"Rømø";"no";0;0;0;55,133333;8,516666
1792;"Rømø";"no";0;0;0;55,133333;8,516666
1793;"Rømø";"no";0;0;0;55,133333;8,516666
1794;"Rømø";"no";0;0;0;55,133333;8,516666
1795;"Rømø";"no";0;0;0;55,133333;8,516666
1796;"Rømø";"no";0;0;0;55,133333;8,516666
1797;"Rømø";"no";0;0;0;55,133333;8,516666
1798;"Rømø";"no";0;0;0;55,133333;8,516666
1799;"Rømø";"no";0;0;0;55,133333;8,516666
1800;"Rømø";"no";0;0;0;55,133333;8,516666
1801;"Rømø";"no";0;0;0;55,133333;8,516666
1802;"Rømø";"no";0;0;0;55,133333;8,516666
1803;"Rømø";"no";2;0;2;55,133333;8,516666
1804;"Rømø";"no";0;0;0;55,133333;8,516666
1805;"Rømø";"no";0;0;0;55,133333;8,516666
1806;"Rømø";"no";0;0;0;55,133333;8,516666
1807;"Rømø";"no";0;0;0;55,133333;8,516666
1808;"Rømø";"no";0;0;0;55,133333;8,516666
1809;"Rømø";"no";0;0;0;55,133333;8,516666
1810;"Rømø";"no";0;0;0;55,133333;8,516666
1811;"Rømø";"no";0;0;0;55,133333;8,516666
1812;"Rømø";"no";0;0;0;55,133333;8,516666
1813;"Rømø";"no";0;0;0;55,133333;8,516666
1814;"Rømø";"no";0;0;0;55,133333;8,516666
1815;"Rømø";"no";0;0;0;55,133333;8,516666
1816;"Rømø";"no";0;0;0;55,133333;8,516666
1817;"Rømø";"no";0;0;0;55,133333;8,516666
1818;"Rømø";"no";0;0;0;55,133333;8,516666
1819;"Rømø";"no";0;0;0;55,133333;8,516666
1820;"Rømø";"no";0;0;0;55,133333;8,516666
1821;"Rømø";"no";1;0;1;55,133333;8,516666
1822;"Rømø";"no";0;0;0;55,133333;8,516666
1823;"Rømø";"no";0;0;0;55,133333;8,516666
1824;"Rømø";"no";0;0;0;55,133333;8,516666
1825;"Rømø";"no";1;1;2;55,133333;8,516666
1826;"Rømø";"no";0;0;0;55,133333;8,516666
1827;"Rømø";"no";0;0;0;55,133333;8,516666
1828;"Rømø";"no";0;0;0;55,133333;8,516666
1829;"Rømø";"no";0;0;0;55,133333;8,516666
1830;"Rømø";"no";0;0;0;55,133333;8,516666
1831;"Rømø";"no";0;0;0;55,133333;8,516666
1832;"Rømø";"no";0;0;0;55,133333;8,516666
1833;"Rømø";"no";0;0;0;55,133333;8,516666
1834;"Rømø";"no";0;0;0;55,133333;8,516666
1835;"Rømø";"no";0;0;0;55,133333;8,516666
1836;"Rømø";"no";0;0;0;55,133333;8,516666
1837;"Rømø";"no";0;0;0;55,133333;8,516666
1838;"Rømø";"no";0;0;0;55,133333;8,516666
1839;"Rømø";"no";0;0;0;55,133333;8,516666
1840;"Rømø";"no";0;0;0;55,133333;8,516666
1841;"Rømø";"no";0;0;0;55,133333;8,516666
1842;"Rømø";"no";0;0;0;55,133333;8,516666
1843;"Rømø";"no";0;0;0;55,133333;8,516666
1844;"Rømø";"no";0;0;0;55,133333;8,516666
1845;"Rømø";"no";0;1;1;55,133333;8,516666
1846;"Rømø";"no";0;0;0;55,133333;8,516666
1847;"Rømø";"no";2;0;2;55,133333;8,516666
1848;"Rømø";"no";0;0;0;55,133333;8,516666
1849;"Rømø";"no";0;0;0;55,133333;8,516666
1850;"Rømø";"no";0;0;0;55,133333;8,516666
1851;"Rømø";"no";0;0;0;55,133333;8,516666
1852;"Rømø";"no";0;0;0;55,133333;8,516666
1853;"Rømø";"no";0;0;0;55,133333;8,516666
1854;"Rømø";"no";0;0;0;55,133333;8,516666
1855;"Rømø";"no";0;0;0;55,133333;8,516666
1856;"Rømø";"no";0;0;0;55,133333;8,516666
1857;"Rømø";"no";0;0;0;55,133333;8,516666
1634;"Ballum";"no";0;0;0;55,083333;8,666666
1635;"Ballum";"no";0;0;0;55,083333;8,666666
1636;"Ballum";"no";0;0;0;55,083333;8,666666
1637;"Ballum";"no";0;0;0;55,083333;8,666666
1638;"Ballum";"no";0;0;0;55,083333;8,666666
1639;"Ballum";"no";0;0;0;55,083333;8,666666
1640;"Ballum";"no";0;0;0;55,083333;8,666666
1641;"Ballum";"no";0;0;0;55,083333;8,666666
1642;"Ballum";"no";1;0;1;55,083333;8,666666
1643;"Ballum";"no";0;0;0;55,083333;8,666666
1644;"Ballum";"no";0;0;0;55,083333;8,666666
1645;"Ballum";"no";0;0;0;55,083333;8,666666
1646;"Ballum";"no";0;0;0;55,083333;8,666666
1647;"Ballum";"no";0;0;0;55,083333;8,666666
1648;"Ballum";"no";0;0;0;55,083333;8,666666
1649;"Ballum";"no";0;0;0;55,083333;8,666666
1650;"Ballum";"no";0;0;0;55,083333;8,666666
1651;"Ballum";"no";0;0;0;55,083333;8,666666
1652;"Ballum";"no";0;0;0;55,083333;8,666666
1653;"Ballum";"no";0;0;0;55,083333;8,666666
1654;"Ballum";"no";0;0;0;55,083333;8,666666
1655;"Ballum";"no";0;0;0;55,083333;8,666666
1656;"Ballum";"no";0;0;0;55,083333;8,666666
1657;"Ballum";"no";0;0;0;55,083333;8,666666
1658;"Ballum";"no";0;0;0;55,083333;8,666666
1659;"Ballum";"no";0;0;0;55,083333;8,666666
1660;"Ballum";"no";0;0;0;55,083333;8,666666
1661;"Ballum";"no";0;0;0;55,083333;8,666666
1662;"Ballum";"no";0;0;0;55,083333;8,666666
1663;"Ballum";"no";0;0;0;55,083333;8,666666
1664;"Ballum";"no";0;0;0;55,083333;8,666666
1665;"Ballum";"no";0;0;0;55,083333;8,666666
1666;"Ballum";"no";0;0;0;55,083333;8,666666
1667;"Ballum";"no";0;0;0;55,083333;8,666666
1668;"Ballum";"no";1;0;1;55,083333;8,666666
1669;"Ballum";"no";1;0;1;55,083333;8,666666
1670;"Ballum";"no";0;0;0;55,083333;8,666666
1671;"Ballum";"no";0;2;2;55,083333;8,666666
1672;"Ballum";"no";1;0;1;55,083333;8,666666
1673;"Ballum";"no";1;0;1;55,083333;8,666666
1674;"Ballum";"no";0;0;0;55,083333;8,666666
1675;"Ballum";"no";0;0;0;55,083333;8,666666
1676;"Ballum";"no";0;0;0;55,083333;8,666666
1677;"Ballum";"no";0;0;0;55,083333;8,666666
1678;"Ballum";"no";0;0;0;55,083333;8,666666
1679;"Ballum";"no";1;0;1;55,083333;8,666666
1680;"Ballum";"no";2;0;2;55,083333;8,666666
1681;"Ballum";"no";0;0;0;55,083333;8,666666
1682;"Ballum";"no";0;0;0;55,083333;8,666666
1683;"Ballum";"no";0;0;0;55,083333;8,666666
1684;"Ballum";"no";0;0;0;55,083333;8,666666
1685;"Ballum";"no";0;0;0;55,083333;8,666666
1686;"Ballum";"no";0;0;0;55,083333;8,666666
1687;"Ballum";"no";0;0;0;55,083333;8,666666
1688;"Ballum";"no";0;0;0;55,083333;8,666666
1689;"Ballum";"no";0;0;0;55,083333;8,666666
1690;"Ballum";"no";0;0;0;55,083333;8,666666
1691;"Ballum";"no";0;0;0;55,083333;8,666666
1692;"Ballum";"no";0;0;0;55,083333;8,666666
1693;"Ballum";"no";0;0;0;55,083333;8,666666
1694;"Ballum";"no";0;0;0;55,083333;8,666666
1695;"Ballum";"no";0;0;0;55,083333;8,666666
1696;"Ballum";"no";0;0;0;55,083333;8,666666
1697;"Ballum";"no";0;0;0;55,083333;8,666666
1698;"Ballum";"no";0;0;0;55,083333;8,666666
1699;"Ballum";"no";0;0;0;55,083333;8,666666
1700;"Ballum";"no";0;0;0;55,083333;8,666666
1701;"Ballum";"no";0;0;0;55,083333;8,666666
1702;"Ballum";"no";0;0;0;55,083333;8,666666
1703;"Ballum";"no";0;0;0;55,083333;8,666666
1704;"Ballum";"no";0;0;0;55,083333;8,666666
1705;"Ballum";"no";0;0;0;55,083333;8,666666
1706;"Ballum";"no";0;0;0;55,083333;8,666666
1707;"Ballum";"no";0;0;0;55,083333;8,666666
1708;"Ballum";"no";0;0;0;55,083333;8,666666
1709;"Ballum";"no";0;0;0;55,083333;8,666666
1710;"Ballum";"no";0;0;0;55,083333;8,666666
1711;"Ballum";"no";0;0;0;55,083333;8,666666
1712;"Ballum";"no";0;0;0;55,083333;8,666666
1713;"Ballum";"no";0;0;0;55,083333;8,666666
1714;"Ballum";"no";0;0;0;55,083333;8,666666
1715;"Ballum";"no";0;0;0;55,083333;8,666666
1716;"Ballum";"no";0;0;0;55,083333;8,666666
1717;"Ballum";"no";0;0;0;55,083333;8,666666
1718;"Ballum";"no";0;0;0;55,083333;8,666666
1719;"Ballum";"no";0;0;0;55,083333;8,666666
1720;"Ballum";"no";0;0;0;55,083333;8,666666
1721;"Ballum";"no";0;0;0;55,083333;8,666666
1722;"Ballum";"no";0;0;0;55,083333;8,666666
1723;"Ballum";"no";0;0;0;55,083333;8,666666
1724;"Ballum";"no";0;0;0;55,083333;8,666666
1725;"Ballum";"no";0;0;0;55,083333;8,666666
1726;"Ballum";"no";0;0;0;55,083333;8,666666
1727;"Ballum";"no";0;0;0;55,083333;8,666666
1728;"Ballum";"no";0;0;0;55,083333;8,666666
1729;"Ballum";"no";0;0;0;55,083333;8,666666
1730;"Ballum";"no";0;0;0;55,083333;8,666666
1731;"Ballum";"no";0;0;0;55,083333;8,666666
1732;"Ballum";"no";0;0;0;55,083333;8,666666
1733;"Ballum";"no";0;0;0;55,083333;8,666666
1734;"Ballum";"no";0;0;0;55,083333;8,666666
1735;"Ballum";"no";0;0;0;55,083333;8,666666
1736;"Ballum";"no";0;0;0;55,083333;8,666666
1737;"Ballum";"no";0;0;0;55,083333;8,666666
1738;"Ballum";"no";0;0;0;55,083333;8,666666
1739;"Ballum";"no";0;0;0;55,083333;8,666666
1740;"Ballum";"no";0;0;0;55,083333;8,666666
1741;"Ballum";"no";0;0;0;55,083333;8,666666
1742;"Ballum";"no";0;0;0;55,083333;8,666666
1743;"Ballum";"no";0;0;0;55,083333;8,666666
1744;"Ballum";"no";0;0;0;55,083333;8,666666
1745;"Ballum";"no";0;0;0;55,083333;8,666666
1746;"Ballum";"no";0;0;0;55,083333;8,666666
1747;"Ballum";"no";0;0;0;55,083333;8,666666
1748;"Ballum";"no";0;0;0;55,083333;8,666666
1749;"Ballum";"no";0;0;0;55,083333;8,666666
1750;"Ballum";"no";0;0;0;55,083333;8,666666
1751;"Ballum";"no";0;0;0;55,083333;8,666666
1752;"Ballum";"no";0;0;0;55,083333;8,666666
1753;"Ballum";"no";0;0;0;55,083333;8,666666
1754;"Ballum";"no";0;0;0;55,083333;8,666666
1755;"Ballum";"no";0;0;0;55,083333;8,666666
1756;"Ballum";"no";0;0;0;55,083333;8,666666
1757;"Ballum";"no";0;0;0;55,083333;8,666666
1758;"Ballum";"no";0;0;0;55,083333;8,666666
1759;"Ballum";"no";0;0;0;55,083333;8,666666
1760;"Ballum";"no";0;0;0;55,083333;8,666666
1761;"Ballum";"no";0;0;0;55,083333;8,666666
1762;"Ballum";"no";0;0;0;55,083333;8,666666
1763;"Ballum";"no";0;0;0;55,083333;8,666666
1764;"Ballum";"no";0;0;0;55,083333;8,666666
1765;"Ballum";"no";0;0;0;55,083333;8,666666
1766;"Ballum";"no";0;0;0;55,083333;8,666666
1767;"Ballum";"no";0;0;0;55,083333;8,666666
1768;"Ballum";"no";0;0;0;55,083333;8,666666
1769;"Ballum";"no";0;0;0;55,083333;8,666666
1770;"Ballum";"no";0;0;0;55,083333;8,666666
1771;"Ballum";"no";0;0;0;55,083333;8,666666
1772;"Ballum";"no";0;0;0;55,083333;8,666666
1773;"Ballum";"no";0;0;0;55,083333;8,666666
1774;"Ballum";"no";0;0;0;55,083333;8,666666
1775;"Ballum";"no";0;0;0;55,083333;8,666666
1776;"Ballum";"no";0;0;0;55,083333;8,666666
1777;"Ballum";"no";0;0;0;55,083333;8,666666
1778;"Ballum";"no";0;0;0;55,083333;8,666666
1779;"Ballum";"no";0;0;0;55,083333;8,666666
1780;"Ballum";"no";0;0;0;55,083333;8,666666
1781;"Ballum";"no";0;0;0;55,083333;8,666666
1782;"Ballum";"no";0;0;0;55,083333;8,666666
1783;"Ballum";"no";0;0;0;55,083333;8,666666
1784;"Ballum";"no";0;0;0;55,083333;8,666666
1785;"Ballum";"no";0;0;0;55,083333;8,666666
1786;"Ballum";"no";0;0;0;55,083333;8,666666
1787;"Ballum";"no";0;0;0;55,083333;8,666666
1788;"Ballum";"no";0;0;0;55,083333;8,666666
1789;"Ballum";"no";0;0;0;55,083333;8,666666
1790;"Ballum";"no";0;0;0;55,083333;8,666666
1791;"Ballum";"no";0;0;0;55,083333;8,666666
1792;"Ballum";"no";0;0;0;55,083333;8,666666
1793;"Ballum";"no";0;0;0;55,083333;8,666666
1794;"Ballum";"no";0;0;0;55,083333;8,666666
1795;"Ballum";"no";0;0;0;55,083333;8,666666
1796;"Ballum";"no";0;0;0;55,083333;8,666666
1797;"Ballum";"no";0;0;0;55,083333;8,666666
1798;"Ballum";"no";0;0;0;55,083333;8,666666
1799;"Ballum";"no";0;0;0;55,083333;8,666666
1800;"Ballum";"no";0;0;0;55,083333;8,666666
1801;"Ballum";"no";0;0;0;55,083333;8,666666
1802;"Ballum";"no";0;0;0;55,083333;8,666666
1803;"Ballum";"no";0;0;0;55,083333;8,666666
1804;"Ballum";"no";0;0;0;55,083333;8,666666
1805;"Ballum";"no";0;0;0;55,083333;8,666666
1806;"Ballum";"no";0;0;0;55,083333;8,666666
1807;"Ballum";"no";0;0;0;55,083333;8,666666
1808;"Ballum";"no";0;0;0;55,083333;8,666666
1809;"Ballum";"no";0;0;0;55,083333;8,666666
1810;"Ballum";"no";0;0;0;55,083333;8,666666
1811;"Ballum";"no";0;0;0;55,083333;8,666666
1812;"Ballum";"no";0;0;0;55,083333;8,666666
1813;"Ballum";"no";0;0;0;55,083333;8,666666
1814;"Ballum";"no";0;0;0;55,083333;8,666666
1815;"Ballum";"no";0;0;0;55,083333;8,666666
1816;"Ballum";"no";0;0;0;55,083333;8,666666
1817;"Ballum";"no";0;0;0;55,083333;8,666666
1818;"Ballum";"no";0;0;0;55,083333;8,666666
1819;"Ballum";"no";0;0;0;55,083333;8,666666
1820;"Ballum";"no";0;0;0;55,083333;8,666666
1821;"Ballum";"no";0;0;0;55,083333;8,666666
1822;"Ballum";"no";0;0;0;55,083333;8,666666
1823;"Ballum";"no";0;0;0;55,083333;8,666666
1824;"Ballum";"no";0;0;0;55,083333;8,666666
1825;"Ballum";"no";0;0;0;55,083333;8,666666
1826;"Ballum";"no";0;0;0;55,083333;8,666666
1827;"Ballum";"no";0;0;0;55,083333;8,666666
1828;"Ballum";"no";0;0;0;55,083333;8,666666
1829;"Ballum";"no";0;0;0;55,083333;8,666666
1830;"Ballum";"no";0;0;0;55,083333;8,666666
1831;"Ballum";"no";0;0;0;55,083333;8,666666
1832;"Ballum";"no";0;0;0;55,083333;8,666666
1833;"Ballum";"no";0;0;0;55,083333;8,666666
1834;"Ballum";"no";0;0;0;55,083333;8,666666
1835;"Ballum";"no";0;0;0;55,083333;8,666666
1836;"Ballum";"no";0;0;0;55,083333;8,666666
1837;"Ballum";"no";0;0;0;55,083333;8,666666
1838;"Ballum";"no";1;0;1;55,083333;8,666666
1839;"Ballum";"no";0;0;0;55,083333;8,666666
1840;"Ballum";"no";0;0;0;55,083333;8,666666
1841;"Ballum";"no";0;0;0;55,083333;8,666666
1842;"Ballum";"no";0;0;0;55,083333;8,666666
1843;"Ballum";"no";0;1;1;55,083333;8,666666
1844;"Ballum";"no";0;0;0;55,083333;8,666666
1845;"Ballum";"no";0;0;0;55,083333;8,666666
1846;"Ballum";"no";0;0;0;55,083333;8,666666
1847;"Ballum";"no";0;0;0;55,083333;8,666666
1848;"Ballum";"no";0;0;0;55,083333;8,666666
1849;"Ballum";"no";0;0;0;55,083333;8,666666
1850;"Ballum";"no";0;0;0;55,083333;8,666666
1851;"Ballum";"no";0;0;0;55,083333;8,666666
1852;"Ballum";"no";0;0;0;55,083333;8,666666
1853;"Ballum";"no";0;0;0;55,083333;8,666666
1854;"Ballum";"no";0;0;0;55,083333;8,666666
1855;"Ballum";"no";0;0;0;55,083333;8,666666
1856;"Ballum";"no";0;0;0;55,083333;8,666666
1857;"Ballum";"no";0;0;0;55,083333;8,666666
1634;"Femø";"no";0;0;0;54,98;11,53
1635;"Femø";"no";0;0;0;54,98;11,53
1636;"Femø";"no";0;0;0;54,98;11,53
1637;"Femø";"no";0;0;0;54,98;11,53
1638;"Femø";"no";0;0;0;54,98;11,53
1639;"Femø";"no";0;0;0;54,98;11,53
1640;"Femø";"no";0;0;0;54,98;11,53
1641;"Femø";"no";0;0;0;54,98;11,53
1642;"Femø";"no";1;0;1;54,98;11,53
1643;"Femø";"no";0;0;0;54,98;11,53
1644;"Femø";"no";0;0;0;54,98;11,53
1645;"Femø";"no";0;0;0;54,98;11,53
1646;"Femø";"no";0;0;0;54,98;11,53
1647;"Femø";"no";0;0;0;54,98;11,53
1648;"Femø";"no";0;0;0;54,98;11,53
1649;"Femø";"no";0;0;0;54,98;11,53
1650;"Femø";"no";0;0;0;54,98;11,53
1651;"Femø";"no";0;0;0;54,98;11,53
1652;"Femø";"no";0;0;0;54,98;11,53
1653;"Femø";"no";0;0;0;54,98;11,53
1654;"Femø";"no";0;0;0;54,98;11,53
1655;"Femø";"no";0;0;0;54,98;11,53
1656;"Femø";"no";0;0;0;54,98;11,53
1657;"Femø";"no";0;0;0;54,98;11,53
1658;"Femø";"no";0;0;0;54,98;11,53
1659;"Femø";"no";0;0;0;54,98;11,53
1660;"Femø";"no";0;0;0;54,98;11,53
1661;"Femø";"no";0;0;0;54,98;11,53
1662;"Femø";"no";0;0;0;54,98;11,53
1663;"Femø";"no";0;0;0;54,98;11,53
1664;"Femø";"no";0;0;0;54,98;11,53
1665;"Femø";"no";0;0;0;54,98;11,53
1666;"Femø";"no";0;0;0;54,98;11,53
1667;"Femø";"no";0;0;0;54,98;11,53
1668;"Femø";"no";0;0;0;54,98;11,53
1669;"Femø";"no";0;0;0;54,98;11,53
1670;"Femø";"no";0;0;0;54,98;11,53
1671;"Femø";"no";0;0;0;54,98;11,53
1672;"Femø";"no";0;0;0;54,98;11,53
1673;"Femø";"no";0;0;0;54,98;11,53
1674;"Femø";"no";0;0;0;54,98;11,53
1675;"Femø";"no";0;0;0;54,98;11,53
1676;"Femø";"no";0;0;0;54,98;11,53
1677;"Femø";"no";0;0;0;54,98;11,53
1678;"Femø";"no";0;0;0;54,98;11,53
1679;"Femø";"no";0;0;0;54,98;11,53
1680;"Femø";"no";0;0;0;54,98;11,53
1681;"Femø";"no";0;0;0;54,98;11,53
1682;"Femø";"no";0;0;0;54,98;11,53
1683;"Femø";"no";0;0;0;54,98;11,53
1684;"Femø";"no";0;0;0;54,98;11,53
1685;"Femø";"no";0;0;0;54,98;11,53
1686;"Femø";"no";0;0;0;54,98;11,53
1687;"Femø";"no";0;0;0;54,98;11,53
1688;"Femø";"no";0;0;0;54,98;11,53
1689;"Femø";"no";0;0;0;54,98;11,53
1690;"Femø";"no";0;0;0;54,98;11,53
1691;"Femø";"no";0;0;0;54,98;11,53
1692;"Femø";"no";0;0;0;54,98;11,53
1693;"Femø";"no";0;0;0;54,98;11,53
1694;"Femø";"no";0;0;0;54,98;11,53
1695;"Femø";"no";0;0;0;54,98;11,53
1696;"Femø";"no";0;0;0;54,98;11,53
1697;"Femø";"no";0;0;0;54,98;11,53
1698;"Femø";"no";0;0;0;54,98;11,53
1699;"Femø";"no";0;0;0;54,98;11,53
1700;"Femø";"no";0;0;0;54,98;11,53
1701;"Femø";"no";0;0;0;54,98;11,53
1702;"Femø";"no";0;0;0;54,98;11,53
1703;"Femø";"no";0;0;0;54,98;11,53
1704;"Femø";"no";0;0;0;54,98;11,53
1705;"Femø";"no";0;0;0;54,98;11,53
1706;"Femø";"no";0;0;0;54,98;11,53
1707;"Femø";"no";0;0;0;54,98;11,53
1708;"Femø";"no";0;0;0;54,98;11,53
1709;"Femø";"no";0;0;0;54,98;11,53
1710;"Femø";"no";0;0;0;54,98;11,53
1711;"Femø";"no";0;0;0;54,98;11,53
1712;"Femø";"no";0;0;0;54,98;11,53
1713;"Femø";"no";0;0;0;54,98;11,53
1714;"Femø";"no";0;0;0;54,98;11,53
1715;"Femø";"no";0;0;0;54,98;11,53
1716;"Femø";"no";0;0;0;54,98;11,53
1717;"Femø";"no";0;0;0;54,98;11,53
1718;"Femø";"no";0;0;0;54,98;11,53
1719;"Femø";"no";0;0;0;54,98;11,53
1720;"Femø";"no";0;0;0;54,98;11,53
1721;"Femø";"no";0;0;0;54,98;11,53
1722;"Femø";"no";0;0;0;54,98;11,53
1723;"Femø";"no";0;0;0;54,98;11,53
1724;"Femø";"no";0;0;0;54,98;11,53
1725;"Femø";"no";0;0;0;54,98;11,53
1726;"Femø";"no";0;0;0;54,98;11,53
1727;"Femø";"no";0;0;0;54,98;11,53
1728;"Femø";"no";0;0;0;54,98;11,53
1729;"Femø";"no";0;0;0;54,98;11,53
1730;"Femø";"no";0;0;0;54,98;11,53
1731;"Femø";"no";0;0;0;54,98;11,53
1732;"Femø";"no";0;0;0;54,98;11,53
1733;"Femø";"no";0;0;0;54,98;11,53
1734;"Femø";"no";0;0;0;54,98;11,53
1735;"Femø";"no";0;0;0;54,98;11,53
1736;"Femø";"no";0;0;0;54,98;11,53
1737;"Femø";"no";0;0;0;54,98;11,53
1738;"Femø";"no";0;0;0;54,98;11,53
1739;"Femø";"no";0;0;0;54,98;11,53
1740;"Femø";"no";0;0;0;54,98;11,53
1741;"Femø";"no";0;0;0;54,98;11,53
1742;"Femø";"no";0;0;0;54,98;11,53
1743;"Femø";"no";0;0;0;54,98;11,53
1744;"Femø";"no";0;0;0;54,98;11,53
1745;"Femø";"no";0;0;0;54,98;11,53
1746;"Femø";"no";0;0;0;54,98;11,53
1747;"Femø";"no";0;0;0;54,98;11,53
1748;"Femø";"no";0;0;0;54,98;11,53
1749;"Femø";"no";0;0;0;54,98;11,53
1750;"Femø";"no";0;0;0;54,98;11,53
1751;"Femø";"no";0;0;0;54,98;11,53
1752;"Femø";"no";0;0;0;54,98;11,53
1753;"Femø";"no";0;0;0;54,98;11,53
1754;"Femø";"no";0;0;0;54,98;11,53
1755;"Femø";"no";0;0;0;54,98;11,53
1756;"Femø";"no";0;0;0;54,98;11,53
1757;"Femø";"no";0;0;0;54,98;11,53
1758;"Femø";"no";0;0;0;54,98;11,53
1759;"Femø";"no";0;0;0;54,98;11,53
1760;"Femø";"no";0;0;0;54,98;11,53
1761;"Femø";"no";0;0;0;54,98;11,53
1762;"Femø";"no";0;0;0;54,98;11,53
1763;"Femø";"no";0;0;0;54,98;11,53
1764;"Femø";"no";0;0;0;54,98;11,53
1765;"Femø";"no";0;0;0;54,98;11,53
1766;"Femø";"no";0;0;0;54,98;11,53
1767;"Femø";"no";0;0;0;54,98;11,53
1768;"Femø";"no";0;0;0;54,98;11,53
1769;"Femø";"no";0;0;0;54,98;11,53
1770;"Femø";"no";0;0;0;54,98;11,53
1771;"Femø";"no";0;0;0;54,98;11,53
1772;"Femø";"no";0;0;0;54,98;11,53
1773;"Femø";"no";0;0;0;54,98;11,53
1774;"Femø";"no";0;0;0;54,98;11,53
1775;"Femø";"no";0;0;0;54,98;11,53
1776;"Femø";"no";0;0;0;54,98;11,53
1777;"Femø";"no";0;0;0;54,98;11,53
1778;"Femø";"no";0;0;0;54,98;11,53
1779;"Femø";"no";0;0;0;54,98;11,53
1780;"Femø";"no";0;0;0;54,98;11,53
1781;"Femø";"no";0;0;0;54,98;11,53
1782;"Femø";"no";0;0;0;54,98;11,53
1783;"Femø";"no";0;0;0;54,98;11,53
1784;"Femø";"no";0;0;0;54,98;11,53
1785;"Femø";"no";0;0;0;54,98;11,53
1786;"Femø";"no";0;0;0;54,98;11,53
1787;"Femø";"no";0;0;0;54,98;11,53
1788;"Femø";"no";0;0;0;54,98;11,53
1789;"Femø";"no";0;0;0;54,98;11,53
1790;"Femø";"no";0;0;0;54,98;11,53
1791;"Femø";"no";0;0;0;54,98;11,53
1792;"Femø";"no";0;0;0;54,98;11,53
1793;"Femø";"no";0;0;0;54,98;11,53
1794;"Femø";"no";0;0;0;54,98;11,53
1795;"Femø";"no";0;0;0;54,98;11,53
1796;"Femø";"no";0;0;0;54,98;11,53
1797;"Femø";"no";0;0;0;54,98;11,53
1798;"Femø";"no";0;0;0;54,98;11,53
1799;"Femø";"no";0;0;0;54,98;11,53
1800;"Femø";"no";0;0;0;54,98;11,53
1801;"Femø";"no";0;0;0;54,98;11,53
1802;"Femø";"no";0;0;0;54,98;11,53
1803;"Femø";"no";0;0;0;54,98;11,53
1804;"Femø";"no";0;0;0;54,98;11,53
1805;"Femø";"no";0;0;0;54,98;11,53
1806;"Femø";"no";0;0;0;54,98;11,53
1807;"Femø";"no";0;0;0;54,98;11,53
1808;"Femø";"no";0;0;0;54,98;11,53
1809;"Femø";"no";0;0;0;54,98;11,53
1810;"Femø";"no";0;0;0;54,98;11,53
1811;"Femø";"no";0;0;0;54,98;11,53
1812;"Femø";"no";0;0;0;54,98;11,53
1813;"Femø";"no";0;0;0;54,98;11,53
1814;"Femø";"no";0;0;0;54,98;11,53
1815;"Femø";"no";0;0;0;54,98;11,53
1816;"Femø";"no";0;0;0;54,98;11,53
1817;"Femø";"no";0;0;0;54,98;11,53
1818;"Femø";"no";0;0;0;54,98;11,53
1819;"Femø";"no";0;0;0;54,98;11,53
1820;"Femø";"no";0;0;0;54,98;11,53
1821;"Femø";"no";0;0;0;54,98;11,53
1822;"Femø";"no";0;0;0;54,98;11,53
1823;"Femø";"no";0;0;0;54,98;11,53
1824;"Femø";"no";0;0;0;54,98;11,53
1825;"Femø";"no";0;0;0;54,98;11,53
1826;"Femø";"no";0;0;0;54,98;11,53
1827;"Femø";"no";0;0;0;54,98;11,53
1828;"Femø";"no";0;0;0;54,98;11,53
1829;"Femø";"no";0;0;0;54,98;11,53
1830;"Femø";"no";0;0;0;54,98;11,53
1831;"Femø";"no";0;0;0;54,98;11,53
1832;"Femø";"no";0;0;0;54,98;11,53
1833;"Femø";"no";0;0;0;54,98;11,53
1834;"Femø";"no";0;0;0;54,98;11,53
1835;"Femø";"no";0;0;0;54,98;11,53
1836;"Femø";"no";0;0;0;54,98;11,53
1837;"Femø";"no";0;0;0;54,98;11,53
1838;"Femø";"no";0;0;0;54,98;11,53
1839;"Femø";"no";0;0;0;54,98;11,53
1840;"Femø";"no";0;0;0;54,98;11,53
1841;"Femø";"no";0;0;0;54,98;11,53
1842;"Femø";"no";0;0;0;54,98;11,53
1843;"Femø";"no";0;0;0;54,98;11,53
1844;"Femø";"no";0;0;0;54,98;11,53
1845;"Femø";"no";0;0;0;54,98;11,53
1846;"Femø";"no";0;0;0;54,98;11,53
1847;"Femø";"no";0;0;0;54,98;11,53
1848;"Femø";"no";0;0;0;54,98;11,53
1849;"Femø";"no";0;0;0;54,98;11,53
1850;"Femø";"no";0;0;0;54,98;11,53
1851;"Femø";"no";0;0;0;54,98;11,53
1852;"Femø";"no";0;0;0;54,98;11,53
1853;"Femø";"no";0;0;0;54,98;11,53
1854;"Femø";"no";0;0;0;54,98;11,53
1855;"Femø";"no";0;0;0;54,98;11,53
1856;"Femø";"no";0;0;0;54,98;11,53
1857;"Femø";"no";0;0;0;54,98;11,53
1634;"Koningsdal";"no";0;0;0;56,684027;10,026117
1635;"Koningsdal";"no";0;0;0;56,684027;10,026117
1636;"Koningsdal";"no";0;0;0;56,684027;10,026117
1637;"Koningsdal";"no";0;0;0;56,684027;10,026117
1638;"Koningsdal";"no";0;0;0;56,684027;10,026117
1639;"Koningsdal";"no";0;0;0;56,684027;10,026117
1640;"Koningsdal";"no";0;0;0;56,684027;10,026117
1641;"Koningsdal";"no";0;0;0;56,684027;10,026117
1642;"Koningsdal";"no";1;0;1;56,684027;10,026117
1643;"Koningsdal";"no";1;0;1;56,684027;10,026117
1644;"Koningsdal";"no";0;0;0;56,684027;10,026117
1645;"Koningsdal";"no";0;0;0;56,684027;10,026117
1646;"Koningsdal";"no";0;0;0;56,684027;10,026117
1647;"Koningsdal";"no";0;0;0;56,684027;10,026117
1648;"Koningsdal";"no";0;0;0;56,684027;10,026117
1649;"Koningsdal";"no";0;0;0;56,684027;10,026117
1650;"Koningsdal";"no";0;0;0;56,684027;10,026117
1651;"Koningsdal";"no";0;0;0;56,684027;10,026117
1652;"Koningsdal";"no";0;0;0;56,684027;10,026117
1653;"Koningsdal";"no";0;0;0;56,684027;10,026117
1654;"Koningsdal";"no";0;0;0;56,684027;10,026117
1655;"Koningsdal";"no";0;0;0;56,684027;10,026117
1656;"Koningsdal";"no";0;0;0;56,684027;10,026117
1657;"Koningsdal";"no";0;0;0;56,684027;10,026117
1658;"Koningsdal";"no";0;0;0;56,684027;10,026117
1659;"Koningsdal";"no";0;0;0;56,684027;10,026117
1660;"Koningsdal";"no";0;0;0;56,684027;10,026117
1661;"Koningsdal";"no";0;0;0;56,684027;10,026117
1662;"Koningsdal";"no";0;0;0;56,684027;10,026117
1663;"Koningsdal";"no";0;0;0;56,684027;10,026117
1664;"Koningsdal";"no";0;0;0;56,684027;10,026117
1665;"Koningsdal";"no";0;0;0;56,684027;10,026117
1666;"Koningsdal";"no";0;0;0;56,684027;10,026117
1667;"Koningsdal";"no";0;0;0;56,684027;10,026117
1668;"Koningsdal";"no";0;0;0;56,684027;10,026117
1669;"Koningsdal";"no";0;0;0;56,684027;10,026117
1670;"Koningsdal";"no";0;0;0;56,684027;10,026117
1671;"Koningsdal";"no";0;0;0;56,684027;10,026117
1672;"Koningsdal";"no";0;0;0;56,684027;10,026117
1673;"Koningsdal";"no";0;0;0;56,684027;10,026117
1674;"Koningsdal";"no";0;0;0;56,684027;10,026117
1675;"Koningsdal";"no";0;0;0;56,684027;10,026117
1676;"Koningsdal";"no";0;0;0;56,684027;10,026117
1677;"Koningsdal";"no";0;0;0;56,684027;10,026117
1678;"Koningsdal";"no";0;0;0;56,684027;10,026117
1679;"Koningsdal";"no";0;0;0;56,684027;10,026117
1680;"Koningsdal";"no";0;0;0;56,684027;10,026117
1681;"Koningsdal";"no";0;0;0;56,684027;10,026117
1682;"Koningsdal";"no";0;0;0;56,684027;10,026117
1683;"Koningsdal";"no";0;0;0;56,684027;10,026117
1684;"Koningsdal";"no";0;0;0;56,684027;10,026117
1685;"Koningsdal";"no";0;0;0;56,684027;10,026117
1686;"Koningsdal";"no";0;0;0;56,684027;10,026117
1687;"Koningsdal";"no";0;0;0;56,684027;10,026117
1688;"Koningsdal";"no";0;0;0;56,684027;10,026117
1689;"Koningsdal";"no";0;0;0;56,684027;10,026117
1690;"Koningsdal";"no";0;0;0;56,684027;10,026117
1691;"Koningsdal";"no";0;0;0;56,684027;10,026117
1692;"Koningsdal";"no";0;0;0;56,684027;10,026117
1693;"Koningsdal";"no";1;0;1;56,684027;10,026117
1694;"Koningsdal";"no";0;0;0;56,684027;10,026117
1695;"Koningsdal";"no";0;0;0;56,684027;10,026117
1696;"Koningsdal";"no";0;0;0;56,684027;10,026117
1697;"Koningsdal";"no";0;0;0;56,684027;10,026117
1698;"Koningsdal";"no";0;0;0;56,684027;10,026117
1699;"Koningsdal";"no";0;0;0;56,684027;10,026117
1700;"Koningsdal";"no";0;0;0;56,684027;10,026117
1701;"Koningsdal";"no";0;0;0;56,684027;10,026117
1702;"Koningsdal";"no";0;0;0;56,684027;10,026117
1703;"Koningsdal";"no";0;0;0;56,684027;10,026117
1704;"Koningsdal";"no";0;0;0;56,684027;10,026117
1705;"Koningsdal";"no";0;0;0;56,684027;10,026117
1706;"Koningsdal";"no";0;0;0;56,684027;10,026117
1707;"Koningsdal";"no";0;0;0;56,684027;10,026117
1708;"Koningsdal";"no";0;0;0;56,684027;10,026117
1709;"Koningsdal";"no";0;0;0;56,684027;10,026117
1710;"Koningsdal";"no";0;0;0;56,684027;10,026117
1711;"Koningsdal";"no";0;0;0;56,684027;10,026117
1712;"Koningsdal";"no";0;0;0;56,684027;10,026117
1713;"Koningsdal";"no";0;0;0;56,684027;10,026117
1714;"Koningsdal";"no";0;0;0;56,684027;10,026117
1715;"Koningsdal";"no";0;0;0;56,684027;10,026117
1716;"Koningsdal";"no";0;0;0;56,684027;10,026117
1717;"Koningsdal";"no";0;0;0;56,684027;10,026117
1718;"Koningsdal";"no";0;0;0;56,684027;10,026117
1719;"Koningsdal";"no";0;0;0;56,684027;10,026117
1720;"Koningsdal";"no";0;0;0;56,684027;10,026117
1721;"Koningsdal";"no";0;0;0;56,684027;10,026117
1722;"Koningsdal";"no";0;0;0;56,684027;10,026117
1723;"Koningsdal";"no";0;0;0;56,684027;10,026117
1724;"Koningsdal";"no";0;0;0;56,684027;10,026117
1725;"Koningsdal";"no";0;0;0;56,684027;10,026117
1726;"Koningsdal";"no";0;0;0;56,684027;10,026117
1727;"Koningsdal";"no";0;0;0;56,684027;10,026117
1728;"Koningsdal";"no";0;0;0;56,684027;10,026117
1729;"Koningsdal";"no";0;0;0;56,684027;10,026117
1730;"Koningsdal";"no";0;0;0;56,684027;10,026117
1731;"Koningsdal";"no";0;0;0;56,684027;10,026117
1732;"Koningsdal";"no";0;0;0;56,684027;10,026117
1733;"Koningsdal";"no";0;0;0;56,684027;10,026117
1734;"Koningsdal";"no";0;0;0;56,684027;10,026117
1735;"Koningsdal";"no";0;0;0;56,684027;10,026117
1736;"Koningsdal";"no";0;0;0;56,684027;10,026117
1737;"Koningsdal";"no";0;0;0;56,684027;10,026117
1738;"Koningsdal";"no";0;0;0;56,684027;10,026117
1739;"Koningsdal";"no";0;0;0;56,684027;10,026117
1740;"Koningsdal";"no";0;0;0;56,684027;10,026117
1741;"Koningsdal";"no";0;0;0;56,684027;10,026117
1742;"Koningsdal";"no";0;0;0;56,684027;10,026117
1743;"Koningsdal";"no";0;0;0;56,684027;10,026117
1744;"Koningsdal";"no";0;0;0;56,684027;10,026117
1745;"Koningsdal";"no";0;0;0;56,684027;10,026117
1746;"Koningsdal";"no";0;0;0;56,684027;10,026117
1747;"Koningsdal";"no";0;0;0;56,684027;10,026117
1748;"Koningsdal";"no";0;0;0;56,684027;10,026117
1749;"Koningsdal";"no";0;0;0;56,684027;10,026117
1750;"Koningsdal";"no";0;0;0;56,684027;10,026117
1751;"Koningsdal";"no";0;0;0;56,684027;10,026117
1752;"Koningsdal";"no";0;0;0;56,684027;10,026117
1753;"Koningsdal";"no";0;0;0;56,684027;10,026117
1754;"Koningsdal";"no";0;0;0;56,684027;10,026117
1755;"Koningsdal";"no";0;0;0;56,684027;10,026117
1756;"Koningsdal";"no";0;0;0;56,684027;10,026117
1757;"Koningsdal";"no";0;0;0;56,684027;10,026117
1758;"Koningsdal";"no";0;0;0;56,684027;10,026117
1759;"Koningsdal";"no";0;0;0;56,684027;10,026117
1760;"Koningsdal";"no";0;0;0;56,684027;10,026117
1761;"Koningsdal";"no";0;0;0;56,684027;10,026117
1762;"Koningsdal";"no";0;0;0;56,684027;10,026117
1763;"Koningsdal";"no";0;0;0;56,684027;10,026117
1764;"Koningsdal";"no";0;0;0;56,684027;10,026117
1765;"Koningsdal";"no";0;0;0;56,684027;10,026117
1766;"Koningsdal";"no";0;0;0;56,684027;10,026117
1767;"Koningsdal";"no";0;0;0;56,684027;10,026117
1768;"Koningsdal";"no";0;0;0;56,684027;10,026117
1769;"Koningsdal";"no";0;0;0;56,684027;10,026117
1770;"Koningsdal";"no";0;0;0;56,684027;10,026117
1771;"Koningsdal";"no";0;0;0;56,684027;10,026117
1772;"Koningsdal";"no";0;0;0;56,684027;10,026117
1773;"Koningsdal";"no";0;0;0;56,684027;10,026117
1774;"Koningsdal";"no";0;0;0;56,684027;10,026117
1775;"Koningsdal";"no";0;0;0;56,684027;10,026117
1776;"Koningsdal";"no";0;0;0;56,684027;10,026117
1777;"Koningsdal";"no";0;0;0;56,684027;10,026117
1778;"Koningsdal";"no";0;0;0;56,684027;10,026117
1779;"Koningsdal";"no";0;0;0;56,684027;10,026117
1780;"Koningsdal";"no";0;0;0;56,684027;10,026117
1781;"Koningsdal";"no";0;0;0;56,684027;10,026117
1782;"Koningsdal";"no";0;0;0;56,684027;10,026117
1783;"Koningsdal";"no";0;0;0;56,684027;10,026117
1784;"Koningsdal";"no";0;0;0;56,684027;10,026117
1785;"Koningsdal";"no";0;0;0;56,684027;10,026117
1786;"Koningsdal";"no";0;0;0;56,684027;10,026117
1787;"Koningsdal";"no";0;0;0;56,684027;10,026117
1788;"Koningsdal";"no";0;0;0;56,684027;10,026117
1789;"Koningsdal";"no";0;0;0;56,684027;10,026117
1790;"Koningsdal";"no";0;0;0;56,684027;10,026117
1791;"Koningsdal";"no";0;0;0;56,684027;10,026117
1792;"Koningsdal";"no";0;0;0;56,684027;10,026117
1793;"Koningsdal";"no";0;0;0;56,684027;10,026117
1794;"Koningsdal";"no";0;0;0;56,684027;10,026117
1795;"Koningsdal";"no";0;0;0;56,684027;10,026117
1796;"Koningsdal";"no";0;0;0;56,684027;10,026117
1797;"Koningsdal";"no";0;0;0;56,684027;10,026117
1798;"Koningsdal";"no";0;0;0;56,684027;10,026117
1799;"Koningsdal";"no";0;0;0;56,684027;10,026117
1800;"Koningsdal";"no";0;0;0;56,684027;10,026117
1801;"Koningsdal";"no";0;0;0;56,684027;10,026117
1802;"Koningsdal";"no";0;0;0;56,684027;10,026117
1803;"Koningsdal";"no";0;0;0;56,684027;10,026117
1804;"Koningsdal";"no";0;0;0;56,684027;10,026117
1805;"Koningsdal";"no";0;0;0;56,684027;10,026117
1806;"Koningsdal";"no";0;0;0;56,684027;10,026117
1807;"Koningsdal";"no";0;0;0;56,684027;10,026117
1808;"Koningsdal";"no";0;0;0;56,684027;10,026117
1809;"Koningsdal";"no";0;0;0;56,684027;10,026117
1810;"Koningsdal";"no";0;0;0;56,684027;10,026117
1811;"Koningsdal";"no";0;0;0;56,684027;10,026117
1812;"Koningsdal";"no";0;0;0;56,684027;10,026117
1813;"Koningsdal";"no";0;0;0;56,684027;10,026117
1814;"Koningsdal";"no";0;0;0;56,684027;10,026117
1815;"Koningsdal";"no";0;0;0;56,684027;10,026117
1816;"Koningsdal";"no";0;0;0;56,684027;10,026117
1817;"Koningsdal";"no";0;0;0;56,684027;10,026117
1818;"Koningsdal";"no";0;0;0;56,684027;10,026117
1819;"Koningsdal";"no";0;0;0;56,684027;10,026117
1820;"Koningsdal";"no";0;0;0;56,684027;10,026117
1821;"Koningsdal";"no";0;0;0;56,684027;10,026117
1822;"Koningsdal";"no";0;0;0;56,684027;10,026117
1823;"Koningsdal";"no";0;0;0;56,684027;10,026117
1824;"Koningsdal";"no";0;0;0;56,684027;10,026117
1825;"Koningsdal";"no";0;0;0;56,684027;10,026117
1826;"Koningsdal";"no";0;0;0;56,684027;10,026117
1827;"Koningsdal";"no";0;0;0;56,684027;10,026117
1828;"Koningsdal";"no";0;0;0;56,684027;10,026117
1829;"Koningsdal";"no";0;0;0;56,684027;10,026117
1830;"Koningsdal";"no";0;0;0;56,684027;10,026117
1831;"Koningsdal";"no";0;0;0;56,684027;10,026117
1832;"Koningsdal";"no";0;0;0;56,684027;10,026117
1833;"Koningsdal";"no";0;0;0;56,684027;10,026117
1834;"Koningsdal";"no";0;0;0;56,684027;10,026117
1835;"Koningsdal";"no";0;0;0;56,684027;10,026117
1836;"Koningsdal";"no";0;0;0;56,684027;10,026117
1837;"Koningsdal";"no";0;0;0;56,684027;10,026117
1838;"Koningsdal";"no";0;0;0;56,684027;10,026117
1839;"Koningsdal";"no";0;0;0;56,684027;10,026117
1840;"Koningsdal";"no";0;0;0;56,684027;10,026117
1841;"Koningsdal";"no";0;0;0;56,684027;10,026117
1842;"Koningsdal";"no";0;0;0;56,684027;10,026117
1843;"Koningsdal";"no";0;0;0;56,684027;10,026117
1844;"Koningsdal";"no";0;0;0;56,684027;10,026117
1845;"Koningsdal";"no";0;0;0;56,684027;10,026117
1846;"Koningsdal";"no";0;0;0;56,684027;10,026117
1847;"Koningsdal";"no";0;0;0;56,684027;10,026117
1848;"Koningsdal";"no";0;0;0;56,684027;10,026117
1849;"Koningsdal";"no";0;0;0;56,684027;10,026117
1850;"Koningsdal";"no";0;0;0;56,684027;10,026117
1851;"Koningsdal";"no";0;0;0;56,684027;10,026117
1852;"Koningsdal";"no";0;0;0;56,684027;10,026117
1853;"Koningsdal";"no";0;0;0;56,684027;10,026117
1854;"Koningsdal";"no";0;0;0;56,684027;10,026117
1855;"Koningsdal";"no";0;0;0;56,684027;10,026117
1856;"Koningsdal";"no";0;0;0;56,684027;10,026117
1857;"Koningsdal";"no";0;0;0;56,684027;10,026117
1634;"Middelfart";"no";0;0;0;55,505833;9,730277
1635;"Middelfart";"no";0;0;0;55,505833;9,730277
1636;"Middelfart";"no";0;0;0;55,505833;9,730277
1637;"Middelfart";"no";0;0;0;55,505833;9,730277
1638;"Middelfart";"no";0;0;0;55,505833;9,730277
1639;"Middelfart";"no";0;0;0;55,505833;9,730277
1640;"Middelfart";"no";0;0;0;55,505833;9,730277
1641;"Middelfart";"no";0;0;0;55,505833;9,730277
1642;"Middelfart";"no";0;0;0;55,505833;9,730277
1643;"Middelfart";"no";1;0;1;55,505833;9,730277
1644;"Middelfart";"no";0;1;1;55,505833;9,730277
1645;"Middelfart";"no";0;0;0;55,505833;9,730277
1646;"Middelfart";"no";0;0;0;55,505833;9,730277
1647;"Middelfart";"no";0;0;0;55,505833;9,730277
1648;"Middelfart";"no";0;0;0;55,505833;9,730277
1649;"Middelfart";"no";0;0;0;55,505833;9,730277
1650;"Middelfart";"no";0;0;0;55,505833;9,730277
1651;"Middelfart";"no";0;0;0;55,505833;9,730277
1652;"Middelfart";"no";0;0;0;55,505833;9,730277
1653;"Middelfart";"no";0;0;0;55,505833;9,730277
1654;"Middelfart";"no";0;0;0;55,505833;9,730277
1655;"Middelfart";"no";0;0;0;55,505833;9,730277
1656;"Middelfart";"no";0;0;0;55,505833;9,730277
1657;"Middelfart";"no";0;0;0;55,505833;9,730277
1658;"Middelfart";"no";0;0;0;55,505833;9,730277
1659;"Middelfart";"no";0;0;0;55,505833;9,730277
1660;"Middelfart";"no";0;0;0;55,505833;9,730277
1661;"Middelfart";"no";0;0;0;55,505833;9,730277
1662;"Middelfart";"no";0;0;0;55,505833;9,730277
1663;"Middelfart";"no";0;0;0;55,505833;9,730277
1664;"Middelfart";"no";0;0;0;55,505833;9,730277
1665;"Middelfart";"no";0;0;0;55,505833;9,730277
1666;"Middelfart";"no";0;0;0;55,505833;9,730277
1667;"Middelfart";"no";0;0;0;55,505833;9,730277
1668;"Middelfart";"no";0;0;0;55,505833;9,730277
1669;"Middelfart";"no";0;0;0;55,505833;9,730277
1670;"Middelfart";"no";0;0;0;55,505833;9,730277
1671;"Middelfart";"no";0;0;0;55,505833;9,730277
1672;"Middelfart";"no";0;0;0;55,505833;9,730277
1673;"Middelfart";"no";0;0;0;55,505833;9,730277
1674;"Middelfart";"no";0;0;0;55,505833;9,730277
1675;"Middelfart";"no";0;0;0;55,505833;9,730277
1676;"Middelfart";"no";0;0;0;55,505833;9,730277
1677;"Middelfart";"no";0;0;0;55,505833;9,730277
1678;"Middelfart";"no";0;0;0;55,505833;9,730277
1679;"Middelfart";"no";0;0;0;55,505833;9,730277
1680;"Middelfart";"no";0;0;0;55,505833;9,730277
1681;"Middelfart";"no";1;0;1;55,505833;9,730277
1682;"Middelfart";"no";0;0;0;55,505833;9,730277
1683;"Middelfart";"no";0;0;0;55,505833;9,730277
1684;"Middelfart";"no";0;0;0;55,505833;9,730277
1685;"Middelfart";"no";0;0;0;55,505833;9,730277
1686;"Middelfart";"no";0;0;0;55,505833;9,730277
1687;"Middelfart";"no";0;0;0;55,505833;9,730277
1688;"Middelfart";"no";0;0;0;55,505833;9,730277
1689;"Middelfart";"no";0;0;0;55,505833;9,730277
1690;"Middelfart";"no";0;0;0;55,505833;9,730277
1691;"Middelfart";"no";0;0;0;55,505833;9,730277
1692;"Middelfart";"no";0;0;0;55,505833;9,730277
1693;"Middelfart";"no";0;1;1;55,505833;9,730277
1694;"Middelfart";"no";0;0;0;55,505833;9,730277
1695;"Middelfart";"no";0;0;0;55,505833;9,730277
1696;"Middelfart";"no";0;0;0;55,505833;9,730277
1697;"Middelfart";"no";0;0;0;55,505833;9,730277
1698;"Middelfart";"no";0;0;0;55,505833;9,730277
1699;"Middelfart";"no";0;0;0;55,505833;9,730277
1700;"Middelfart";"no";0;0;0;55,505833;9,730277
1701;"Middelfart";"no";0;0;0;55,505833;9,730277
1702;"Middelfart";"no";0;0;0;55,505833;9,730277
1703;"Middelfart";"no";0;0;0;55,505833;9,730277
1704;"Middelfart";"no";0;0;0;55,505833;9,730277
1705;"Middelfart";"no";0;0;0;55,505833;9,730277
1706;"Middelfart";"no";0;0;0;55,505833;9,730277
1707;"Middelfart";"no";0;0;0;55,505833;9,730277
1708;"Middelfart";"no";0;0;0;55,505833;9,730277
1709;"Middelfart";"no";0;0;0;55,505833;9,730277
1710;"Middelfart";"no";0;0;0;55,505833;9,730277
1711;"Middelfart";"no";0;0;0;55,505833;9,730277
1712;"Middelfart";"no";0;0;0;55,505833;9,730277
1713;"Middelfart";"no";0;0;0;55,505833;9,730277
1714;"Middelfart";"no";0;0;0;55,505833;9,730277
1715;"Middelfart";"no";0;0;0;55,505833;9,730277
1716;"Middelfart";"no";0;0;0;55,505833;9,730277
1717;"Middelfart";"no";0;0;0;55,505833;9,730277
1718;"Middelfart";"no";0;0;0;55,505833;9,730277
1719;"Middelfart";"no";0;0;0;55,505833;9,730277
1720;"Middelfart";"no";0;0;0;55,505833;9,730277
1721;"Middelfart";"no";0;0;0;55,505833;9,730277
1722;"Middelfart";"no";0;0;0;55,505833;9,730277
1723;"Middelfart";"no";0;0;0;55,505833;9,730277
1724;"Middelfart";"no";0;0;0;55,505833;9,730277
1725;"Middelfart";"no";0;0;0;55,505833;9,730277
1726;"Middelfart";"no";0;0;0;55,505833;9,730277
1727;"Middelfart";"no";0;0;0;55,505833;9,730277
1728;"Middelfart";"no";0;1;1;55,505833;9,730277
1729;"Middelfart";"no";0;0;0;55,505833;9,730277
1730;"Middelfart";"no";0;0;0;55,505833;9,730277
1731;"Middelfart";"no";0;0;0;55,505833;9,730277
1732;"Middelfart";"no";0;0;0;55,505833;9,730277
1733;"Middelfart";"no";0;0;0;55,505833;9,730277
1734;"Middelfart";"no";0;0;0;55,505833;9,730277
1735;"Middelfart";"no";0;0;0;55,505833;9,730277
1736;"Middelfart";"no";0;0;0;55,505833;9,730277
1737;"Middelfart";"no";0;0;0;55,505833;9,730277
1738;"Middelfart";"no";0;0;0;55,505833;9,730277
1739;"Middelfart";"no";0;0;0;55,505833;9,730277
1740;"Middelfart";"no";0;0;0;55,505833;9,730277
1741;"Middelfart";"no";0;0;0;55,505833;9,730277
1742;"Middelfart";"no";0;0;0;55,505833;9,730277
1743;"Middelfart";"no";0;0;0;55,505833;9,730277
1744;"Middelfart";"no";0;0;0;55,505833;9,730277
1745;"Middelfart";"no";0;0;0;55,505833;9,730277
1746;"Middelfart";"no";0;0;0;55,505833;9,730277
1747;"Middelfart";"no";0;0;0;55,505833;9,730277
1748;"Middelfart";"no";0;0;0;55,505833;9,730277
1749;"Middelfart";"no";0;0;0;55,505833;9,730277
1750;"Middelfart";"no";0;0;0;55,505833;9,730277
1751;"Middelfart";"no";0;0;0;55,505833;9,730277
1752;"Middelfart";"no";0;0;0;55,505833;9,730277
1753;"Middelfart";"no";0;0;0;55,505833;9,730277
1754;"Middelfart";"no";0;0;0;55,505833;9,730277
1755;"Middelfart";"no";0;0;0;55,505833;9,730277
1756;"Middelfart";"no";0;0;0;55,505833;9,730277
1757;"Middelfart";"no";0;0;0;55,505833;9,730277
1758;"Middelfart";"no";0;0;0;55,505833;9,730277
1759;"Middelfart";"no";0;0;0;55,505833;9,730277
1760;"Middelfart";"no";0;0;0;55,505833;9,730277
1761;"Middelfart";"no";0;0;0;55,505833;9,730277
1762;"Middelfart";"no";0;0;0;55,505833;9,730277
1763;"Middelfart";"no";0;0;0;55,505833;9,730277
1764;"Middelfart";"no";0;0;0;55,505833;9,730277
1765;"Middelfart";"no";0;0;0;55,505833;9,730277
1766;"Middelfart";"no";0;0;0;55,505833;9,730277
1767;"Middelfart";"no";0;0;0;55,505833;9,730277
1768;"Middelfart";"no";0;0;0;55,505833;9,730277
1769;"Middelfart";"no";0;3;3;55,505833;9,730277
1770;"Middelfart";"no";0;0;0;55,505833;9,730277
1771;"Middelfart";"no";0;0;0;55,505833;9,730277
1772;"Middelfart";"no";0;0;0;55,505833;9,730277
1773;"Middelfart";"no";0;0;0;55,505833;9,730277
1774;"Middelfart";"no";0;0;0;55,505833;9,730277
1775;"Middelfart";"no";0;0;0;55,505833;9,730277
1776;"Middelfart";"no";0;0;0;55,505833;9,730277
1777;"Middelfart";"no";0;0;0;55,505833;9,730277
1778;"Middelfart";"no";0;0;0;55,505833;9,730277
1779;"Middelfart";"no";0;0;0;55,505833;9,730277
1780;"Middelfart";"no";0;0;0;55,505833;9,730277
1781;"Middelfart";"no";0;0;0;55,505833;9,730277
1782;"Middelfart";"no";0;0;0;55,505833;9,730277
1783;"Middelfart";"no";0;0;0;55,505833;9,730277
1784;"Middelfart";"no";0;0;0;55,505833;9,730277
1785;"Middelfart";"no";0;0;0;55,505833;9,730277
1786;"Middelfart";"no";0;0;0;55,505833;9,730277
1787;"Middelfart";"no";1;0;1;55,505833;9,730277
1788;"Middelfart";"no";0;0;0;55,505833;9,730277
1789;"Middelfart";"no";0;0;0;55,505833;9,730277
1790;"Middelfart";"no";0;0;0;55,505833;9,730277
1791;"Middelfart";"no";0;0;0;55,505833;9,730277
1792;"Middelfart";"no";0;0;0;55,505833;9,730277
1793;"Middelfart";"no";0;0;0;55,505833;9,730277
1794;"Middelfart";"no";0;0;0;55,505833;9,730277
1795;"Middelfart";"no";0;0;0;55,505833;9,730277
1796;"Middelfart";"no";0;0;0;55,505833;9,730277
1797;"Middelfart";"no";0;0;0;55,505833;9,730277
1798;"Middelfart";"no";0;0;0;55,505833;9,730277
1799;"Middelfart";"no";0;0;0;55,505833;9,730277
1800;"Middelfart";"no";0;0;0;55,505833;9,730277
1801;"Middelfart";"no";0;0;0;55,505833;9,730277
1802;"Middelfart";"no";0;0;0;55,505833;9,730277
1803;"Middelfart";"no";0;0;0;55,505833;9,730277
1804;"Middelfart";"no";0;0;0;55,505833;9,730277
1805;"Middelfart";"no";0;0;0;55,505833;9,730277
1806;"Middelfart";"no";0;0;0;55,505833;9,730277
1807;"Middelfart";"no";0;0;0;55,505833;9,730277
1808;"Middelfart";"no";0;0;0;55,505833;9,730277
1809;"Middelfart";"no";0;0;0;55,505833;9,730277
1810;"Middelfart";"no";0;0;0;55,505833;9,730277
1811;"Middelfart";"no";0;0;0;55,505833;9,730277
1812;"Middelfart";"no";0;0;0;55,505833;9,730277
1813;"Middelfart";"no";0;0;0;55,505833;9,730277
1814;"Middelfart";"no";0;0;0;55,505833;9,730277
1815;"Middelfart";"no";0;0;0;55,505833;9,730277
1816;"Middelfart";"no";0;0;0;55,505833;9,730277
1817;"Middelfart";"no";0;0;0;55,505833;9,730277
1818;"Middelfart";"no";0;0;0;55,505833;9,730277
1819;"Middelfart";"no";0;0;0;55,505833;9,730277
1820;"Middelfart";"no";0;1;1;55,505833;9,730277
1821;"Middelfart";"no";0;0;0;55,505833;9,730277
1822;"Middelfart";"no";0;0;0;55,505833;9,730277
1823;"Middelfart";"no";0;0;0;55,505833;9,730277
1824;"Middelfart";"no";0;0;0;55,505833;9,730277
1825;"Middelfart";"no";0;0;0;55,505833;9,730277
1826;"Middelfart";"no";0;0;0;55,505833;9,730277
1827;"Middelfart";"no";0;0;0;55,505833;9,730277
1828;"Middelfart";"no";0;0;0;55,505833;9,730277
1829;"Middelfart";"no";0;0;0;55,505833;9,730277
1830;"Middelfart";"no";0;0;0;55,505833;9,730277
1831;"Middelfart";"no";0;0;0;55,505833;9,730277
1832;"Middelfart";"no";0;0;0;55,505833;9,730277
1833;"Middelfart";"no";0;0;0;55,505833;9,730277
1834;"Middelfart";"no";0;2;2;55,505833;9,730277
1835;"Middelfart";"no";0;0;0;55,505833;9,730277
1836;"Middelfart";"no";0;0;0;55,505833;9,730277
1837;"Middelfart";"no";0;0;0;55,505833;9,730277
1838;"Middelfart";"no";0;0;0;55,505833;9,730277
1839;"Middelfart";"no";0;0;0;55,505833;9,730277
1840;"Middelfart";"no";0;0;0;55,505833;9,730277
1841;"Middelfart";"no";0;0;0;55,505833;9,730277
1842;"Middelfart";"no";0;1;1;55,505833;9,730277
1843;"Middelfart";"no";0;0;0;55,505833;9,730277
1844;"Middelfart";"no";1;2;3;55,505833;9,730277
1845;"Middelfart";"no";0;0;0;55,505833;9,730277
1846;"Middelfart";"no";0;0;0;55,505833;9,730277
1847;"Middelfart";"no";2;0;2;55,505833;9,730277
1848;"Middelfart";"no";0;1;1;55,505833;9,730277
1849;"Middelfart";"no";0;0;0;55,505833;9,730277
1850;"Middelfart";"no";0;0;0;55,505833;9,730277
1851;"Middelfart";"no";1;0;1;55,505833;9,730277
1852;"Middelfart";"no";0;0;0;55,505833;9,730277
1853;"Middelfart";"no";0;1;1;55,505833;9,730277
1854;"Middelfart";"no";1;0;1;55,505833;9,730277
1855;"Middelfart";"no";0;0;0;55,505833;9,730277
1856;"Middelfart";"no";0;0;0;55,505833;9,730277
1857;"Middelfart";"no";0;0;0;55,505833;9,730277
1634;"Rudkøbing";"no";0;0;0;54,936388;10,71
1635;"Rudkøbing";"no";0;0;0;54,936388;10,71
1636;"Rudkøbing";"no";0;0;0;54,936388;10,71
1637;"Rudkøbing";"no";0;0;0;54,936388;10,71
1638;"Rudkøbing";"no";0;0;0;54,936388;10,71
1639;"Rudkøbing";"no";0;0;0;54,936388;10,71
1640;"Rudkøbing";"no";0;0;0;54,936388;10,71
1641;"Rudkøbing";"no";0;0;0;54,936388;10,71
1642;"Rudkøbing";"no";0;0;0;54,936388;10,71
1643;"Rudkøbing";"no";1;0;1;54,936388;10,71
1644;"Rudkøbing";"no";0;0;0;54,936388;10,71
1645;"Rudkøbing";"no";0;0;0;54,936388;10,71
1646;"Rudkøbing";"no";0;0;0;54,936388;10,71
1647;"Rudkøbing";"no";0;0;0;54,936388;10,71
1648;"Rudkøbing";"no";1;0;1;54,936388;10,71
1649;"Rudkøbing";"no";0;0;0;54,936388;10,71
1650;"Rudkøbing";"no";0;0;0;54,936388;10,71
1651;"Rudkøbing";"no";0;0;0;54,936388;10,71
1652;"Rudkøbing";"no";0;0;0;54,936388;10,71
1653;"Rudkøbing";"no";0;0;0;54,936388;10,71
1654;"Rudkøbing";"no";0;0;0;54,936388;10,71
1655;"Rudkøbing";"no";0;0;0;54,936388;10,71
1656;"Rudkøbing";"no";0;0;0;54,936388;10,71
1657;"Rudkøbing";"no";0;0;0;54,936388;10,71
1658;"Rudkøbing";"no";0;0;0;54,936388;10,71
1659;"Rudkøbing";"no";0;0;0;54,936388;10,71
1660;"Rudkøbing";"no";0;0;0;54,936388;10,71
1661;"Rudkøbing";"no";0;0;0;54,936388;10,71
1662;"Rudkøbing";"no";0;0;0;54,936388;10,71
1663;"Rudkøbing";"no";0;0;0;54,936388;10,71
1664;"Rudkøbing";"no";0;0;0;54,936388;10,71
1665;"Rudkøbing";"no";0;0;0;54,936388;10,71
1666;"Rudkøbing";"no";0;0;0;54,936388;10,71
1667;"Rudkøbing";"no";0;0;0;54,936388;10,71
1668;"Rudkøbing";"no";0;0;0;54,936388;10,71
1669;"Rudkøbing";"no";0;0;0;54,936388;10,71
1670;"Rudkøbing";"no";0;0;0;54,936388;10,71
1671;"Rudkøbing";"no";0;0;0;54,936388;10,71
1672;"Rudkøbing";"no";0;0;0;54,936388;10,71
1673;"Rudkøbing";"no";0;0;0;54,936388;10,71
1674;"Rudkøbing";"no";0;0;0;54,936388;10,71
1675;"Rudkøbing";"no";0;0;0;54,936388;10,71
1676;"Rudkøbing";"no";0;0;0;54,936388;10,71
1677;"Rudkøbing";"no";0;0;0;54,936388;10,71
1678;"Rudkøbing";"no";0;0;0;54,936388;10,71
1679;"Rudkøbing";"no";1;0;1;54,936388;10,71
1680;"Rudkøbing";"no";0;0;0;54,936388;10,71
1681;"Rudkøbing";"no";0;0;0;54,936388;10,71
1682;"Rudkøbing";"no";0;0;0;54,936388;10,71
1683;"Rudkøbing";"no";0;0;0;54,936388;10,71
1684;"Rudkøbing";"no";0;0;0;54,936388;10,71
1685;"Rudkøbing";"no";0;0;0;54,936388;10,71
1686;"Rudkøbing";"no";0;0;0;54,936388;10,71
1687;"Rudkøbing";"no";0;0;0;54,936388;10,71
1688;"Rudkøbing";"no";0;0;0;54,936388;10,71
1689;"Rudkøbing";"no";0;0;0;54,936388;10,71
1690;"Rudkøbing";"no";0;0;0;54,936388;10,71
1691;"Rudkøbing";"no";0;0;0;54,936388;10,71
1692;"Rudkøbing";"no";0;0;0;54,936388;10,71
1693;"Rudkøbing";"no";0;0;0;54,936388;10,71
1694;"Rudkøbing";"no";0;0;0;54,936388;10,71
1695;"Rudkøbing";"no";0;0;0;54,936388;10,71
1696;"Rudkøbing";"no";0;0;0;54,936388;10,71
1697;"Rudkøbing";"no";0;0;0;54,936388;10,71
1698;"Rudkøbing";"no";0;0;0;54,936388;10,71
1699;"Rudkøbing";"no";0;0;0;54,936388;10,71
1700;"Rudkøbing";"no";0;0;0;54,936388;10,71
1701;"Rudkøbing";"no";0;0;0;54,936388;10,71
1702;"Rudkøbing";"no";0;0;0;54,936388;10,71
1703;"Rudkøbing";"no";0;0;0;54,936388;10,71
1704;"Rudkøbing";"no";0;0;0;54,936388;10,71
1705;"Rudkøbing";"no";0;0;0;54,936388;10,71
1706;"Rudkøbing";"no";0;2;2;54,936388;10,71
1707;"Rudkøbing";"no";0;0;0;54,936388;10,71
1708;"Rudkøbing";"no";0;0;0;54,936388;10,71
1709;"Rudkøbing";"no";0;0;0;54,936388;10,71
1710;"Rudkøbing";"no";7;0;7;54,936388;10,71
1711;"Rudkøbing";"no";0;0;0;54,936388;10,71
1712;"Rudkøbing";"no";0;0;0;54,936388;10,71
1713;"Rudkøbing";"no";0;0;0;54,936388;10,71
1714;"Rudkøbing";"no";0;0;0;54,936388;10,71
1715;"Rudkøbing";"no";0;0;0;54,936388;10,71
1716;"Rudkøbing";"no";0;0;0;54,936388;10,71
1717;"Rudkøbing";"no";2;0;2;54,936388;10,71
1718;"Rudkøbing";"no";0;0;0;54,936388;10,71
1719;"Rudkøbing";"no";0;0;0;54,936388;10,71
1720;"Rudkøbing";"no";0;0;0;54,936388;10,71
1721;"Rudkøbing";"no";0;0;0;54,936388;10,71
1722;"Rudkøbing";"no";0;0;0;54,936388;10,71
1723;"Rudkøbing";"no";0;1;1;54,936388;10,71
1724;"Rudkøbing";"no";0;1;1;54,936388;10,71
1725;"Rudkøbing";"no";0;0;0;54,936388;10,71
1726;"Rudkøbing";"no";0;0;0;54,936388;10,71
1727;"Rudkøbing";"no";0;0;0;54,936388;10,71
1728;"Rudkøbing";"no";0;0;0;54,936388;10,71
1729;"Rudkøbing";"no";0;1;1;54,936388;10,71
1730;"Rudkøbing";"no";0;0;0;54,936388;10,71
1731;"Rudkøbing";"no";0;0;0;54,936388;10,71
1732;"Rudkøbing";"no";0;0;0;54,936388;10,71
1733;"Rudkøbing";"no";0;0;0;54,936388;10,71
1734;"Rudkøbing";"no";0;1;1;54,936388;10,71
1735;"Rudkøbing";"no";0;0;0;54,936388;10,71
1736;"Rudkøbing";"no";0;0;0;54,936388;10,71
1737;"Rudkøbing";"no";0;0;0;54,936388;10,71
1738;"Rudkøbing";"no";0;0;0;54,936388;10,71
1739;"Rudkøbing";"no";0;0;0;54,936388;10,71
1740;"Rudkøbing";"no";0;3;3;54,936388;10,71
1741;"Rudkøbing";"no";0;2;2;54,936388;10,71
1742;"Rudkøbing";"no";0;0;0;54,936388;10,71
1743;"Rudkøbing";"no";0;1;1;54,936388;10,71
1744;"Rudkøbing";"no";0;0;0;54,936388;10,71
1745;"Rudkøbing";"no";0;0;0;54,936388;10,71
1746;"Rudkøbing";"no";0;1;1;54,936388;10,71
1747;"Rudkøbing";"no";0;0;0;54,936388;10,71
1748;"Rudkøbing";"no";0;1;1;54,936388;10,71
1749;"Rudkøbing";"no";0;0;0;54,936388;10,71
1750;"Rudkøbing";"no";0;1;1;54,936388;10,71
1751;"Rudkøbing";"no";0;0;0;54,936388;10,71
1752;"Rudkøbing";"no";0;0;0;54,936388;10,71
1753;"Rudkøbing";"no";0;0;0;54,936388;10,71
1754;"Rudkøbing";"no";0;1;1;54,936388;10,71
1755;"Rudkøbing";"no";0;0;0;54,936388;10,71
1756;"Rudkøbing";"no";0;1;1;54,936388;10,71
1757;"Rudkøbing";"no";0;0;0;54,936388;10,71
1758;"Rudkøbing";"no";0;0;0;54,936388;10,71
1759;"Rudkøbing";"no";0;0;0;54,936388;10,71
1760;"Rudkøbing";"no";0;0;0;54,936388;10,71
1761;"Rudkøbing";"no";0;0;0;54,936388;10,71
1762;"Rudkøbing";"no";0;0;0;54,936388;10,71
1763;"Rudkøbing";"no";0;0;0;54,936388;10,71
1764;"Rudkøbing";"no";0;0;0;54,936388;10,71
1765;"Rudkøbing";"no";0;0;0;54,936388;10,71
1766;"Rudkøbing";"no";0;0;0;54,936388;10,71
1767;"Rudkøbing";"no";1;0;1;54,936388;10,71
1768;"Rudkøbing";"no";0;0;0;54,936388;10,71
1769;"Rudkøbing";"no";0;0;0;54,936388;10,71
1770;"Rudkøbing";"no";0;0;0;54,936388;10,71
1771;"Rudkøbing";"no";0;0;0;54,936388;10,71
1772;"Rudkøbing";"no";0;0;0;54,936388;10,71
1773;"Rudkøbing";"no";0;1;1;54,936388;10,71
1774;"Rudkøbing";"no";0;1;1;54,936388;10,71
1775;"Rudkøbing";"no";1;0;1;54,936388;10,71
1776;"Rudkøbing";"no";1;0;1;54,936388;10,71
1777;"Rudkøbing";"no";0;1;1;54,936388;10,71
1778;"Rudkøbing";"no";0;0;0;54,936388;10,71
1779;"Rudkøbing";"no";0;0;0;54,936388;10,71
1780;"Rudkøbing";"no";0;1;1;54,936388;10,71
1781;"Rudkøbing";"no";1;1;2;54,936388;10,71
1782;"Rudkøbing";"no";0;0;0;54,936388;10,71
1783;"Rudkøbing";"no";0;0;0;54,936388;10,71
1784;"Rudkøbing";"no";1;0;1;54,936388;10,71
1785;"Rudkøbing";"no";0;0;0;54,936388;10,71
1786;"Rudkøbing";"no";0;6;6;54,936388;10,71
1787;"Rudkøbing";"no";1;1;2;54,936388;10,71
1788;"Rudkøbing";"no";0;1;1;54,936388;10,71
1789;"Rudkøbing";"no";2;0;2;54,936388;10,71
1790;"Rudkøbing";"no";0;0;0;54,936388;10,71
1791;"Rudkøbing";"no";1;1;2;54,936388;10,71
1792;"Rudkøbing";"no";0;0;0;54,936388;10,71
1793;"Rudkøbing";"no";0;0;0;54,936388;10,71
1794;"Rudkøbing";"no";0;1;1;54,936388;10,71
1795;"Rudkøbing";"no";1;1;2;54,936388;10,71
1796;"Rudkøbing";"no";0;0;0;54,936388;10,71
1797;"Rudkøbing";"no";0;0;0;54,936388;10,71
1798;"Rudkøbing";"no";0;0;0;54,936388;10,71
1799;"Rudkøbing";"no";0;0;0;54,936388;10,71
1800;"Rudkøbing";"no";1;1;2;54,936388;10,71
1801;"Rudkøbing";"no";4;0;4;54,936388;10,71
1802;"Rudkøbing";"no";2;0;2;54,936388;10,71
1803;"Rudkøbing";"no";0;0;0;54,936388;10,71
1804;"Rudkøbing";"no";0;0;0;54,936388;10,71
1805;"Rudkøbing";"no";0;0;0;54,936388;10,71
1806;"Rudkøbing";"no";0;0;0;54,936388;10,71
1807;"Rudkøbing";"no";0;0;0;54,936388;10,71
1808;"Rudkøbing";"no";0;0;0;54,936388;10,71
1809;"Rudkøbing";"no";0;0;0;54,936388;10,71
1810;"Rudkøbing";"no";0;0;0;54,936388;10,71
1811;"Rudkøbing";"no";0;0;0;54,936388;10,71
1812;"Rudkøbing";"no";0;0;0;54,936388;10,71
1813;"Rudkøbing";"no";0;0;0;54,936388;10,71
1814;"Rudkøbing";"no";3;0;3;54,936388;10,71
1815;"Rudkøbing";"no";0;0;0;54,936388;10,71
1816;"Rudkøbing";"no";0;0;0;54,936388;10,71
1817;"Rudkøbing";"no";0;0;0;54,936388;10,71
1818;"Rudkøbing";"no";1;2;3;54,936388;10,71
1819;"Rudkøbing";"no";0;1;1;54,936388;10,71
1820;"Rudkøbing";"no";0;0;0;54,936388;10,71
1821;"Rudkøbing";"no";0;0;0;54,936388;10,71
1822;"Rudkøbing";"no";0;0;0;54,936388;10,71
1823;"Rudkøbing";"no";0;0;0;54,936388;10,71
1824;"Rudkøbing";"no";1;1;2;54,936388;10,71
1825;"Rudkøbing";"no";1;0;1;54,936388;10,71
1826;"Rudkøbing";"no";0;0;0;54,936388;10,71
1827;"Rudkøbing";"no";0;1;1;54,936388;10,71
1828;"Rudkøbing";"no";0;0;0;54,936388;10,71
1829;"Rudkøbing";"no";0;0;0;54,936388;10,71
1830;"Rudkøbing";"no";0;0;0;54,936388;10,71
1831;"Rudkøbing";"no";0;1;1;54,936388;10,71
1832;"Rudkøbing";"no";0;0;0;54,936388;10,71
1833;"Rudkøbing";"no";0;0;0;54,936388;10,71
1834;"Rudkøbing";"no";0;0;0;54,936388;10,71
1835;"Rudkøbing";"no";1;0;1;54,936388;10,71
1836;"Rudkøbing";"no";1;0;1;54,936388;10,71
1837;"Rudkøbing";"no";0;0;0;54,936388;10,71
1838;"Rudkøbing";"no";1;1;2;54,936388;10,71
1839;"Rudkøbing";"no";0;0;0;54,936388;10,71
1840;"Rudkøbing";"no";0;0;0;54,936388;10,71
1841;"Rudkøbing";"no";0;0;0;54,936388;10,71
1842;"Rudkøbing";"no";0;0;0;54,936388;10,71
1843;"Rudkøbing";"no";0;1;1;54,936388;10,71
1844;"Rudkøbing";"no";0;1;1;54,936388;10,71
1845;"Rudkøbing";"no";0;0;0;54,936388;10,71
1846;"Rudkøbing";"no";0;0;0;54,936388;10,71
1847;"Rudkøbing";"no";2;0;2;54,936388;10,71
1848;"Rudkøbing";"no";1;4;5;54,936388;10,71
1849;"Rudkøbing";"no";0;0;0;54,936388;10,71
1850;"Rudkøbing";"no";1;0;1;54,936388;10,71
1851;"Rudkøbing";"no";0;0;0;54,936388;10,71
1852;"Rudkøbing";"no";0;0;0;54,936388;10,71
1853;"Rudkøbing";"no";0;0;0;54,936388;10,71
1854;"Rudkøbing";"no";0;0;0;54,936388;10,71
1855;"Rudkøbing";"no";0;0;0;54,936388;10,71
1856;"Rudkøbing";"no";0;0;0;54,936388;10,71
1857;"Rudkøbing";"no";0;0;0;54,936388;10,71
1634;"Samsø";"no";0;0;0;55,833333;10,583333
1635;"Samsø";"no";0;0;0;55,833333;10,583333
1636;"Samsø";"no";0;0;0;55,833333;10,583333
1637;"Samsø";"no";0;0;0;55,833333;10,583333
1638;"Samsø";"no";0;0;0;55,833333;10,583333
1639;"Samsø";"no";0;0;0;55,833333;10,583333
1640;"Samsø";"no";0;0;0;55,833333;10,583333
1641;"Samsø";"no";0;0;0;55,833333;10,583333
1642;"Samsø";"no";0;0;0;55,833333;10,583333
1643;"Samsø";"no";1;0;1;55,833333;10,583333
1644;"Samsø";"no";0;0;0;55,833333;10,583333
1645;"Samsø";"no";0;0;0;55,833333;10,583333
1646;"Samsø";"no";0;0;0;55,833333;10,583333
1647;"Samsø";"no";0;0;0;55,833333;10,583333
1648;"Samsø";"no";0;0;0;55,833333;10,583333
1649;"Samsø";"no";0;1;1;55,833333;10,583333
1650;"Samsø";"no";0;0;0;55,833333;10,583333
1651;"Samsø";"no";0;0;0;55,833333;10,583333
1652;"Samsø";"no";0;0;0;55,833333;10,583333
1653;"Samsø";"no";0;0;0;55,833333;10,583333
1654;"Samsø";"no";0;0;0;55,833333;10,583333
1655;"Samsø";"no";0;0;0;55,833333;10,583333
1656;"Samsø";"no";0;0;0;55,833333;10,583333
1657;"Samsø";"no";0;0;0;55,833333;10,583333
1658;"Samsø";"no";0;0;0;55,833333;10,583333
1659;"Samsø";"no";0;0;0;55,833333;10,583333
1660;"Samsø";"no";0;0;0;55,833333;10,583333
1661;"Samsø";"no";0;0;0;55,833333;10,583333
1662;"Samsø";"no";0;0;0;55,833333;10,583333
1663;"Samsø";"no";0;0;0;55,833333;10,583333
1664;"Samsø";"no";0;0;0;55,833333;10,583333
1665;"Samsø";"no";0;0;0;55,833333;10,583333
1666;"Samsø";"no";0;0;0;55,833333;10,583333
1667;"Samsø";"no";0;0;0;55,833333;10,583333
1668;"Samsø";"no";0;0;0;55,833333;10,583333
1669;"Samsø";"no";0;0;0;55,833333;10,583333
1670;"Samsø";"no";0;0;0;55,833333;10,583333
1671;"Samsø";"no";0;0;0;55,833333;10,583333
1672;"Samsø";"no";0;0;0;55,833333;10,583333
1673;"Samsø";"no";0;0;0;55,833333;10,583333
1674;"Samsø";"no";0;1;1;55,833333;10,583333
1675;"Samsø";"no";0;0;0;55,833333;10,583333
1676;"Samsø";"no";0;0;0;55,833333;10,583333
1677;"Samsø";"no";0;0;0;55,833333;10,583333
1678;"Samsø";"no";0;0;0;55,833333;10,583333
1679;"Samsø";"no";1;1;2;55,833333;10,583333
1680;"Samsø";"no";2;1;3;55,833333;10,583333
1681;"Samsø";"no";1;0;1;55,833333;10,583333
1682;"Samsø";"no";0;0;0;55,833333;10,583333
1683;"Samsø";"no";0;1;1;55,833333;10,583333
1684;"Samsø";"no";0;0;0;55,833333;10,583333
1685;"Samsø";"no";0;1;1;55,833333;10,583333
1686;"Samsø";"no";0;1;1;55,833333;10,583333
1687;"Samsø";"no";0;0;0;55,833333;10,583333
1688;"Samsø";"no";0;0;0;55,833333;10,583333
1689;"Samsø";"no";0;0;0;55,833333;10,583333
1690;"Samsø";"no";0;0;0;55,833333;10,583333
1691;"Samsø";"no";0;0;0;55,833333;10,583333
1692;"Samsø";"no";0;0;0;55,833333;10,583333
1693;"Samsø";"no";0;0;0;55,833333;10,583333
1694;"Samsø";"no";0;1;1;55,833333;10,583333
1695;"Samsø";"no";0;0;0;55,833333;10,583333
1696;"Samsø";"no";0;0;0;55,833333;10,583333
1697;"Samsø";"no";0;0;0;55,833333;10,583333
1698;"Samsø";"no";0;0;0;55,833333;10,583333
1699;"Samsø";"no";0;0;0;55,833333;10,583333
1700;"Samsø";"no";0;0;0;55,833333;10,583333
1701;"Samsø";"no";0;0;0;55,833333;10,583333
1702;"Samsø";"no";0;0;0;55,833333;10,583333
1703;"Samsø";"no";0;0;0;55,833333;10,583333
1704;"Samsø";"no";0;0;0;55,833333;10,583333
1705;"Samsø";"no";0;0;0;55,833333;10,583333
1706;"Samsø";"no";0;0;0;55,833333;10,583333
1707;"Samsø";"no";0;0;0;55,833333;10,583333
1708;"Samsø";"no";0;0;0;55,833333;10,583333
1709;"Samsø";"no";0;1;1;55,833333;10,583333
1710;"Samsø";"no";0;0;0;55,833333;10,583333
1711;"Samsø";"no";0;0;0;55,833333;10,583333
1712;"Samsø";"no";0;0;0;55,833333;10,583333
1713;"Samsø";"no";0;0;0;55,833333;10,583333
1714;"Samsø";"no";0;0;0;55,833333;10,583333
1715;"Samsø";"no";0;0;0;55,833333;10,583333
1716;"Samsø";"no";0;0;0;55,833333;10,583333
1717;"Samsø";"no";0;0;0;55,833333;10,583333
1718;"Samsø";"no";0;0;0;55,833333;10,583333
1719;"Samsø";"no";0;0;0;55,833333;10,583333
1720;"Samsø";"no";0;0;0;55,833333;10,583333
1721;"Samsø";"no";0;0;0;55,833333;10,583333
1722;"Samsø";"no";0;0;0;55,833333;10,583333
1723;"Samsø";"no";0;0;0;55,833333;10,583333
1724;"Samsø";"no";0;1;1;55,833333;10,583333
1725;"Samsø";"no";0;0;0;55,833333;10,583333
1726;"Samsø";"no";0;0;0;55,833333;10,583333
1727;"Samsø";"no";0;1;1;55,833333;10,583333
1728;"Samsø";"no";0;0;0;55,833333;10,583333
1729;"Samsø";"no";0;0;0;55,833333;10,583333
1730;"Samsø";"no";0;0;0;55,833333;10,583333
1731;"Samsø";"no";0;0;0;55,833333;10,583333
1732;"Samsø";"no";0;0;0;55,833333;10,583333
1733;"Samsø";"no";0;0;0;55,833333;10,583333
1734;"Samsø";"no";0;0;0;55,833333;10,583333
1735;"Samsø";"no";0;0;0;55,833333;10,583333
1736;"Samsø";"no";0;0;0;55,833333;10,583333
1737;"Samsø";"no";0;1;1;55,833333;10,583333
1738;"Samsø";"no";0;0;0;55,833333;10,583333
1739;"Samsø";"no";0;0;0;55,833333;10,583333
1740;"Samsø";"no";0;0;0;55,833333;10,583333
1741;"Samsø";"no";0;0;0;55,833333;10,583333
1742;"Samsø";"no";0;0;0;55,833333;10,583333
1743;"Samsø";"no";0;0;0;55,833333;10,583333
1744;"Samsø";"no";0;0;0;55,833333;10,583333
1745;"Samsø";"no";0;0;0;55,833333;10,583333
1746;"Samsø";"no";0;0;0;55,833333;10,583333
1747;"Samsø";"no";0;0;0;55,833333;10,583333
1748;"Samsø";"no";0;0;0;55,833333;10,583333
1749;"Samsø";"no";0;0;0;55,833333;10,583333
1750;"Samsø";"no";0;0;0;55,833333;10,583333
1751;"Samsø";"no";0;0;0;55,833333;10,583333
1752;"Samsø";"no";0;0;0;55,833333;10,583333
1753;"Samsø";"no";0;0;0;55,833333;10,583333
1754;"Samsø";"no";0;0;0;55,833333;10,583333
1755;"Samsø";"no";0;2;2;55,833333;10,583333
1756;"Samsø";"no";0;0;0;55,833333;10,583333
1757;"Samsø";"no";0;0;0;55,833333;10,583333
1758;"Samsø";"no";0;0;0;55,833333;10,583333
1759;"Samsø";"no";0;0;0;55,833333;10,583333
1760;"Samsø";"no";0;0;0;55,833333;10,583333
1761;"Samsø";"no";0;0;0;55,833333;10,583333
1762;"Samsø";"no";0;0;0;55,833333;10,583333
1763;"Samsø";"no";0;0;0;55,833333;10,583333
1764;"Samsø";"no";0;0;0;55,833333;10,583333
1765;"Samsø";"no";0;0;0;55,833333;10,583333
1766;"Samsø";"no";0;0;0;55,833333;10,583333
1767;"Samsø";"no";0;0;0;55,833333;10,583333
1768;"Samsø";"no";0;0;0;55,833333;10,583333
1769;"Samsø";"no";0;0;0;55,833333;10,583333
1770;"Samsø";"no";0;0;0;55,833333;10,583333
1771;"Samsø";"no";0;1;1;55,833333;10,583333
1772;"Samsø";"no";0;0;0;55,833333;10,583333
1773;"Samsø";"no";0;0;0;55,833333;10,583333
1774;"Samsø";"no";0;0;0;55,833333;10,583333
1775;"Samsø";"no";0;0;0;55,833333;10,583333
1776;"Samsø";"no";0;0;0;55,833333;10,583333
1777;"Samsø";"no";0;0;0;55,833333;10,583333
1778;"Samsø";"no";0;0;0;55,833333;10,583333
1779;"Samsø";"no";0;0;0;55,833333;10,583333
1780;"Samsø";"no";0;0;0;55,833333;10,583333
1781;"Samsø";"no";0;0;0;55,833333;10,583333
1782;"Samsø";"no";0;0;0;55,833333;10,583333
1783;"Samsø";"no";0;0;0;55,833333;10,583333
1784;"Samsø";"no";0;0;0;55,833333;10,583333
1785;"Samsø";"no";0;0;0;55,833333;10,583333
1786;"Samsø";"no";0;0;0;55,833333;10,583333
1787;"Samsø";"no";0;0;0;55,833333;10,583333
1788;"Samsø";"no";0;0;0;55,833333;10,583333
1789;"Samsø";"no";0;0;0;55,833333;10,583333
1790;"Samsø";"no";0;0;0;55,833333;10,583333
1791;"Samsø";"no";0;0;0;55,833333;10,583333
1792;"Samsø";"no";0;0;0;55,833333;10,583333
1793;"Samsø";"no";0;0;0;55,833333;10,583333
1794;"Samsø";"no";0;0;0;55,833333;10,583333
1795;"Samsø";"no";0;0;0;55,833333;10,583333
1796;"Samsø";"no";0;0;0;55,833333;10,583333
1797;"Samsø";"no";0;0;0;55,833333;10,583333
1798;"Samsø";"no";0;0;0;55,833333;10,583333
1799;"Samsø";"no";0;0;0;55,833333;10,583333
1800;"Samsø";"no";0;0;0;55,833333;10,583333
1801;"Samsø";"no";0;0;0;55,833333;10,583333
1802;"Samsø";"no";0;0;0;55,833333;10,583333
1803;"Samsø";"no";0;0;0;55,833333;10,583333
1804;"Samsø";"no";0;0;0;55,833333;10,583333
1805;"Samsø";"no";0;0;0;55,833333;10,583333
1806;"Samsø";"no";0;0;0;55,833333;10,583333
1807;"Samsø";"no";0;0;0;55,833333;10,583333
1808;"Samsø";"no";0;0;0;55,833333;10,583333
1809;"Samsø";"no";0;0;0;55,833333;10,583333
1810;"Samsø";"no";0;0;0;55,833333;10,583333
1811;"Samsø";"no";0;0;0;55,833333;10,583333
1812;"Samsø";"no";0;0;0;55,833333;10,583333
1813;"Samsø";"no";0;0;0;55,833333;10,583333
1814;"Samsø";"no";0;0;0;55,833333;10,583333
1815;"Samsø";"no";0;1;1;55,833333;10,583333
1816;"Samsø";"no";0;1;1;55,833333;10,583333
1817;"Samsø";"no";1;0;1;55,833333;10,583333
1818;"Samsø";"no";0;0;0;55,833333;10,583333
1819;"Samsø";"no";0;2;2;55,833333;10,583333
1820;"Samsø";"no";0;1;1;55,833333;10,583333
1821;"Samsø";"no";0;1;1;55,833333;10,583333
1822;"Samsø";"no";0;1;1;55,833333;10,583333
1823;"Samsø";"no";0;0;0;55,833333;10,583333
1824;"Samsø";"no";0;0;0;55,833333;10,583333
1825;"Samsø";"no";0;0;0;55,833333;10,583333
1826;"Samsø";"no";0;1;1;55,833333;10,583333
1827;"Samsø";"no";0;3;3;55,833333;10,583333
1828;"Samsø";"no";0;1;1;55,833333;10,583333
1829;"Samsø";"no";1;1;2;55,833333;10,583333
1830;"Samsø";"no";0;1;1;55,833333;10,583333
1831;"Samsø";"no";0;4;4;55,833333;10,583333
1832;"Samsø";"no";0;0;0;55,833333;10,583333
1833;"Samsø";"no";0;0;0;55,833333;10,583333
1834;"Samsø";"no";2;2;4;55,833333;10,583333
1835;"Samsø";"no";0;0;0;55,833333;10,583333
1836;"Samsø";"no";0;0;0;55,833333;10,583333
1837;"Samsø";"no";0;1;1;55,833333;10,583333
1838;"Samsø";"no";4;2;6;55,833333;10,583333
1839;"Samsø";"no";0;2;2;55,833333;10,583333
1840;"Samsø";"no";0;0;0;55,833333;10,583333
1841;"Samsø";"no";1;3;4;55,833333;10,583333
1842;"Samsø";"no";0;0;0;55,833333;10,583333
1843;"Samsø";"no";0;2;2;55,833333;10,583333
1844;"Samsø";"no";1;0;1;55,833333;10,583333
1845;"Samsø";"no";1;2;3;55,833333;10,583333
1846;"Samsø";"no";0;0;0;55,833333;10,583333
1847;"Samsø";"no";1;1;2;55,833333;10,583333
1848;"Samsø";"no";0;1;1;55,833333;10,583333
1849;"Samsø";"no";1;1;2;55,833333;10,583333
1850;"Samsø";"no";1;0;1;55,833333;10,583333
1851;"Samsø";"no";1;1;2;55,833333;10,583333
1852;"Samsø";"no";2;1;3;55,833333;10,583333
1853;"Samsø";"no";1;1;2;55,833333;10,583333
1854;"Samsø";"no";0;1;1;55,833333;10,583333
1855;"Samsø";"no";0;1;1;55,833333;10,583333
1856;"Samsø";"no";1;2;3;55,833333;10,583333
1857;"Samsø";"no";0;0;0;55,833333;10,583333
1634;"Storehedinge";"no";0;0;0;55,309444;12,388611
1635;"Storehedinge";"no";0;0;0;55,309444;12,388611
1636;"Storehedinge";"no";0;0;0;55,309444;12,388611
1637;"Storehedinge";"no";0;0;0;55,309444;12,388611
1638;"Storehedinge";"no";0;0;0;55,309444;12,388611
1639;"Storehedinge";"no";0;0;0;55,309444;12,388611
1640;"Storehedinge";"no";0;0;0;55,309444;12,388611
1641;"Storehedinge";"no";0;0;0;55,309444;12,388611
1642;"Storehedinge";"no";0;0;0;55,309444;12,388611
1643;"Storehedinge";"no";2;0;2;55,309444;12,388611
1644;"Storehedinge";"no";0;0;0;55,309444;12,388611
1645;"Storehedinge";"no";0;0;0;55,309444;12,388611
1646;"Storehedinge";"no";0;0;0;55,309444;12,388611
1647;"Storehedinge";"no";0;0;0;55,309444;12,388611
1648;"Storehedinge";"no";0;0;0;55,309444;12,388611
1649;"Storehedinge";"no";0;0;0;55,309444;12,388611
1650;"Storehedinge";"no";0;0;0;55,309444;12,388611
1651;"Storehedinge";"no";0;0;0;55,309444;12,388611
1652;"Storehedinge";"no";0;0;0;55,309444;12,388611
1653;"Storehedinge";"no";0;0;0;55,309444;12,388611
1654;"Storehedinge";"no";0;0;0;55,309444;12,388611
1655;"Storehedinge";"no";0;0;0;55,309444;12,388611
1656;"Storehedinge";"no";0;0;0;55,309444;12,388611
1657;"Storehedinge";"no";0;0;0;55,309444;12,388611
1658;"Storehedinge";"no";0;0;0;55,309444;12,388611
1659;"Storehedinge";"no";0;0;0;55,309444;12,388611
1660;"Storehedinge";"no";0;0;0;55,309444;12,388611
1661;"Storehedinge";"no";0;0;0;55,309444;12,388611
1662;"Storehedinge";"no";0;0;0;55,309444;12,388611
1663;"Storehedinge";"no";0;0;0;55,309444;12,388611
1664;"Storehedinge";"no";0;0;0;55,309444;12,388611
1665;"Storehedinge";"no";1;0;1;55,309444;12,388611
1666;"Storehedinge";"no";1;0;1;55,309444;12,388611
1667;"Storehedinge";"no";1;0;1;55,309444;12,388611
1668;"Storehedinge";"no";1;0;1;55,309444;12,388611
1669;"Storehedinge";"no";1;0;1;55,309444;12,388611
1670;"Storehedinge";"no";0;0;0;55,309444;12,388611
1671;"Storehedinge";"no";1;0;1;55,309444;12,388611
1672;"Storehedinge";"no";1;0;1;55,309444;12,388611
1673;"Storehedinge";"no";0;0;0;55,309444;12,388611
1674;"Storehedinge";"no";0;0;0;55,309444;12,388611
1675;"Storehedinge";"no";0;0;0;55,309444;12,388611
1676;"Storehedinge";"no";0;0;0;55,309444;12,388611
1677;"Storehedinge";"no";0;0;0;55,309444;12,388611
1678;"Storehedinge";"no";0;0;0;55,309444;12,388611
1679;"Storehedinge";"no";0;0;0;55,309444;12,388611
1680;"Storehedinge";"no";0;0;0;55,309444;12,388611
1681;"Storehedinge";"no";0;0;0;55,309444;12,388611
1682;"Storehedinge";"no";0;0;0;55,309444;12,388611
1683;"Storehedinge";"no";0;0;0;55,309444;12,388611
1684;"Storehedinge";"no";0;0;0;55,309444;12,388611
1685;"Storehedinge";"no";0;0;0;55,309444;12,388611
1686;"Storehedinge";"no";0;0;0;55,309444;12,388611
1687;"Storehedinge";"no";0;0;0;55,309444;12,388611
1688;"Storehedinge";"no";0;0;0;55,309444;12,388611
1689;"Storehedinge";"no";0;0;0;55,309444;12,388611
1690;"Storehedinge";"no";0;0;0;55,309444;12,388611
1691;"Storehedinge";"no";0;0;0;55,309444;12,388611
1692;"Storehedinge";"no";0;0;0;55,309444;12,388611
1693;"Storehedinge";"no";0;0;0;55,309444;12,388611
1694;"Storehedinge";"no";0;0;0;55,309444;12,388611
1695;"Storehedinge";"no";0;0;0;55,309444;12,388611
1696;"Storehedinge";"no";0;0;0;55,309444;12,388611
1697;"Storehedinge";"no";0;0;0;55,309444;12,388611
1698;"Storehedinge";"no";0;0;0;55,309444;12,388611
1699;"Storehedinge";"no";0;0;0;55,309444;12,388611
1700;"Storehedinge";"no";0;0;0;55,309444;12,388611
1701;"Storehedinge";"no";0;0;0;55,309444;12,388611
1702;"Storehedinge";"no";0;0;0;55,309444;12,388611
1703;"Storehedinge";"no";0;0;0;55,309444;12,388611
1704;"Storehedinge";"no";0;0;0;55,309444;12,388611
1705;"Storehedinge";"no";0;0;0;55,309444;12,388611
1706;"Storehedinge";"no";0;0;0;55,309444;12,388611
1707;"Storehedinge";"no";0;0;0;55,309444;12,388611
1708;"Storehedinge";"no";0;0;0;55,309444;12,388611
1709;"Storehedinge";"no";0;0;0;55,309444;12,388611
1710;"Storehedinge";"no";0;0;0;55,309444;12,388611
1711;"Storehedinge";"no";0;0;0;55,309444;12,388611
1712;"Storehedinge";"no";0;0;0;55,309444;12,388611
1713;"Storehedinge";"no";0;0;0;55,309444;12,388611
1714;"Storehedinge";"no";0;0;0;55,309444;12,388611
1715;"Storehedinge";"no";0;0;0;55,309444;12,388611
1716;"Storehedinge";"no";0;0;0;55,309444;12,388611
1717;"Storehedinge";"no";0;0;0;55,309444;12,388611
1718;"Storehedinge";"no";0;0;0;55,309444;12,388611
1719;"Storehedinge";"no";0;0;0;55,309444;12,388611
1720;"Storehedinge";"no";0;0;0;55,309444;12,388611
1721;"Storehedinge";"no";0;0;0;55,309444;12,388611
1722;"Storehedinge";"no";0;0;0;55,309444;12,388611
1723;"Storehedinge";"no";0;0;0;55,309444;12,388611
1724;"Storehedinge";"no";0;0;0;55,309444;12,388611
1725;"Storehedinge";"no";0;0;0;55,309444;12,388611
1726;"Storehedinge";"no";0;0;0;55,309444;12,388611
1727;"Storehedinge";"no";0;0;0;55,309444;12,388611
1728;"Storehedinge";"no";0;0;0;55,309444;12,388611
1729;"Storehedinge";"no";0;0;0;55,309444;12,388611
1730;"Storehedinge";"no";0;0;0;55,309444;12,388611
1731;"Storehedinge";"no";0;0;0;55,309444;12,388611
1732;"Storehedinge";"no";0;0;0;55,309444;12,388611
1733;"Storehedinge";"no";0;0;0;55,309444;12,388611
1734;"Storehedinge";"no";0;0;0;55,309444;12,388611
1735;"Storehedinge";"no";0;0;0;55,309444;12,388611
1736;"Storehedinge";"no";0;0;0;55,309444;12,388611
1737;"Storehedinge";"no";0;0;0;55,309444;12,388611
1738;"Storehedinge";"no";0;0;0;55,309444;12,388611
1739;"Storehedinge";"no";0;0;0;55,309444;12,388611
1740;"Storehedinge";"no";0;0;0;55,309444;12,388611
1741;"Storehedinge";"no";0;0;0;55,309444;12,388611
1742;"Storehedinge";"no";0;0;0;55,309444;12,388611
1743;"Storehedinge";"no";0;0;0;55,309444;12,388611
1744;"Storehedinge";"no";0;0;0;55,309444;12,388611
1745;"Storehedinge";"no";0;0;0;55,309444;12,388611
1746;"Storehedinge";"no";0;0;0;55,309444;12,388611
1747;"Storehedinge";"no";0;0;0;55,309444;12,388611
1748;"Storehedinge";"no";0;0;0;55,309444;12,388611
1749;"Storehedinge";"no";0;0;0;55,309444;12,388611
1750;"Storehedinge";"no";0;0;0;55,309444;12,388611
1751;"Storehedinge";"no";0;0;0;55,309444;12,388611
1752;"Storehedinge";"no";0;0;0;55,309444;12,388611
1753;"Storehedinge";"no";0;0;0;55,309444;12,388611
1754;"Storehedinge";"no";0;0;0;55,309444;12,388611
1755;"Storehedinge";"no";0;0;0;55,309444;12,388611
1756;"Storehedinge";"no";0;0;0;55,309444;12,388611
1757;"Storehedinge";"no";0;0;0;55,309444;12,388611
1758;"Storehedinge";"no";0;0;0;55,309444;12,388611
1759;"Storehedinge";"no";0;0;0;55,309444;12,388611
1760;"Storehedinge";"no";0;0;0;55,309444;12,388611
1761;"Storehedinge";"no";0;0;0;55,309444;12,388611
1762;"Storehedinge";"no";0;0;0;55,309444;12,388611
1763;"Storehedinge";"no";0;0;0;55,309444;12,388611
1764;"Storehedinge";"no";0;0;0;55,309444;12,388611
1765;"Storehedinge";"no";0;0;0;55,309444;12,388611
1766;"Storehedinge";"no";0;0;0;55,309444;12,388611
1767;"Storehedinge";"no";0;0;0;55,309444;12,388611
1768;"Storehedinge";"no";0;0;0;55,309444;12,388611
1769;"Storehedinge";"no";0;0;0;55,309444;12,388611
1770;"Storehedinge";"no";0;0;0;55,309444;12,388611
1771;"Storehedinge";"no";0;0;0;55,309444;12,388611
1772;"Storehedinge";"no";0;0;0;55,309444;12,388611
1773;"Storehedinge";"no";0;0;0;55,309444;12,388611
1774;"Storehedinge";"no";0;0;0;55,309444;12,388611
1775;"Storehedinge";"no";0;0;0;55,309444;12,388611
1776;"Storehedinge";"no";0;0;0;55,309444;12,388611
1777;"Storehedinge";"no";0;0;0;55,309444;12,388611
1778;"Storehedinge";"no";0;0;0;55,309444;12,388611
1779;"Storehedinge";"no";0;0;0;55,309444;12,388611
1780;"Storehedinge";"no";0;0;0;55,309444;12,388611
1781;"Storehedinge";"no";0;0;0;55,309444;12,388611
1782;"Storehedinge";"no";0;0;0;55,309444;12,388611
1783;"Storehedinge";"no";0;0;0;55,309444;12,388611
1784;"Storehedinge";"no";0;0;0;55,309444;12,388611
1785;"Storehedinge";"no";0;0;0;55,309444;12,388611
1786;"Storehedinge";"no";0;0;0;55,309444;12,388611
1787;"Storehedinge";"no";0;0;0;55,309444;12,388611
1788;"Storehedinge";"no";0;0;0;55,309444;12,388611
1789;"Storehedinge";"no";0;0;0;55,309444;12,388611
1790;"Storehedinge";"no";0;0;0;55,309444;12,388611
1791;"Storehedinge";"no";0;0;0;55,309444;12,388611
1792;"Storehedinge";"no";0;0;0;55,309444;12,388611
1793;"Storehedinge";"no";0;0;0;55,309444;12,388611
1794;"Storehedinge";"no";0;0;0;55,309444;12,388611
1795;"Storehedinge";"no";0;0;0;55,309444;12,388611
1796;"Storehedinge";"no";0;0;0;55,309444;12,388611
1797;"Storehedinge";"no";0;0;0;55,309444;12,388611
1798;"Storehedinge";"no";0;0;0;55,309444;12,388611
1799;"Storehedinge";"no";0;0;0;55,309444;12,388611
1800;"Storehedinge";"no";0;0;0;55,309444;12,388611
1801;"Storehedinge";"no";0;0;0;55,309444;12,388611
1802;"Storehedinge";"no";0;0;0;55,309444;12,388611
1803;"Storehedinge";"no";0;0;0;55,309444;12,388611
1804;"Storehedinge";"no";0;0;0;55,309444;12,388611
1805;"Storehedinge";"no";0;0;0;55,309444;12,388611
1806;"Storehedinge";"no";0;0;0;55,309444;12,388611
1807;"Storehedinge";"no";0;0;0;55,309444;12,388611
1808;"Storehedinge";"no";0;0;0;55,309444;12,388611
1809;"Storehedinge";"no";0;0;0;55,309444;12,388611
1810;"Storehedinge";"no";0;0;0;55,309444;12,388611
1811;"Storehedinge";"no";0;0;0;55,309444;12,388611
1812;"Storehedinge";"no";0;0;0;55,309444;12,388611
1813;"Storehedinge";"no";0;0;0;55,309444;12,388611
1814;"Storehedinge";"no";0;0;0;55,309444;12,388611
1815;"Storehedinge";"no";0;0;0;55,309444;12,388611
1816;"Storehedinge";"no";0;0;0;55,309444;12,388611
1817;"Storehedinge";"no";0;0;0;55,309444;12,388611
1818;"Storehedinge";"no";0;0;0;55,309444;12,388611
1819;"Storehedinge";"no";0;0;0;55,309444;12,388611
1820;"Storehedinge";"no";0;0;0;55,309444;12,388611
1821;"Storehedinge";"no";0;0;0;55,309444;12,388611
1822;"Storehedinge";"no";0;0;0;55,309444;12,388611
1823;"Storehedinge";"no";0;0;0;55,309444;12,388611
1824;"Storehedinge";"no";0;0;0;55,309444;12,388611
1825;"Storehedinge";"no";0;0;0;55,309444;12,388611
1826;"Storehedinge";"no";0;0;0;55,309444;12,388611
1827;"Storehedinge";"no";0;0;0;55,309444;12,388611
1828;"Storehedinge";"no";0;0;0;55,309444;12,388611
1829;"Storehedinge";"no";0;0;0;55,309444;12,388611
1830;"Storehedinge";"no";0;0;0;55,309444;12,388611
1831;"Storehedinge";"no";0;0;0;55,309444;12,388611
1832;"Storehedinge";"no";0;0;0;55,309444;12,388611
1833;"Storehedinge";"no";0;0;0;55,309444;12,388611
1834;"Storehedinge";"no";0;0;0;55,309444;12,388611
1835;"Storehedinge";"no";0;0;0;55,309444;12,388611
1836;"Storehedinge";"no";0;0;0;55,309444;12,388611
1837;"Storehedinge";"no";0;0;0;55,309444;12,388611
1838;"Storehedinge";"no";3;0;3;55,309444;12,388611
1839;"Storehedinge";"no";2;1;3;55,309444;12,388611
1840;"Storehedinge";"no";0;0;0;55,309444;12,388611
1841;"Storehedinge";"no";3;0;3;55,309444;12,388611
1842;"Storehedinge";"no";2;1;3;55,309444;12,388611
1843;"Storehedinge";"no";3;0;3;55,309444;12,388611
1844;"Storehedinge";"no";3;4;7;55,309444;12,388611
1845;"Storehedinge";"no";5;3;8;55,309444;12,388611
1846;"Storehedinge";"no";10;6;16;55,309444;12,388611
1847;"Storehedinge";"no";5;4;9;55,309444;12,388611
1848;"Storehedinge";"no";8;2;10;55,309444;12,388611
1849;"Storehedinge";"no";9;4;13;55,309444;12,388611
1850;"Storehedinge";"no";9;4;13;55,309444;12,388611
1851;"Storehedinge";"no";7;3;10;55,309444;12,388611
1852;"Storehedinge";"no";14;6;20;55,309444;12,388611
1853;"Storehedinge";"no";10;9;19;55,309444;12,388611
1854;"Storehedinge";"no";8;7;15;55,309444;12,388611
1855;"Storehedinge";"no";11;8;19;55,309444;12,388611
1856;"Storehedinge";"no";2;4;6;55,309444;12,388611
1857;"Storehedinge";"no";0;0;0;55,309444;12,388611
1634;"Neksø";"no";0;0;0;55,066666;15,13
1635;"Neksø";"no";0;0;0;55,066666;15,13
1636;"Neksø";"no";0;0;0;55,066666;15,13
1637;"Neksø";"no";0;0;0;55,066666;15,13
1638;"Neksø";"no";0;0;0;55,066666;15,13
1639;"Neksø";"no";0;0;0;55,066666;15,13
1640;"Neksø";"no";0;0;0;55,066666;15,13
1641;"Neksø";"no";0;0;0;55,066666;15,13
1642;"Neksø";"no";0;0;0;55,066666;15,13
1643;"Neksø";"no";0;0;0;55,066666;15,13
1644;"Neksø";"no";1;0;1;55,066666;15,13
1645;"Neksø";"no";0;0;0;55,066666;15,13
1646;"Neksø";"no";0;0;0;55,066666;15,13
1647;"Neksø";"no";0;0;0;55,066666;15,13
1648;"Neksø";"no";0;0;0;55,066666;15,13
1649;"Neksø";"no";0;0;0;55,066666;15,13
1650;"Neksø";"no";0;0;0;55,066666;15,13
1651;"Neksø";"no";0;0;0;55,066666;15,13
1652;"Neksø";"no";0;0;0;55,066666;15,13
1653;"Neksø";"no";0;0;0;55,066666;15,13
1654;"Neksø";"no";0;0;0;55,066666;15,13
1655;"Neksø";"no";0;0;0;55,066666;15,13
1656;"Neksø";"no";0;0;0;55,066666;15,13
1657;"Neksø";"no";0;0;0;55,066666;15,13
1658;"Neksø";"no";0;0;0;55,066666;15,13
1659;"Neksø";"no";0;0;0;55,066666;15,13
1660;"Neksø";"no";0;0;0;55,066666;15,13
1661;"Neksø";"no";0;0;0;55,066666;15,13
1662;"Neksø";"no";0;0;0;55,066666;15,13
1663;"Neksø";"no";0;0;0;55,066666;15,13
1664;"Neksø";"no";0;0;0;55,066666;15,13
1665;"Neksø";"no";0;0;0;55,066666;15,13
1666;"Neksø";"no";0;0;0;55,066666;15,13
1667;"Neksø";"no";0;0;0;55,066666;15,13
1668;"Neksø";"no";0;0;0;55,066666;15,13
1669;"Neksø";"no";0;0;0;55,066666;15,13
1670;"Neksø";"no";0;0;0;55,066666;15,13
1671;"Neksø";"no";0;0;0;55,066666;15,13
1672;"Neksø";"no";0;0;0;55,066666;15,13
1673;"Neksø";"no";0;0;0;55,066666;15,13
1674;"Neksø";"no";0;0;0;55,066666;15,13
1675;"Neksø";"no";0;0;0;55,066666;15,13
1676;"Neksø";"no";0;0;0;55,066666;15,13
1677;"Neksø";"no";0;0;0;55,066666;15,13
1678;"Neksø";"no";0;0;0;55,066666;15,13
1679;"Neksø";"no";0;0;0;55,066666;15,13
1680;"Neksø";"no";0;0;0;55,066666;15,13
1681;"Neksø";"no";0;0;0;55,066666;15,13
1682;"Neksø";"no";0;0;0;55,066666;15,13
1683;"Neksø";"no";0;0;0;55,066666;15,13
1684;"Neksø";"no";0;0;0;55,066666;15,13
1685;"Neksø";"no";0;0;0;55,066666;15,13
1686;"Neksø";"no";0;0;0;55,066666;15,13
1687;"Neksø";"no";0;0;0;55,066666;15,13
1688;"Neksø";"no";0;0;0;55,066666;15,13
1689;"Neksø";"no";0;0;0;55,066666;15,13
1690;"Neksø";"no";0;0;0;55,066666;15,13
1691;"Neksø";"no";0;0;0;55,066666;15,13
1692;"Neksø";"no";0;0;0;55,066666;15,13
1693;"Neksø";"no";0;0;0;55,066666;15,13
1694;"Neksø";"no";0;0;0;55,066666;15,13
1695;"Neksø";"no";0;0;0;55,066666;15,13
1696;"Neksø";"no";0;0;0;55,066666;15,13
1697;"Neksø";"no";0;0;0;55,066666;15,13
1698;"Neksø";"no";0;0;0;55,066666;15,13
1699;"Neksø";"no";0;0;0;55,066666;15,13
1700;"Neksø";"no";0;0;0;55,066666;15,13
1701;"Neksø";"no";0;0;0;55,066666;15,13
1702;"Neksø";"no";0;0;0;55,066666;15,13
1703;"Neksø";"no";0;0;0;55,066666;15,13
1704;"Neksø";"no";0;0;0;55,066666;15,13
1705;"Neksø";"no";0;0;0;55,066666;15,13
1706;"Neksø";"no";0;0;0;55,066666;15,13
1707;"Neksø";"no";0;0;0;55,066666;15,13
1708;"Neksø";"no";0;0;0;55,066666;15,13
1709;"Neksø";"no";0;0;0;55,066666;15,13
1710;"Neksø";"no";0;0;0;55,066666;15,13
1711;"Neksø";"no";0;0;0;55,066666;15,13
1712;"Neksø";"no";0;0;0;55,066666;15,13
1713;"Neksø";"no";0;0;0;55,066666;15,13
1714;"Neksø";"no";0;0;0;55,066666;15,13
1715;"Neksø";"no";0;0;0;55,066666;15,13
1716;"Neksø";"no";0;0;0;55,066666;15,13
1717;"Neksø";"no";0;0;0;55,066666;15,13
1718;"Neksø";"no";0;0;0;55,066666;15,13
1719;"Neksø";"no";0;0;0;55,066666;15,13
1720;"Neksø";"no";0;0;0;55,066666;15,13
1721;"Neksø";"no";0;0;0;55,066666;15,13
1722;"Neksø";"no";0;0;0;55,066666;15,13
1723;"Neksø";"no";0;0;0;55,066666;15,13
1724;"Neksø";"no";0;0;0;55,066666;15,13
1725;"Neksø";"no";0;0;0;55,066666;15,13
1726;"Neksø";"no";0;0;0;55,066666;15,13
1727;"Neksø";"no";0;0;0;55,066666;15,13
1728;"Neksø";"no";0;0;0;55,066666;15,13
1729;"Neksø";"no";0;0;0;55,066666;15,13
1730;"Neksø";"no";0;0;0;55,066666;15,13
1731;"Neksø";"no";0;0;0;55,066666;15,13
1732;"Neksø";"no";0;0;0;55,066666;15,13
1733;"Neksø";"no";0;0;0;55,066666;15,13
1734;"Neksø";"no";0;0;0;55,066666;15,13
1735;"Neksø";"no";0;0;0;55,066666;15,13
1736;"Neksø";"no";0;0;0;55,066666;15,13
1737;"Neksø";"no";0;0;0;55,066666;15,13
1738;"Neksø";"no";0;0;0;55,066666;15,13
1739;"Neksø";"no";0;0;0;55,066666;15,13
1740;"Neksø";"no";0;0;0;55,066666;15,13
1741;"Neksø";"no";0;0;0;55,066666;15,13
1742;"Neksø";"no";0;0;0;55,066666;15,13
1743;"Neksø";"no";0;0;0;55,066666;15,13
1744;"Neksø";"no";0;0;0;55,066666;15,13
1745;"Neksø";"no";0;0;0;55,066666;15,13
1746;"Neksø";"no";0;0;0;55,066666;15,13
1747;"Neksø";"no";0;0;0;55,066666;15,13
1748;"Neksø";"no";0;0;0;55,066666;15,13
1749;"Neksø";"no";0;0;0;55,066666;15,13
1750;"Neksø";"no";0;0;0;55,066666;15,13
1751;"Neksø";"no";0;0;0;55,066666;15,13
1752;"Neksø";"no";0;0;0;55,066666;15,13
1753;"Neksø";"no";0;0;0;55,066666;15,13
1754;"Neksø";"no";0;0;0;55,066666;15,13
1755;"Neksø";"no";0;0;0;55,066666;15,13
1756;"Neksø";"no";0;0;0;55,066666;15,13
1757;"Neksø";"no";0;0;0;55,066666;15,13
1758;"Neksø";"no";0;0;0;55,066666;15,13
1759;"Neksø";"no";0;0;0;55,066666;15,13
1760;"Neksø";"no";0;0;0;55,066666;15,13
1761;"Neksø";"no";0;0;0;55,066666;15,13
1762;"Neksø";"no";0;0;0;55,066666;15,13
1763;"Neksø";"no";0;0;0;55,066666;15,13
1764;"Neksø";"no";0;0;0;55,066666;15,13
1765;"Neksø";"no";0;0;0;55,066666;15,13
1766;"Neksø";"no";0;0;0;55,066666;15,13
1767;"Neksø";"no";0;0;0;55,066666;15,13
1768;"Neksø";"no";0;0;0;55,066666;15,13
1769;"Neksø";"no";0;0;0;55,066666;15,13
1770;"Neksø";"no";0;0;0;55,066666;15,13
1771;"Neksø";"no";0;0;0;55,066666;15,13
1772;"Neksø";"no";0;0;0;55,066666;15,13
1773;"Neksø";"no";0;0;0;55,066666;15,13
1774;"Neksø";"no";0;0;0;55,066666;15,13
1775;"Neksø";"no";0;0;0;55,066666;15,13
1776;"Neksø";"no";0;0;0;55,066666;15,13
1777;"Neksø";"no";0;0;0;55,066666;15,13
1778;"Neksø";"no";0;0;0;55,066666;15,13
1779;"Neksø";"no";0;0;0;55,066666;15,13
1780;"Neksø";"no";0;0;0;55,066666;15,13
1781;"Neksø";"no";0;0;0;55,066666;15,13
1782;"Neksø";"no";0;0;0;55,066666;15,13
1783;"Neksø";"no";0;0;0;55,066666;15,13
1784;"Neksø";"no";0;0;0;55,066666;15,13
1785;"Neksø";"no";0;0;0;55,066666;15,13
1786;"Neksø";"no";0;0;0;55,066666;15,13
1787;"Neksø";"no";0;0;0;55,066666;15,13
1788;"Neksø";"no";0;0;0;55,066666;15,13
1789;"Neksø";"no";0;0;0;55,066666;15,13
1790;"Neksø";"no";0;0;0;55,066666;15,13
1791;"Neksø";"no";0;0;0;55,066666;15,13
1792;"Neksø";"no";0;0;0;55,066666;15,13
1793;"Neksø";"no";0;0;0;55,066666;15,13
1794;"Neksø";"no";0;0;0;55,066666;15,13
1795;"Neksø";"no";0;0;0;55,066666;15,13
1796;"Neksø";"no";0;0;0;55,066666;15,13
1797;"Neksø";"no";0;0;0;55,066666;15,13
1798;"Neksø";"no";0;0;0;55,066666;15,13
1799;"Neksø";"no";0;0;0;55,066666;15,13
1800;"Neksø";"no";0;0;0;55,066666;15,13
1801;"Neksø";"no";0;0;0;55,066666;15,13
1802;"Neksø";"no";0;0;0;55,066666;15,13
1803;"Neksø";"no";0;0;0;55,066666;15,13
1804;"Neksø";"no";0;0;0;55,066666;15,13
1805;"Neksø";"no";0;0;0;55,066666;15,13
1806;"Neksø";"no";0;0;0;55,066666;15,13
1807;"Neksø";"no";0;0;0;55,066666;15,13
1808;"Neksø";"no";0;0;0;55,066666;15,13
1809;"Neksø";"no";0;0;0;55,066666;15,13
1810;"Neksø";"no";0;0;0;55,066666;15,13
1811;"Neksø";"no";0;0;0;55,066666;15,13
1812;"Neksø";"no";0;0;0;55,066666;15,13
1813;"Neksø";"no";0;0;0;55,066666;15,13
1814;"Neksø";"no";0;0;0;55,066666;15,13
1815;"Neksø";"no";0;0;0;55,066666;15,13
1816;"Neksø";"no";0;0;0;55,066666;15,13
1817;"Neksø";"no";0;0;0;55,066666;15,13
1818;"Neksø";"no";0;0;0;55,066666;15,13
1819;"Neksø";"no";0;0;0;55,066666;15,13
1820;"Neksø";"no";0;0;0;55,066666;15,13
1821;"Neksø";"no";0;0;0;55,066666;15,13
1822;"Neksø";"no";0;0;0;55,066666;15,13
1823;"Neksø";"no";0;0;0;55,066666;15,13
1824;"Neksø";"no";0;0;0;55,066666;15,13
1825;"Neksø";"no";0;0;0;55,066666;15,13
1826;"Neksø";"no";0;0;0;55,066666;15,13
1827;"Neksø";"no";0;0;0;55,066666;15,13
1828;"Neksø";"no";0;0;0;55,066666;15,13
1829;"Neksø";"no";1;0;1;55,066666;15,13
1830;"Neksø";"no";1;0;1;55,066666;15,13
1831;"Neksø";"no";1;2;3;55,066666;15,13
1832;"Neksø";"no";1;2;3;55,066666;15,13
1833;"Neksø";"no";0;0;0;55,066666;15,13
1834;"Neksø";"no";1;0;1;55,066666;15,13
1835;"Neksø";"no";1;0;1;55,066666;15,13
1836;"Neksø";"no";1;0;1;55,066666;15,13
1837;"Neksø";"no";0;0;0;55,066666;15,13
1838;"Neksø";"no";1;1;2;55,066666;15,13
1839;"Neksø";"no";0;0;0;55,066666;15,13
1840;"Neksø";"no";1;1;2;55,066666;15,13
1841;"Neksø";"no";2;2;4;55,066666;15,13
1842;"Neksø";"no";2;1;3;55,066666;15,13
1843;"Neksø";"no";3;3;6;55,066666;15,13
1844;"Neksø";"no";2;0;2;55,066666;15,13
1845;"Neksø";"no";1;1;2;55,066666;15,13
1846;"Neksø";"no";2;1;3;55,066666;15,13
1847;"Neksø";"no";0;0;0;55,066666;15,13
1848;"Neksø";"no";1;1;2;55,066666;15,13
1849;"Neksø";"no";1;2;3;55,066666;15,13
1850;"Neksø";"no";0;2;2;55,066666;15,13
1851;"Neksø";"no";0;0;0;55,066666;15,13
1852;"Neksø";"no";1;1;2;55,066666;15,13
1853;"Neksø";"no";0;2;2;55,066666;15,13
1854;"Neksø";"no";2;1;3;55,066666;15,13
1855;"Neksø";"no";2;3;5;55,066666;15,13
1856;"Neksø";"no";2;3;5;55,066666;15,13
1857;"Neksø";"no";0;0;0;55,066666;15,13
1634;"Sakskøbing";"no";0;0;0;54,8;11,65
1635;"Sakskøbing";"no";0;0;0;54,8;11,65
1636;"Sakskøbing";"no";0;0;0;54,8;11,65
1637;"Sakskøbing";"no";0;0;0;54,8;11,65
1638;"Sakskøbing";"no";0;0;0;54,8;11,65
1639;"Sakskøbing";"no";0;0;0;54,8;11,65
1640;"Sakskøbing";"no";0;0;0;54,8;11,65
1641;"Sakskøbing";"no";0;0;0;54,8;11,65
1642;"Sakskøbing";"no";0;0;0;54,8;11,65
1643;"Sakskøbing";"no";0;0;0;54,8;11,65
1644;"Sakskøbing";"no";1;0;1;54,8;11,65
1645;"Sakskøbing";"no";0;0;0;54,8;11,65
1646;"Sakskøbing";"no";0;0;0;54,8;11,65
1647;"Sakskøbing";"no";0;0;0;54,8;11,65
1648;"Sakskøbing";"no";0;0;0;54,8;11,65
1649;"Sakskøbing";"no";0;0;0;54,8;11,65
1650;"Sakskøbing";"no";0;0;0;54,8;11,65
1651;"Sakskøbing";"no";0;0;0;54,8;11,65
1652;"Sakskøbing";"no";0;0;0;54,8;11,65
1653;"Sakskøbing";"no";0;0;0;54,8;11,65
1654;"Sakskøbing";"no";0;0;0;54,8;11,65
1655;"Sakskøbing";"no";0;0;0;54,8;11,65
1656;"Sakskøbing";"no";0;0;0;54,8;11,65
1657;"Sakskøbing";"no";0;0;0;54,8;11,65
1658;"Sakskøbing";"no";0;0;0;54,8;11,65
1659;"Sakskøbing";"no";0;0;0;54,8;11,65
1660;"Sakskøbing";"no";0;0;0;54,8;11,65
1661;"Sakskøbing";"no";0;0;0;54,8;11,65
1662;"Sakskøbing";"no";0;0;0;54,8;11,65
1663;"Sakskøbing";"no";0;0;0;54,8;11,65
1664;"Sakskøbing";"no";0;0;0;54,8;11,65
1665;"Sakskøbing";"no";0;0;0;54,8;11,65
1666;"Sakskøbing";"no";0;0;0;54,8;11,65
1667;"Sakskøbing";"no";1;0;1;54,8;11,65
1668;"Sakskøbing";"no";0;0;0;54,8;11,65
1669;"Sakskøbing";"no";0;0;0;54,8;11,65
1670;"Sakskøbing";"no";1;0;1;54,8;11,65
1671;"Sakskøbing";"no";0;0;0;54,8;11,65
1672;"Sakskøbing";"no";0;0;0;54,8;11,65
1673;"Sakskøbing";"no";0;0;0;54,8;11,65
1674;"Sakskøbing";"no";0;0;0;54,8;11,65
1675;"Sakskøbing";"no";0;0;0;54,8;11,65
1676;"Sakskøbing";"no";0;0;0;54,8;11,65
1677;"Sakskøbing";"no";0;0;0;54,8;11,65
1678;"Sakskøbing";"no";0;0;0;54,8;11,65
1679;"Sakskøbing";"no";0;0;0;54,8;11,65
1680;"Sakskøbing";"no";1;0;1;54,8;11,65
1681;"Sakskøbing";"no";0;0;0;54,8;11,65
1682;"Sakskøbing";"no";0;0;0;54,8;11,65
1683;"Sakskøbing";"no";0;0;0;54,8;11,65
1684;"Sakskøbing";"no";0;0;0;54,8;11,65
1685;"Sakskøbing";"no";0;0;0;54,8;11,65
1686;"Sakskøbing";"no";0;0;0;54,8;11,65
1687;"Sakskøbing";"no";0;0;0;54,8;11,65
1688;"Sakskøbing";"no";0;0;0;54,8;11,65
1689;"Sakskøbing";"no";0;0;0;54,8;11,65
1690;"Sakskøbing";"no";0;0;0;54,8;11,65
1691;"Sakskøbing";"no";0;0;0;54,8;11,65
1692;"Sakskøbing";"no";0;0;0;54,8;11,65
1693;"Sakskøbing";"no";0;0;0;54,8;11,65
1694;"Sakskøbing";"no";0;0;0;54,8;11,65
1695;"Sakskøbing";"no";0;0;0;54,8;11,65
1696;"Sakskøbing";"no";0;0;0;54,8;11,65
1697;"Sakskøbing";"no";0;0;0;54,8;11,65
1698;"Sakskøbing";"no";0;0;0;54,8;11,65
1699;"Sakskøbing";"no";1;0;1;54,8;11,65
1700;"Sakskøbing";"no";0;0;0;54,8;11,65
1701;"Sakskøbing";"no";0;0;0;54,8;11,65
1702;"Sakskøbing";"no";0;0;0;54,8;11,65
1703;"Sakskøbing";"no";0;0;0;54,8;11,65
1704;"Sakskøbing";"no";0;0;0;54,8;11,65
1705;"Sakskøbing";"no";0;0;0;54,8;11,65
1706;"Sakskøbing";"no";0;0;0;54,8;11,65
1707;"Sakskøbing";"no";0;0;0;54,8;11,65
1708;"Sakskøbing";"no";0;0;0;54,8;11,65
1709;"Sakskøbing";"no";0;0;0;54,8;11,65
1710;"Sakskøbing";"no";0;0;0;54,8;11,65
1711;"Sakskøbing";"no";0;0;0;54,8;11,65
1712;"Sakskøbing";"no";0;0;0;54,8;11,65
1713;"Sakskøbing";"no";0;0;0;54,8;11,65
1714;"Sakskøbing";"no";0;0;0;54,8;11,65
1715;"Sakskøbing";"no";0;0;0;54,8;11,65
1716;"Sakskøbing";"no";0;0;0;54,8;11,65
1717;"Sakskøbing";"no";0;0;0;54,8;11,65
1718;"Sakskøbing";"no";0;0;0;54,8;11,65
1719;"Sakskøbing";"no";0;0;0;54,8;11,65
1720;"Sakskøbing";"no";0;0;0;54,8;11,65
1721;"Sakskøbing";"no";0;0;0;54,8;11,65
1722;"Sakskøbing";"no";0;0;0;54,8;11,65
1723;"Sakskøbing";"no";0;0;0;54,8;11,65
1724;"Sakskøbing";"no";0;0;0;54,8;11,65
1725;"Sakskøbing";"no";0;0;0;54,8;11,65
1726;"Sakskøbing";"no";0;0;0;54,8;11,65
1727;"Sakskøbing";"no";0;0;0;54,8;11,65
1728;"Sakskøbing";"no";0;0;0;54,8;11,65
1729;"Sakskøbing";"no";0;0;0;54,8;11,65
1730;"Sakskøbing";"no";0;0;0;54,8;11,65
1731;"Sakskøbing";"no";0;0;0;54,8;11,65
1732;"Sakskøbing";"no";0;0;0;54,8;11,65
1733;"Sakskøbing";"no";0;0;0;54,8;11,65
1734;"Sakskøbing";"no";0;0;0;54,8;11,65
1735;"Sakskøbing";"no";0;0;0;54,8;11,65
1736;"Sakskøbing";"no";0;0;0;54,8;11,65
1737;"Sakskøbing";"no";0;0;0;54,8;11,65
1738;"Sakskøbing";"no";0;1;1;54,8;11,65
1739;"Sakskøbing";"no";0;0;0;54,8;11,65
1740;"Sakskøbing";"no";0;0;0;54,8;11,65
1741;"Sakskøbing";"no";0;0;0;54,8;11,65
1742;"Sakskøbing";"no";0;0;0;54,8;11,65
1743;"Sakskøbing";"no";0;0;0;54,8;11,65
1744;"Sakskøbing";"no";0;0;0;54,8;11,65
1745;"Sakskøbing";"no";0;0;0;54,8;11,65
1746;"Sakskøbing";"no";0;0;0;54,8;11,65
1747;"Sakskøbing";"no";0;0;0;54,8;11,65
1748;"Sakskøbing";"no";0;0;0;54,8;11,65
1749;"Sakskøbing";"no";0;0;0;54,8;11,65
1750;"Sakskøbing";"no";0;0;0;54,8;11,65
1751;"Sakskøbing";"no";0;0;0;54,8;11,65
1752;"Sakskøbing";"no";0;0;0;54,8;11,65
1753;"Sakskøbing";"no";0;0;0;54,8;11,65
1754;"Sakskøbing";"no";0;0;0;54,8;11,65
1755;"Sakskøbing";"no";0;0;0;54,8;11,65
1756;"Sakskøbing";"no";0;0;0;54,8;11,65
1757;"Sakskøbing";"no";0;0;0;54,8;11,65
1758;"Sakskøbing";"no";0;0;0;54,8;11,65
1759;"Sakskøbing";"no";0;0;0;54,8;11,65
1760;"Sakskøbing";"no";0;0;0;54,8;11,65
1761;"Sakskøbing";"no";0;0;0;54,8;11,65
1762;"Sakskøbing";"no";0;0;0;54,8;11,65
1763;"Sakskøbing";"no";0;0;0;54,8;11,65
1764;"Sakskøbing";"no";0;0;0;54,8;11,65
1765;"Sakskøbing";"no";0;0;0;54,8;11,65
1766;"Sakskøbing";"no";0;1;1;54,8;11,65
1767;"Sakskøbing";"no";0;0;0;54,8;11,65
1768;"Sakskøbing";"no";0;0;0;54,8;11,65
1769;"Sakskøbing";"no";0;0;0;54,8;11,65
1770;"Sakskøbing";"no";0;0;0;54,8;11,65
1771;"Sakskøbing";"no";0;0;0;54,8;11,65
1772;"Sakskøbing";"no";0;0;0;54,8;11,65
1773;"Sakskøbing";"no";0;0;0;54,8;11,65
1774;"Sakskøbing";"no";0;0;0;54,8;11,65
1775;"Sakskøbing";"no";0;0;0;54,8;11,65
1776;"Sakskøbing";"no";0;0;0;54,8;11,65
1777;"Sakskøbing";"no";0;1;1;54,8;11,65
1778;"Sakskøbing";"no";0;0;0;54,8;11,65
1779;"Sakskøbing";"no";0;0;0;54,8;11,65
1780;"Sakskøbing";"no";0;0;0;54,8;11,65
1781;"Sakskøbing";"no";0;0;0;54,8;11,65
1782;"Sakskøbing";"no";0;0;0;54,8;11,65
1783;"Sakskøbing";"no";0;0;0;54,8;11,65
1784;"Sakskøbing";"no";0;0;0;54,8;11,65
1785;"Sakskøbing";"no";0;0;0;54,8;11,65
1786;"Sakskøbing";"no";0;0;0;54,8;11,65
1787;"Sakskøbing";"no";0;0;0;54,8;11,65
1788;"Sakskøbing";"no";0;0;0;54,8;11,65
1789;"Sakskøbing";"no";0;0;0;54,8;11,65
1790;"Sakskøbing";"no";0;1;1;54,8;11,65
1791;"Sakskøbing";"no";0;0;0;54,8;11,65
1792;"Sakskøbing";"no";0;0;0;54,8;11,65
1793;"Sakskøbing";"no";0;0;0;54,8;11,65
1794;"Sakskøbing";"no";0;0;0;54,8;11,65
1795;"Sakskøbing";"no";0;0;0;54,8;11,65
1796;"Sakskøbing";"no";0;0;0;54,8;11,65
1797;"Sakskøbing";"no";0;0;0;54,8;11,65
1798;"Sakskøbing";"no";0;0;0;54,8;11,65
1799;"Sakskøbing";"no";0;1;1;54,8;11,65
1800;"Sakskøbing";"no";0;2;2;54,8;11,65
1801;"Sakskøbing";"no";0;0;0;54,8;11,65
1802;"Sakskøbing";"no";0;0;0;54,8;11,65
1803;"Sakskøbing";"no";0;1;1;54,8;11,65
1804;"Sakskøbing";"no";0;0;0;54,8;11,65
1805;"Sakskøbing";"no";0;0;0;54,8;11,65
1806;"Sakskøbing";"no";0;0;0;54,8;11,65
1807;"Sakskøbing";"no";0;0;0;54,8;11,65
1808;"Sakskøbing";"no";0;0;0;54,8;11,65
1809;"Sakskøbing";"no";0;0;0;54,8;11,65
1810;"Sakskøbing";"no";0;1;1;54,8;11,65
1811;"Sakskøbing";"no";0;0;0;54,8;11,65
1812;"Sakskøbing";"no";0;0;0;54,8;11,65
1813;"Sakskøbing";"no";0;0;0;54,8;11,65
1814;"Sakskøbing";"no";0;0;0;54,8;11,65
1815;"Sakskøbing";"no";0;0;0;54,8;11,65
1816;"Sakskøbing";"no";0;0;0;54,8;11,65
1817;"Sakskøbing";"no";0;0;0;54,8;11,65
1818;"Sakskøbing";"no";0;0;0;54,8;11,65
1819;"Sakskøbing";"no";0;0;0;54,8;11,65
1820;"Sakskøbing";"no";3;0;3;54,8;11,65
1821;"Sakskøbing";"no";0;1;1;54,8;11,65
1822;"Sakskøbing";"no";0;0;0;54,8;11,65
1823;"Sakskøbing";"no";0;0;0;54,8;11,65
1824;"Sakskøbing";"no";1;0;1;54,8;11,65
1825;"Sakskøbing";"no";1;0;1;54,8;11,65
1826;"Sakskøbing";"no";0;0;0;54,8;11,65
1827;"Sakskøbing";"no";0;2;2;54,8;11,65
1828;"Sakskøbing";"no";1;2;3;54,8;11,65
1829;"Sakskøbing";"no";1;0;1;54,8;11,65
1830;"Sakskøbing";"no";0;0;0;54,8;11,65
1831;"Sakskøbing";"no";0;0;0;54,8;11,65
1832;"Sakskøbing";"no";1;1;2;54,8;11,65
1833;"Sakskøbing";"no";1;0;1;54,8;11,65
1834;"Sakskøbing";"no";0;0;0;54,8;11,65
1835;"Sakskøbing";"no";0;0;0;54,8;11,65
1836;"Sakskøbing";"no";0;1;1;54,8;11,65
1837;"Sakskøbing";"no";1;0;1;54,8;11,65
1838;"Sakskøbing";"no";0;0;0;54,8;11,65
1839;"Sakskøbing";"no";0;2;2;54,8;11,65
1840;"Sakskøbing";"no";0;2;2;54,8;11,65
1841;"Sakskøbing";"no";0;0;0;54,8;11,65
1842;"Sakskøbing";"no";0;0;0;54,8;11,65
1843;"Sakskøbing";"no";0;0;0;54,8;11,65
1844;"Sakskøbing";"no";2;0;2;54,8;11,65
1845;"Sakskøbing";"no";1;3;4;54,8;11,65
1846;"Sakskøbing";"no";2;0;2;54,8;11,65
1847;"Sakskøbing";"no";0;0;0;54,8;11,65
1848;"Sakskøbing";"no";1;0;1;54,8;11,65
1849;"Sakskøbing";"no";0;2;2;54,8;11,65
1850;"Sakskøbing";"no";0;0;0;54,8;11,65
1851;"Sakskøbing";"no";0;0;0;54,8;11,65
1852;"Sakskøbing";"no";0;0;0;54,8;11,65
1853;"Sakskøbing";"no";1;0;1;54,8;11,65
1854;"Sakskøbing";"no";0;0;0;54,8;11,65
1855;"Sakskøbing";"no";0;0;0;54,8;11,65
1856;"Sakskøbing";"no";0;1;1;54,8;11,65
1857;"Sakskøbing";"no";0;0;0;54,8;11,65
1634;"Sønderborg";"no";0;0;0;54,909166;9,807222
1635;"Sønderborg";"no";0;0;0;54,909166;9,807222
1636;"Sønderborg";"no";0;0;0;54,909166;9,807222
1637;"Sønderborg";"no";0;0;0;54,909166;9,807222
1638;"Sønderborg";"no";0;0;0;54,909166;9,807222
1639;"Sønderborg";"no";0;0;0;54,909166;9,807222
1640;"Sønderborg";"no";0;0;0;54,909166;9,807222
1641;"Sønderborg";"no";0;0;0;54,909166;9,807222
1642;"Sønderborg";"no";0;0;0;54,909166;9,807222
1643;"Sønderborg";"no";0;0;0;54,909166;9,807222
1644;"Sønderborg";"no";0;0;0;54,909166;9,807222
1645;"Sønderborg";"no";0;0;0;54,909166;9,807222
1646;"Sønderborg";"no";4;0;4;54,909166;9,807222
1647;"Sønderborg";"no";0;0;0;54,909166;9,807222
1648;"Sønderborg";"no";0;0;0;54,909166;9,807222
1649;"Sønderborg";"no";0;0;0;54,909166;9,807222
1650;"Sønderborg";"no";1;0;1;54,909166;9,807222
1651;"Sønderborg";"no";0;0;0;54,909166;9,807222
1652;"Sønderborg";"no";0;0;0;54,909166;9,807222
1653;"Sønderborg";"no";1;0;1;54,909166;9,807222
1654;"Sønderborg";"no";0;0;0;54,909166;9,807222
1655;"Sønderborg";"no";0;0;0;54,909166;9,807222
1656;"Sønderborg";"no";0;0;0;54,909166;9,807222
1657;"Sønderborg";"no";2;0;2;54,909166;9,807222
1658;"Sønderborg";"no";0;0;0;54,909166;9,807222
1659;"Sønderborg";"no";0;0;0;54,909166;9,807222
1660;"Sønderborg";"no";0;0;0;54,909166;9,807222
1661;"Sønderborg";"no";0;0;0;54,909166;9,807222
1662;"Sønderborg";"no";0;0;0;54,909166;9,807222
1663;"Sønderborg";"no";0;0;0;54,909166;9,807222
1664;"Sønderborg";"no";1;0;1;54,909166;9,807222
1665;"Sønderborg";"no";0;0;0;54,909166;9,807222
1666;"Sønderborg";"no";0;0;0;54,909166;9,807222
1667;"Sønderborg";"no";0;1;1;54,909166;9,807222
1668;"Sønderborg";"no";0;1;1;54,909166;9,807222
1669;"Sønderborg";"no";0;0;0;54,909166;9,807222
1670;"Sønderborg";"no";0;0;0;54,909166;9,807222
1671;"Sønderborg";"no";0;0;0;54,909166;9,807222
1672;"Sønderborg";"no";2;0;2;54,909166;9,807222
1673;"Sønderborg";"no";1;0;1;54,909166;9,807222
1674;"Sønderborg";"no";0;0;0;54,909166;9,807222
1675;"Sønderborg";"no";0;0;0;54,909166;9,807222
1676;"Sønderborg";"no";0;0;0;54,909166;9,807222
1677;"Sønderborg";"no";0;0;0;54,909166;9,807222
1678;"Sønderborg";"no";0;0;0;54,909166;9,807222
1679;"Sønderborg";"no";0;0;0;54,909166;9,807222
1680;"Sønderborg";"no";1;0;1;54,909166;9,807222
1681;"Sønderborg";"no";0;0;0;54,909166;9,807222
1682;"Sønderborg";"no";0;0;0;54,909166;9,807222
1683;"Sønderborg";"no";0;1;1;54,909166;9,807222
1684;"Sønderborg";"no";0;0;0;54,909166;9,807222
1685;"Sønderborg";"no";0;0;0;54,909166;9,807222
1686;"Sønderborg";"no";1;0;1;54,909166;9,807222
1687;"Sønderborg";"no";0;0;0;54,909166;9,807222
1688;"Sønderborg";"no";0;0;0;54,909166;9,807222
1689;"Sønderborg";"no";0;0;0;54,909166;9,807222
1690;"Sønderborg";"no";1;1;2;54,909166;9,807222
1691;"Sønderborg";"no";0;0;0;54,909166;9,807222
1692;"Sønderborg";"no";0;0;0;54,909166;9,807222
1693;"Sønderborg";"no";2;0;2;54,909166;9,807222
1694;"Sønderborg";"no";0;0;0;54,909166;9,807222
1695;"Sønderborg";"no";0;1;1;54,909166;9,807222
1696;"Sønderborg";"no";0;0;0;54,909166;9,807222
1697;"Sønderborg";"no";0;0;0;54,909166;9,807222
1698;"Sønderborg";"no";1;0;1;54,909166;9,807222
1699;"Sønderborg";"no";0;1;1;54,909166;9,807222
1700;"Sønderborg";"no";0;0;0;54,909166;9,807222
1701;"Sønderborg";"no";0;0;0;54,909166;9,807222
1702;"Sønderborg";"no";0;0;0;54,909166;9,807222
1703;"Sønderborg";"no";0;0;0;54,909166;9,807222
1704;"Sønderborg";"no";0;0;0;54,909166;9,807222
1705;"Sønderborg";"no";0;0;0;54,909166;9,807222
1706;"Sønderborg";"no";0;0;0;54,909166;9,807222
1707;"Sønderborg";"no";0;0;0;54,909166;9,807222
1708;"Sønderborg";"no";0;0;0;54,909166;9,807222
1709;"Sønderborg";"no";0;0;0;54,909166;9,807222
1710;"Sønderborg";"no";1;0;1;54,909166;9,807222
1711;"Sønderborg";"no";0;0;0;54,909166;9,807222
1712;"Sønderborg";"no";0;0;0;54,909166;9,807222
1713;"Sønderborg";"no";0;0;0;54,909166;9,807222
1714;"Sønderborg";"no";0;1;1;54,909166;9,807222
1715;"Sønderborg";"no";0;0;0;54,909166;9,807222
1716;"Sønderborg";"no";0;0;0;54,909166;9,807222
1717;"Sønderborg";"no";0;0;0;54,909166;9,807222
1718;"Sønderborg";"no";0;0;0;54,909166;9,807222
1719;"Sønderborg";"no";0;0;0;54,909166;9,807222
1720;"Sønderborg";"no";0;1;1;54,909166;9,807222
1721;"Sønderborg";"no";1;0;1;54,909166;9,807222
1722;"Sønderborg";"no";0;0;0;54,909166;9,807222
1723;"Sønderborg";"no";0;0;0;54,909166;9,807222
1724;"Sønderborg";"no";0;0;0;54,909166;9,807222
1725;"Sønderborg";"no";0;0;0;54,909166;9,807222
1726;"Sønderborg";"no";0;0;0;54,909166;9,807222
1727;"Sønderborg";"no";0;0;0;54,909166;9,807222
1728;"Sønderborg";"no";0;0;0;54,909166;9,807222
1729;"Sønderborg";"no";0;0;0;54,909166;9,807222
1730;"Sønderborg";"no";0;0;0;54,909166;9,807222
1731;"Sønderborg";"no";0;0;0;54,909166;9,807222
1732;"Sønderborg";"no";0;0;0;54,909166;9,807222
1733;"Sønderborg";"no";0;0;0;54,909166;9,807222
1734;"Sønderborg";"no";0;0;0;54,909166;9,807222
1735;"Sønderborg";"no";0;0;0;54,909166;9,807222
1736;"Sønderborg";"no";0;1;1;54,909166;9,807222
1737;"Sønderborg";"no";0;1;1;54,909166;9,807222
1738;"Sønderborg";"no";1;1;2;54,909166;9,807222
1739;"Sønderborg";"no";0;0;0;54,909166;9,807222
1740;"Sønderborg";"no";0;0;0;54,909166;9,807222
1741;"Sønderborg";"no";0;0;0;54,909166;9,807222
1742;"Sønderborg";"no";0;1;1;54,909166;9,807222
1743;"Sønderborg";"no";0;0;0;54,909166;9,807222
1744;"Sønderborg";"no";0;0;0;54,909166;9,807222
1745;"Sønderborg";"no";1;1;2;54,909166;9,807222
1746;"Sønderborg";"no";2;0;2;54,909166;9,807222
1747;"Sønderborg";"no";1;1;2;54,909166;9,807222
1748;"Sønderborg";"no";0;1;1;54,909166;9,807222
1749;"Sønderborg";"no";0;2;2;54,909166;9,807222
1750;"Sønderborg";"no";1;1;2;54,909166;9,807222
1751;"Sønderborg";"no";0;2;2;54,909166;9,807222
1752;"Sønderborg";"no";0;2;2;54,909166;9,807222
1753;"Sønderborg";"no";1;0;1;54,909166;9,807222
1754;"Sønderborg";"no";2;2;4;54,909166;9,807222
1755;"Sønderborg";"no";1;1;2;54,909166;9,807222
1756;"Sønderborg";"no";0;0;0;54,909166;9,807222
1757;"Sønderborg";"no";0;0;0;54,909166;9,807222
1758;"Sønderborg";"no";0;0;0;54,909166;9,807222
1759;"Sønderborg";"no";1;3;4;54,909166;9,807222
1760;"Sønderborg";"no";0;0;0;54,909166;9,807222
1761;"Sønderborg";"no";0;2;2;54,909166;9,807222
1762;"Sønderborg";"no";0;0;0;54,909166;9,807222
1763;"Sønderborg";"no";1;0;1;54,909166;9,807222
1764;"Sønderborg";"no";0;2;2;54,909166;9,807222
1765;"Sønderborg";"no";0;3;3;54,909166;9,807222
1766;"Sønderborg";"no";1;0;1;54,909166;9,807222
1767;"Sønderborg";"no";2;0;2;54,909166;9,807222
1768;"Sønderborg";"no";0;1;1;54,909166;9,807222
1769;"Sønderborg";"no";1;2;3;54,909166;9,807222
1770;"Sønderborg";"no";0;2;2;54,909166;9,807222
1771;"Sønderborg";"no";0;0;0;54,909166;9,807222
1772;"Sønderborg";"no";0;0;0;54,909166;9,807222
1773;"Sønderborg";"no";1;1;2;54,909166;9,807222
1774;"Sønderborg";"no";1;0;1;54,909166;9,807222
1775;"Sønderborg";"no";1;1;2;54,909166;9,807222
1776;"Sønderborg";"no";1;1;2;54,909166;9,807222
1777;"Sønderborg";"no";0;1;1;54,909166;9,807222
1778;"Sønderborg";"no";0;0;0;54,909166;9,807222
1779;"Sønderborg";"no";0;0;0;54,909166;9,807222
1780;"Sønderborg";"no";0;1;1;54,909166;9,807222
1781;"Sønderborg";"no";0;1;1;54,909166;9,807222
1782;"Sønderborg";"no";0;0;0;54,909166;9,807222
1783;"Sønderborg";"no";0;1;1;54,909166;9,807222
1784;"Sønderborg";"no";0;0;0;54,909166;9,807222
1785;"Sønderborg";"no";0;2;2;54,909166;9,807222
1786;"Sønderborg";"no";0;5;5;54,909166;9,807222
1787;"Sønderborg";"no";0;5;5;54,909166;9,807222
1788;"Sønderborg";"no";1;1;2;54,909166;9,807222
1789;"Sønderborg";"no";1;1;2;54,909166;9,807222
1790;"Sønderborg";"no";0;1;1;54,909166;9,807222
1791;"Sønderborg";"no";1;1;2;54,909166;9,807222
1792;"Sønderborg";"no";1;0;1;54,909166;9,807222
1793;"Sønderborg";"no";1;1;2;54,909166;9,807222
1794;"Sønderborg";"no";1;1;2;54,909166;9,807222
1795;"Sønderborg";"no";2;2;4;54,909166;9,807222
1796;"Sønderborg";"no";0;0;0;54,909166;9,807222
1797;"Sønderborg";"no";1;3;4;54,909166;9,807222
1798;"Sønderborg";"no";0;3;3;54,909166;9,807222
1799;"Sønderborg";"no";0;1;1;54,909166;9,807222
1800;"Sønderborg";"no";0;0;0;54,909166;9,807222
1801;"Sønderborg";"no";3;0;3;54,909166;9,807222
1802;"Sønderborg";"no";1;1;2;54,909166;9,807222
1803;"Sønderborg";"no";2;4;6;54,909166;9,807222
1804;"Sønderborg";"no";2;1;3;54,909166;9,807222
1805;"Sønderborg";"no";4;2;6;54,909166;9,807222
1806;"Sønderborg";"no";3;0;3;54,909166;9,807222
1807;"Sønderborg";"no";0;1;1;54,909166;9,807222
1808;"Sønderborg";"no";0;0;0;54,909166;9,807222
1809;"Sønderborg";"no";0;0;0;54,909166;9,807222
1810;"Sønderborg";"no";0;0;0;54,909166;9,807222
1811;"Sønderborg";"no";0;0;0;54,909166;9,807222
1812;"Sønderborg";"no";0;2;2;54,909166;9,807222
1813;"Sønderborg";"no";0;0;0;54,909166;9,807222
1814;"Sønderborg";"no";1;1;2;54,909166;9,807222
1815;"Sønderborg";"no";0;1;1;54,909166;9,807222
1816;"Sønderborg";"no";1;0;1;54,909166;9,807222
1817;"Sønderborg";"no";3;0;3;54,909166;9,807222
1818;"Sønderborg";"no";2;0;2;54,909166;9,807222
1819;"Sønderborg";"no";1;1;2;54,909166;9,807222
1820;"Sønderborg";"no";1;3;4;54,909166;9,807222
1821;"Sønderborg";"no";1;1;2;54,909166;9,807222
1822;"Sønderborg";"no";0;3;3;54,909166;9,807222
1823;"Sønderborg";"no";0;1;1;54,909166;9,807222
1824;"Sønderborg";"no";1;2;3;54,909166;9,807222
1825;"Sønderborg";"no";1;2;3;54,909166;9,807222
1826;"Sønderborg";"no";0;1;1;54,909166;9,807222
1827;"Sønderborg";"no";2;2;4;54,909166;9,807222
1828;"Sønderborg";"no";0;1;1;54,909166;9,807222
1829;"Sønderborg";"no";3;0;3;54,909166;9,807222
1830;"Sønderborg";"no";3;4;7;54,909166;9,807222
1831;"Sønderborg";"no";1;3;4;54,909166;9,807222
1832;"Sønderborg";"no";2;0;2;54,909166;9,807222
1833;"Sønderborg";"no";1;2;3;54,909166;9,807222
1834;"Sønderborg";"no";2;2;4;54,909166;9,807222
1835;"Sønderborg";"no";1;1;2;54,909166;9,807222
1836;"Sønderborg";"no";1;2;3;54,909166;9,807222
1837;"Sønderborg";"no";0;1;1;54,909166;9,807222
1838;"Sønderborg";"no";1;2;3;54,909166;9,807222
1839;"Sønderborg";"no";0;3;3;54,909166;9,807222
1840;"Sønderborg";"no";1;1;2;54,909166;9,807222
1841;"Sønderborg";"no";0;1;1;54,909166;9,807222
1842;"Sønderborg";"no";1;3;4;54,909166;9,807222
1843;"Sønderborg";"no";2;2;4;54,909166;9,807222
1844;"Sønderborg";"no";1;1;2;54,909166;9,807222
1845;"Sønderborg";"no";0;2;2;54,909166;9,807222
1846;"Sønderborg";"no";0;3;3;54,909166;9,807222
1847;"Sønderborg";"no";1;2;3;54,909166;9,807222
1848;"Sønderborg";"no";2;3;5;54,909166;9,807222
1849;"Sønderborg";"no";4;5;9;54,909166;9,807222
1850;"Sønderborg";"no";0;4;4;54,909166;9,807222
1851;"Sønderborg";"no";3;4;7;54,909166;9,807222
1852;"Sønderborg";"no";0;0;0;54,909166;9,807222
1853;"Sønderborg";"no";0;0;0;54,909166;9,807222
1854;"Sønderborg";"no";0;1;1;54,909166;9,807222
1855;"Sønderborg";"no";1;0;1;54,909166;9,807222
1856;"Sønderborg";"no";2;0;2;54,909166;9,807222
1857;"Sønderborg";"no";0;0;0;54,909166;9,807222
1634;"Saltholm";"no";0;0;0;55,639444;12,764166
1635;"Saltholm";"no";0;0;0;55,639444;12,764166
1636;"Saltholm";"no";0;0;0;55,639444;12,764166
1637;"Saltholm";"no";0;0;0;55,639444;12,764166
1638;"Saltholm";"no";0;0;0;55,639444;12,764166
1639;"Saltholm";"no";0;0;0;55,639444;12,764166
1640;"Saltholm";"no";0;0;0;55,639444;12,764166
1641;"Saltholm";"no";0;0;0;55,639444;12,764166
1642;"Saltholm";"no";0;0;0;55,639444;12,764166
1643;"Saltholm";"no";0;0;0;55,639444;12,764166
1644;"Saltholm";"no";0;0;0;55,639444;12,764166
1645;"Saltholm";"no";0;0;0;55,639444;12,764166
1646;"Saltholm";"no";0;0;0;55,639444;12,764166
1647;"Saltholm";"no";1;0;1;55,639444;12,764166
1648;"Saltholm";"no";1;0;1;55,639444;12,764166
1649;"Saltholm";"no";0;0;0;55,639444;12,764166
1650;"Saltholm";"no";0;0;0;55,639444;12,764166
1651;"Saltholm";"no";0;0;0;55,639444;12,764166
1652;"Saltholm";"no";0;0;0;55,639444;12,764166
1653;"Saltholm";"no";0;0;0;55,639444;12,764166
1654;"Saltholm";"no";0;0;0;55,639444;12,764166
1655;"Saltholm";"no";0;0;0;55,639444;12,764166
1656;"Saltholm";"no";0;0;0;55,639444;12,764166
1657;"Saltholm";"no";0;0;0;55,639444;12,764166
1658;"Saltholm";"no";0;0;0;55,639444;12,764166
1659;"Saltholm";"no";0;0;0;55,639444;12,764166
1660;"Saltholm";"no";0;0;0;55,639444;12,764166
1661;"Saltholm";"no";0;0;0;55,639444;12,764166
1662;"Saltholm";"no";0;0;0;55,639444;12,764166
1663;"Saltholm";"no";0;0;0;55,639444;12,764166
1664;"Saltholm";"no";0;0;0;55,639444;12,764166
1665;"Saltholm";"no";0;0;0;55,639444;12,764166
1666;"Saltholm";"no";0;0;0;55,639444;12,764166
1667;"Saltholm";"no";0;0;0;55,639444;12,764166
1668;"Saltholm";"no";0;0;0;55,639444;12,764166
1669;"Saltholm";"no";0;0;0;55,639444;12,764166
1670;"Saltholm";"no";0;0;0;55,639444;12,764166
1671;"Saltholm";"no";0;0;0;55,639444;12,764166
1672;"Saltholm";"no";0;0;0;55,639444;12,764166
1673;"Saltholm";"no";0;0;0;55,639444;12,764166
1674;"Saltholm";"no";0;0;0;55,639444;12,764166
1675;"Saltholm";"no";0;0;0;55,639444;12,764166
1676;"Saltholm";"no";0;0;0;55,639444;12,764166
1677;"Saltholm";"no";0;0;0;55,639444;12,764166
1678;"Saltholm";"no";0;0;0;55,639444;12,764166
1679;"Saltholm";"no";0;0;0;55,639444;12,764166
1680;"Saltholm";"no";0;0;0;55,639444;12,764166
1681;"Saltholm";"no";0;0;0;55,639444;12,764166
1682;"Saltholm";"no";0;0;0;55,639444;12,764166
1683;"Saltholm";"no";0;0;0;55,639444;12,764166
1684;"Saltholm";"no";0;0;0;55,639444;12,764166
1685;"Saltholm";"no";0;0;0;55,639444;12,764166
1686;"Saltholm";"no";0;0;0;55,639444;12,764166
1687;"Saltholm";"no";0;0;0;55,639444;12,764166
1688;"Saltholm";"no";0;0;0;55,639444;12,764166
1689;"Saltholm";"no";0;0;0;55,639444;12,764166
1690;"Saltholm";"no";0;0;0;55,639444;12,764166
1691;"Saltholm";"no";0;0;0;55,639444;12,764166
1692;"Saltholm";"no";0;0;0;55,639444;12,764166
1693;"Saltholm";"no";0;0;0;55,639444;12,764166
1694;"Saltholm";"no";0;0;0;55,639444;12,764166
1695;"Saltholm";"no";0;0;0;55,639444;12,764166
1696;"Saltholm";"no";0;0;0;55,639444;12,764166
1697;"Saltholm";"no";0;0;0;55,639444;12,764166
1698;"Saltholm";"no";0;0;0;55,639444;12,764166
1699;"Saltholm";"no";0;0;0;55,639444;12,764166
1700;"Saltholm";"no";0;0;0;55,639444;12,764166
1701;"Saltholm";"no";0;0;0;55,639444;12,764166
1702;"Saltholm";"no";0;0;0;55,639444;12,764166
1703;"Saltholm";"no";0;0;0;55,639444;12,764166
1704;"Saltholm";"no";0;0;0;55,639444;12,764166
1705;"Saltholm";"no";0;0;0;55,639444;12,764166
1706;"Saltholm";"no";0;0;0;55,639444;12,764166
1707;"Saltholm";"no";0;0;0;55,639444;12,764166
1708;"Saltholm";"no";0;0;0;55,639444;12,764166
1709;"Saltholm";"no";0;0;0;55,639444;12,764166
1710;"Saltholm";"no";0;0;0;55,639444;12,764166
1711;"Saltholm";"no";0;0;0;55,639444;12,764166
1712;"Saltholm";"no";0;0;0;55,639444;12,764166
1713;"Saltholm";"no";0;0;0;55,639444;12,764166
1714;"Saltholm";"no";0;0;0;55,639444;12,764166
1715;"Saltholm";"no";0;0;0;55,639444;12,764166
1716;"Saltholm";"no";0;0;0;55,639444;12,764166
1717;"Saltholm";"no";0;0;0;55,639444;12,764166
1718;"Saltholm";"no";0;0;0;55,639444;12,764166
1719;"Saltholm";"no";0;0;0;55,639444;12,764166
1720;"Saltholm";"no";0;0;0;55,639444;12,764166
1721;"Saltholm";"no";0;0;0;55,639444;12,764166
1722;"Saltholm";"no";0;0;0;55,639444;12,764166
1723;"Saltholm";"no";0;0;0;55,639444;12,764166
1724;"Saltholm";"no";0;0;0;55,639444;12,764166
1725;"Saltholm";"no";0;0;0;55,639444;12,764166
1726;"Saltholm";"no";0;0;0;55,639444;12,764166
1727;"Saltholm";"no";0;0;0;55,639444;12,764166
1728;"Saltholm";"no";0;0;0;55,639444;12,764166
1729;"Saltholm";"no";0;0;0;55,639444;12,764166
1730;"Saltholm";"no";0;0;0;55,639444;12,764166
1731;"Saltholm";"no";0;0;0;55,639444;12,764166
1732;"Saltholm";"no";0;0;0;55,639444;12,764166
1733;"Saltholm";"no";0;0;0;55,639444;12,764166
1734;"Saltholm";"no";0;0;0;55,639444;12,764166
1735;"Saltholm";"no";0;0;0;55,639444;12,764166
1736;"Saltholm";"no";0;0;0;55,639444;12,764166
1737;"Saltholm";"no";0;0;0;55,639444;12,764166
1738;"Saltholm";"no";0;0;0;55,639444;12,764166
1739;"Saltholm";"no";0;0;0;55,639444;12,764166
1740;"Saltholm";"no";0;0;0;55,639444;12,764166
1741;"Saltholm";"no";0;0;0;55,639444;12,764166
1742;"Saltholm";"no";0;0;0;55,639444;12,764166
1743;"Saltholm";"no";0;0;0;55,639444;12,764166
1744;"Saltholm";"no";0;0;0;55,639444;12,764166
1745;"Saltholm";"no";0;0;0;55,639444;12,764166
1746;"Saltholm";"no";0;0;0;55,639444;12,764166
1747;"Saltholm";"no";0;0;0;55,639444;12,764166
1748;"Saltholm";"no";0;0;0;55,639444;12,764166
1749;"Saltholm";"no";0;0;0;55,639444;12,764166
1750;"Saltholm";"no";0;0;0;55,639444;12,764166
1751;"Saltholm";"no";0;0;0;55,639444;12,764166
1752;"Saltholm";"no";0;0;0;55,639444;12,764166
1753;"Saltholm";"no";0;0;0;55,639444;12,764166
1754;"Saltholm";"no";0;0;0;55,639444;12,764166
1755;"Saltholm";"no";0;0;0;55,639444;12,764166
1756;"Saltholm";"no";0;0;0;55,639444;12,764166
1757;"Saltholm";"no";0;0;0;55,639444;12,764166
1758;"Saltholm";"no";0;0;0;55,639444;12,764166
1759;"Saltholm";"no";0;0;0;55,639444;12,764166
1760;"Saltholm";"no";0;0;0;55,639444;12,764166
1761;"Saltholm";"no";0;0;0;55,639444;12,764166
1762;"Saltholm";"no";0;0;0;55,639444;12,764166
1763;"Saltholm";"no";0;0;0;55,639444;12,764166
1764;"Saltholm";"no";0;0;0;55,639444;12,764166
1765;"Saltholm";"no";0;0;0;55,639444;12,764166
1766;"Saltholm";"no";0;0;0;55,639444;12,764166
1767;"Saltholm";"no";0;0;0;55,639444;12,764166
1768;"Saltholm";"no";0;0;0;55,639444;12,764166
1769;"Saltholm";"no";0;0;0;55,639444;12,764166
1770;"Saltholm";"no";0;0;0;55,639444;12,764166
1771;"Saltholm";"no";0;0;0;55,639444;12,764166
1772;"Saltholm";"no";0;0;0;55,639444;12,764166
1773;"Saltholm";"no";0;0;0;55,639444;12,764166
1774;"Saltholm";"no";0;0;0;55,639444;12,764166
1775;"Saltholm";"no";0;0;0;55,639444;12,764166
1776;"Saltholm";"no";0;0;0;55,639444;12,764166
1777;"Saltholm";"no";0;0;0;55,639444;12,764166
1778;"Saltholm";"no";0;0;0;55,639444;12,764166
1779;"Saltholm";"no";0;0;0;55,639444;12,764166
1780;"Saltholm";"no";0;0;0;55,639444;12,764166
1781;"Saltholm";"no";0;0;0;55,639444;12,764166
1782;"Saltholm";"no";0;0;0;55,639444;12,764166
1783;"Saltholm";"no";0;0;0;55,639444;12,764166
1784;"Saltholm";"no";0;0;0;55,639444;12,764166
1785;"Saltholm";"no";0;0;0;55,639444;12,764166
1786;"Saltholm";"no";0;0;0;55,639444;12,764166
1787;"Saltholm";"no";0;0;0;55,639444;12,764166
1788;"Saltholm";"no";0;0;0;55,639444;12,764166
1789;"Saltholm";"no";0;0;0;55,639444;12,764166
1790;"Saltholm";"no";0;0;0;55,639444;12,764166
1791;"Saltholm";"no";0;0;0;55,639444;12,764166
1792;"Saltholm";"no";0;0;0;55,639444;12,764166
1793;"Saltholm";"no";0;0;0;55,639444;12,764166
1794;"Saltholm";"no";0;0;0;55,639444;12,764166
1795;"Saltholm";"no";0;0;0;55,639444;12,764166
1796;"Saltholm";"no";0;0;0;55,639444;12,764166
1797;"Saltholm";"no";0;0;0;55,639444;12,764166
1798;"Saltholm";"no";0;0;0;55,639444;12,764166
1799;"Saltholm";"no";0;0;0;55,639444;12,764166
1800;"Saltholm";"no";0;0;0;55,639444;12,764166
1801;"Saltholm";"no";0;0;0;55,639444;12,764166
1802;"Saltholm";"no";0;0;0;55,639444;12,764166
1803;"Saltholm";"no";0;0;0;55,639444;12,764166
1804;"Saltholm";"no";0;0;0;55,639444;12,764166
1805;"Saltholm";"no";0;0;0;55,639444;12,764166
1806;"Saltholm";"no";0;0;0;55,639444;12,764166
1807;"Saltholm";"no";0;0;0;55,639444;12,764166
1808;"Saltholm";"no";0;0;0;55,639444;12,764166
1809;"Saltholm";"no";0;0;0;55,639444;12,764166
1810;"Saltholm";"no";0;0;0;55,639444;12,764166
1811;"Saltholm";"no";0;0;0;55,639444;12,764166
1812;"Saltholm";"no";0;0;0;55,639444;12,764166
1813;"Saltholm";"no";0;0;0;55,639444;12,764166
1814;"Saltholm";"no";0;0;0;55,639444;12,764166
1815;"Saltholm";"no";0;0;0;55,639444;12,764166
1816;"Saltholm";"no";0;0;0;55,639444;12,764166
1817;"Saltholm";"no";0;0;0;55,639444;12,764166
1818;"Saltholm";"no";0;0;0;55,639444;12,764166
1819;"Saltholm";"no";0;0;0;55,639444;12,764166
1820;"Saltholm";"no";0;0;0;55,639444;12,764166
1821;"Saltholm";"no";0;0;0;55,639444;12,764166
1822;"Saltholm";"no";0;0;0;55,639444;12,764166
1823;"Saltholm";"no";0;0;0;55,639444;12,764166
1824;"Saltholm";"no";0;0;0;55,639444;12,764166
1825;"Saltholm";"no";0;0;0;55,639444;12,764166
1826;"Saltholm";"no";0;0;0;55,639444;12,764166
1827;"Saltholm";"no";0;0;0;55,639444;12,764166
1828;"Saltholm";"no";0;0;0;55,639444;12,764166
1829;"Saltholm";"no";0;0;0;55,639444;12,764166
1830;"Saltholm";"no";0;0;0;55,639444;12,764166
1831;"Saltholm";"no";0;0;0;55,639444;12,764166
1832;"Saltholm";"no";0;0;0;55,639444;12,764166
1833;"Saltholm";"no";0;0;0;55,639444;12,764166
1834;"Saltholm";"no";0;0;0;55,639444;12,764166
1835;"Saltholm";"no";0;0;0;55,639444;12,764166
1836;"Saltholm";"no";0;0;0;55,639444;12,764166
1837;"Saltholm";"no";0;0;0;55,639444;12,764166
1838;"Saltholm";"no";0;0;0;55,639444;12,764166
1839;"Saltholm";"no";0;0;0;55,639444;12,764166
1840;"Saltholm";"no";0;0;0;55,639444;12,764166
1841;"Saltholm";"no";0;0;0;55,639444;12,764166
1842;"Saltholm";"no";0;0;0;55,639444;12,764166
1843;"Saltholm";"no";0;0;0;55,639444;12,764166
1844;"Saltholm";"no";0;1;1;55,639444;12,764166
1845;"Saltholm";"no";0;0;0;55,639444;12,764166
1846;"Saltholm";"no";0;0;0;55,639444;12,764166
1847;"Saltholm";"no";0;0;0;55,639444;12,764166
1848;"Saltholm";"no";0;0;0;55,639444;12,764166
1849;"Saltholm";"no";0;0;0;55,639444;12,764166
1850;"Saltholm";"no";0;0;0;55,639444;12,764166
1851;"Saltholm";"no";0;0;0;55,639444;12,764166
1852;"Saltholm";"no";0;0;0;55,639444;12,764166
1853;"Saltholm";"no";0;0;0;55,639444;12,764166
1854;"Saltholm";"no";0;0;0;55,639444;12,764166
1855;"Saltholm";"no";0;0;0;55,639444;12,764166
1856;"Saltholm";"no";0;0;0;55,639444;12,764166
1857;"Saltholm";"no";0;0;0;55,639444;12,764166
1634;"Fjellerup";"no";0;0;0;56,5;10,6
1635;"Fjellerup";"no";0;0;0;56,5;10,6
1636;"Fjellerup";"no";0;0;0;56,5;10,6
1637;"Fjellerup";"no";0;0;0;56,5;10,6
1638;"Fjellerup";"no";0;0;0;56,5;10,6
1639;"Fjellerup";"no";0;0;0;56,5;10,6
1640;"Fjellerup";"no";0;0;0;56,5;10,6
1641;"Fjellerup";"no";0;0;0;56,5;10,6
1642;"Fjellerup";"no";0;0;0;56,5;10,6
1643;"Fjellerup";"no";0;0;0;56,5;10,6
1644;"Fjellerup";"no";0;0;0;56,5;10,6
1645;"Fjellerup";"no";0;0;0;56,5;10,6
1646;"Fjellerup";"no";0;0;0;56,5;10,6
1647;"Fjellerup";"no";0;0;0;56,5;10,6
1648;"Fjellerup";"no";1;0;1;56,5;10,6
1649;"Fjellerup";"no";0;0;0;56,5;10,6
1650;"Fjellerup";"no";0;0;0;56,5;10,6
1651;"Fjellerup";"no";0;0;0;56,5;10,6
1652;"Fjellerup";"no";0;0;0;56,5;10,6
1653;"Fjellerup";"no";0;0;0;56,5;10,6
1654;"Fjellerup";"no";0;0;0;56,5;10,6
1655;"Fjellerup";"no";0;0;0;56,5;10,6
1656;"Fjellerup";"no";0;0;0;56,5;10,6
1657;"Fjellerup";"no";0;0;0;56,5;10,6
1658;"Fjellerup";"no";0;0;0;56,5;10,6
1659;"Fjellerup";"no";0;0;0;56,5;10,6
1660;"Fjellerup";"no";0;0;0;56,5;10,6
1661;"Fjellerup";"no";0;0;0;56,5;10,6
1662;"Fjellerup";"no";0;0;0;56,5;10,6
1663;"Fjellerup";"no";0;0;0;56,5;10,6
1664;"Fjellerup";"no";0;0;0;56,5;10,6
1665;"Fjellerup";"no";0;0;0;56,5;10,6
1666;"Fjellerup";"no";0;0;0;56,5;10,6
1667;"Fjellerup";"no";0;0;0;56,5;10,6
1668;"Fjellerup";"no";0;0;0;56,5;10,6
1669;"Fjellerup";"no";0;0;0;56,5;10,6
1670;"Fjellerup";"no";0;0;0;56,5;10,6
1671;"Fjellerup";"no";0;0;0;56,5;10,6
1672;"Fjellerup";"no";0;0;0;56,5;10,6
1673;"Fjellerup";"no";0;0;0;56,5;10,6
1674;"Fjellerup";"no";0;0;0;56,5;10,6
1675;"Fjellerup";"no";0;0;0;56,5;10,6
1676;"Fjellerup";"no";0;0;0;56,5;10,6
1677;"Fjellerup";"no";0;0;0;56,5;10,6
1678;"Fjellerup";"no";0;0;0;56,5;10,6
1679;"Fjellerup";"no";1;0;1;56,5;10,6
1680;"Fjellerup";"no";0;0;0;56,5;10,6
1681;"Fjellerup";"no";0;0;0;56,5;10,6
1682;"Fjellerup";"no";0;0;0;56,5;10,6
1683;"Fjellerup";"no";0;0;0;56,5;10,6
1684;"Fjellerup";"no";0;0;0;56,5;10,6
1685;"Fjellerup";"no";0;0;0;56,5;10,6
1686;"Fjellerup";"no";0;0;0;56,5;10,6
1687;"Fjellerup";"no";0;0;0;56,5;10,6
1688;"Fjellerup";"no";0;0;0;56,5;10,6
1689;"Fjellerup";"no";0;0;0;56,5;10,6
1690;"Fjellerup";"no";0;0;0;56,5;10,6
1691;"Fjellerup";"no";0;0;0;56,5;10,6
1692;"Fjellerup";"no";0;0;0;56,5;10,6
1693;"Fjellerup";"no";0;0;0;56,5;10,6
1694;"Fjellerup";"no";0;0;0;56,5;10,6
1695;"Fjellerup";"no";0;0;0;56,5;10,6
1696;"Fjellerup";"no";0;0;0;56,5;10,6
1697;"Fjellerup";"no";0;0;0;56,5;10,6
1698;"Fjellerup";"no";0;0;0;56,5;10,6
1699;"Fjellerup";"no";0;0;0;56,5;10,6
1700;"Fjellerup";"no";0;0;0;56,5;10,6
1701;"Fjellerup";"no";0;0;0;56,5;10,6
1702;"Fjellerup";"no";0;0;0;56,5;10,6
1703;"Fjellerup";"no";0;0;0;56,5;10,6
1704;"Fjellerup";"no";0;0;0;56,5;10,6
1705;"Fjellerup";"no";0;0;0;56,5;10,6
1706;"Fjellerup";"no";0;0;0;56,5;10,6
1707;"Fjellerup";"no";0;0;0;56,5;10,6
1708;"Fjellerup";"no";0;0;0;56,5;10,6
1709;"Fjellerup";"no";0;0;0;56,5;10,6
1710;"Fjellerup";"no";0;0;0;56,5;10,6
1711;"Fjellerup";"no";0;0;0;56,5;10,6
1712;"Fjellerup";"no";0;0;0;56,5;10,6
1713;"Fjellerup";"no";0;0;0;56,5;10,6
1714;"Fjellerup";"no";0;0;0;56,5;10,6
1715;"Fjellerup";"no";0;0;0;56,5;10,6
1716;"Fjellerup";"no";0;0;0;56,5;10,6
1717;"Fjellerup";"no";0;0;0;56,5;10,6
1718;"Fjellerup";"no";0;0;0;56,5;10,6
1719;"Fjellerup";"no";0;0;0;56,5;10,6
1720;"Fjellerup";"no";0;0;0;56,5;10,6
1721;"Fjellerup";"no";0;0;0;56,5;10,6
1722;"Fjellerup";"no";0;0;0;56,5;10,6
1723;"Fjellerup";"no";0;0;0;56,5;10,6
1724;"Fjellerup";"no";0;0;0;56,5;10,6
1725;"Fjellerup";"no";0;0;0;56,5;10,6
1726;"Fjellerup";"no";0;0;0;56,5;10,6
1727;"Fjellerup";"no";0;0;0;56,5;10,6
1728;"Fjellerup";"no";0;0;0;56,5;10,6
1729;"Fjellerup";"no";0;0;0;56,5;10,6
1730;"Fjellerup";"no";0;0;0;56,5;10,6
1731;"Fjellerup";"no";0;0;0;56,5;10,6
1732;"Fjellerup";"no";0;0;0;56,5;10,6
1733;"Fjellerup";"no";0;0;0;56,5;10,6
1734;"Fjellerup";"no";0;0;0;56,5;10,6
1735;"Fjellerup";"no";0;0;0;56,5;10,6
1736;"Fjellerup";"no";0;0;0;56,5;10,6
1737;"Fjellerup";"no";0;0;0;56,5;10,6
1738;"Fjellerup";"no";0;0;0;56,5;10,6
1739;"Fjellerup";"no";0;0;0;56,5;10,6
1740;"Fjellerup";"no";0;0;0;56,5;10,6
1741;"Fjellerup";"no";0;0;0;56,5;10,6
1742;"Fjellerup";"no";0;0;0;56,5;10,6
1743;"Fjellerup";"no";0;0;0;56,5;10,6
1744;"Fjellerup";"no";0;0;0;56,5;10,6
1745;"Fjellerup";"no";0;0;0;56,5;10,6
1746;"Fjellerup";"no";0;0;0;56,5;10,6
1747;"Fjellerup";"no";0;0;0;56,5;10,6
1748;"Fjellerup";"no";0;0;0;56,5;10,6
1749;"Fjellerup";"no";0;0;0;56,5;10,6
1750;"Fjellerup";"no";0;0;0;56,5;10,6
1751;"Fjellerup";"no";0;0;0;56,5;10,6
1752;"Fjellerup";"no";0;0;0;56,5;10,6
1753;"Fjellerup";"no";0;0;0;56,5;10,6
1754;"Fjellerup";"no";0;0;0;56,5;10,6
1755;"Fjellerup";"no";0;0;0;56,5;10,6
1756;"Fjellerup";"no";0;0;0;56,5;10,6
1757;"Fjellerup";"no";0;0;0;56,5;10,6
1758;"Fjellerup";"no";0;0;0;56,5;10,6
1759;"Fjellerup";"no";0;0;0;56,5;10,6
1760;"Fjellerup";"no";0;0;0;56,5;10,6
1761;"Fjellerup";"no";0;0;0;56,5;10,6
1762;"Fjellerup";"no";0;0;0;56,5;10,6
1763;"Fjellerup";"no";0;0;0;56,5;10,6
1764;"Fjellerup";"no";0;0;0;56,5;10,6
1765;"Fjellerup";"no";0;0;0;56,5;10,6
1766;"Fjellerup";"no";0;0;0;56,5;10,6
1767;"Fjellerup";"no";0;0;0;56,5;10,6
1768;"Fjellerup";"no";0;0;0;56,5;10,6
1769;"Fjellerup";"no";0;0;0;56,5;10,6
1770;"Fjellerup";"no";0;0;0;56,5;10,6
1771;"Fjellerup";"no";0;0;0;56,5;10,6
1772;"Fjellerup";"no";0;0;0;56,5;10,6
1773;"Fjellerup";"no";0;0;0;56,5;10,6
1774;"Fjellerup";"no";0;0;0;56,5;10,6
1775;"Fjellerup";"no";0;0;0;56,5;10,6
1776;"Fjellerup";"no";0;0;0;56,5;10,6
1777;"Fjellerup";"no";0;0;0;56,5;10,6
1778;"Fjellerup";"no";0;0;0;56,5;10,6
1779;"Fjellerup";"no";0;0;0;56,5;10,6
1780;"Fjellerup";"no";0;0;0;56,5;10,6
1781;"Fjellerup";"no";0;0;0;56,5;10,6
1782;"Fjellerup";"no";0;0;0;56,5;10,6
1783;"Fjellerup";"no";0;0;0;56,5;10,6
1784;"Fjellerup";"no";0;0;0;56,5;10,6
1785;"Fjellerup";"no";0;0;0;56,5;10,6
1786;"Fjellerup";"no";0;0;0;56,5;10,6
1787;"Fjellerup";"no";0;0;0;56,5;10,6
1788;"Fjellerup";"no";0;0;0;56,5;10,6
1789;"Fjellerup";"no";0;0;0;56,5;10,6
1790;"Fjellerup";"no";0;0;0;56,5;10,6
1791;"Fjellerup";"no";0;0;0;56,5;10,6
1792;"Fjellerup";"no";0;0;0;56,5;10,6
1793;"Fjellerup";"no";0;0;0;56,5;10,6
1794;"Fjellerup";"no";0;0;0;56,5;10,6
1795;"Fjellerup";"no";0;0;0;56,5;10,6
1796;"Fjellerup";"no";0;0;0;56,5;10,6
1797;"Fjellerup";"no";0;0;0;56,5;10,6
1798;"Fjellerup";"no";0;0;0;56,5;10,6
1799;"Fjellerup";"no";0;0;0;56,5;10,6
1800;"Fjellerup";"no";0;0;0;56,5;10,6
1801;"Fjellerup";"no";0;0;0;56,5;10,6
1802;"Fjellerup";"no";0;0;0;56,5;10,6
1803;"Fjellerup";"no";0;0;0;56,5;10,6
1804;"Fjellerup";"no";0;0;0;56,5;10,6
1805;"Fjellerup";"no";0;0;0;56,5;10,6
1806;"Fjellerup";"no";0;0;0;56,5;10,6
1807;"Fjellerup";"no";0;0;0;56,5;10,6
1808;"Fjellerup";"no";0;0;0;56,5;10,6
1809;"Fjellerup";"no";0;0;0;56,5;10,6
1810;"Fjellerup";"no";0;0;0;56,5;10,6
1811;"Fjellerup";"no";0;0;0;56,5;10,6
1812;"Fjellerup";"no";0;0;0;56,5;10,6
1813;"Fjellerup";"no";0;0;0;56,5;10,6
1814;"Fjellerup";"no";0;0;0;56,5;10,6
1815;"Fjellerup";"no";0;0;0;56,5;10,6
1816;"Fjellerup";"no";0;0;0;56,5;10,6
1817;"Fjellerup";"no";0;0;0;56,5;10,6
1818;"Fjellerup";"no";0;0;0;56,5;10,6
1819;"Fjellerup";"no";0;0;0;56,5;10,6
1820;"Fjellerup";"no";0;0;0;56,5;10,6
1821;"Fjellerup";"no";0;0;0;56,5;10,6
1822;"Fjellerup";"no";0;0;0;56,5;10,6
1823;"Fjellerup";"no";0;0;0;56,5;10,6
1824;"Fjellerup";"no";0;0;0;56,5;10,6
1825;"Fjellerup";"no";0;0;0;56,5;10,6
1826;"Fjellerup";"no";0;0;0;56,5;10,6
1827;"Fjellerup";"no";0;0;0;56,5;10,6
1828;"Fjellerup";"no";0;0;0;56,5;10,6
1829;"Fjellerup";"no";0;0;0;56,5;10,6
1830;"Fjellerup";"no";0;0;0;56,5;10,6
1831;"Fjellerup";"no";0;0;0;56,5;10,6
1832;"Fjellerup";"no";0;0;0;56,5;10,6
1833;"Fjellerup";"no";0;0;0;56,5;10,6
1834;"Fjellerup";"no";0;0;0;56,5;10,6
1835;"Fjellerup";"no";0;0;0;56,5;10,6
1836;"Fjellerup";"no";0;0;0;56,5;10,6
1837;"Fjellerup";"no";0;0;0;56,5;10,6
1838;"Fjellerup";"no";0;0;0;56,5;10,6
1839;"Fjellerup";"no";0;0;0;56,5;10,6
1840;"Fjellerup";"no";0;0;0;56,5;10,6
1841;"Fjellerup";"no";0;0;0;56,5;10,6
1842;"Fjellerup";"no";0;0;0;56,5;10,6
1843;"Fjellerup";"no";0;0;0;56,5;10,6
1844;"Fjellerup";"no";0;0;0;56,5;10,6
1845;"Fjellerup";"no";0;0;0;56,5;10,6
1846;"Fjellerup";"no";0;0;0;56,5;10,6
1847;"Fjellerup";"no";0;0;0;56,5;10,6
1848;"Fjellerup";"no";0;0;0;56,5;10,6
1849;"Fjellerup";"no";0;0;0;56,5;10,6
1850;"Fjellerup";"no";0;0;0;56,5;10,6
1851;"Fjellerup";"no";0;0;0;56,5;10,6
1852;"Fjellerup";"no";0;0;0;56,5;10,6
1853;"Fjellerup";"no";0;0;0;56,5;10,6
1854;"Fjellerup";"no";0;0;0;56,5;10,6
1855;"Fjellerup";"no";0;0;0;56,5;10,6
1856;"Fjellerup";"no";0;0;0;56,5;10,6
1857;"Fjellerup";"no";0;0;0;56,5;10,6
1634;"Selandt";"no";0;0;0;55,49;11,76
1635;"Selandt";"no";0;0;0;55,49;11,76
1636;"Selandt";"no";0;0;0;55,49;11,76
1637;"Selandt";"no";0;0;0;55,49;11,76
1638;"Selandt";"no";0;0;0;55,49;11,76
1639;"Selandt";"no";0;0;0;55,49;11,76
1640;"Selandt";"no";0;0;0;55,49;11,76
1641;"Selandt";"no";0;0;0;55,49;11,76
1642;"Selandt";"no";0;0;0;55,49;11,76
1643;"Selandt";"no";0;0;0;55,49;11,76
1644;"Selandt";"no";0;0;0;55,49;11,76
1645;"Selandt";"no";0;0;0;55,49;11,76
1646;"Selandt";"no";0;0;0;55,49;11,76
1647;"Selandt";"no";0;0;0;55,49;11,76
1648;"Selandt";"no";1;0;1;55,49;11,76
1649;"Selandt";"no";0;0;0;55,49;11,76
1650;"Selandt";"no";0;0;0;55,49;11,76
1651;"Selandt";"no";0;0;0;55,49;11,76
1652;"Selandt";"no";0;0;0;55,49;11,76
1653;"Selandt";"no";1;0;1;55,49;11,76
1654;"Selandt";"no";0;0;0;55,49;11,76
1655;"Selandt";"no";0;0;0;55,49;11,76
1656;"Selandt";"no";0;0;0;55,49;11,76
1657;"Selandt";"no";0;0;0;55,49;11,76
1658;"Selandt";"no";0;0;0;55,49;11,76
1659;"Selandt";"no";0;0;0;55,49;11,76
1660;"Selandt";"no";0;0;0;55,49;11,76
1661;"Selandt";"no";0;0;0;55,49;11,76
1662;"Selandt";"no";0;0;0;55,49;11,76
1663;"Selandt";"no";0;0;0;55,49;11,76
1664;"Selandt";"no";0;0;0;55,49;11,76
1665;"Selandt";"no";0;0;0;55,49;11,76
1666;"Selandt";"no";0;0;0;55,49;11,76
1667;"Selandt";"no";0;0;0;55,49;11,76
1668;"Selandt";"no";0;0;0;55,49;11,76
1669;"Selandt";"no";0;0;0;55,49;11,76
1670;"Selandt";"no";0;0;0;55,49;11,76
1671;"Selandt";"no";0;0;0;55,49;11,76
1672;"Selandt";"no";0;0;0;55,49;11,76
1673;"Selandt";"no";0;0;0;55,49;11,76
1674;"Selandt";"no";0;0;0;55,49;11,76
1675;"Selandt";"no";0;0;0;55,49;11,76
1676;"Selandt";"no";0;0;0;55,49;11,76
1677;"Selandt";"no";0;0;0;55,49;11,76
1678;"Selandt";"no";0;0;0;55,49;11,76
1679;"Selandt";"no";0;0;0;55,49;11,76
1680;"Selandt";"no";0;0;0;55,49;11,76
1681;"Selandt";"no";0;0;0;55,49;11,76
1682;"Selandt";"no";0;0;0;55,49;11,76
1683;"Selandt";"no";0;0;0;55,49;11,76
1684;"Selandt";"no";0;0;0;55,49;11,76
1685;"Selandt";"no";0;0;0;55,49;11,76
1686;"Selandt";"no";0;0;0;55,49;11,76
1687;"Selandt";"no";0;0;0;55,49;11,76
1688;"Selandt";"no";0;0;0;55,49;11,76
1689;"Selandt";"no";0;0;0;55,49;11,76
1690;"Selandt";"no";0;0;0;55,49;11,76
1691;"Selandt";"no";0;0;0;55,49;11,76
1692;"Selandt";"no";0;0;0;55,49;11,76
1693;"Selandt";"no";0;0;0;55,49;11,76
1694;"Selandt";"no";0;0;0;55,49;11,76
1695;"Selandt";"no";0;0;0;55,49;11,76
1696;"Selandt";"no";0;0;0;55,49;11,76
1697;"Selandt";"no";0;0;0;55,49;11,76
1698;"Selandt";"no";0;0;0;55,49;11,76
1699;"Selandt";"no";0;0;0;55,49;11,76
1700;"Selandt";"no";0;0;0;55,49;11,76
1701;"Selandt";"no";0;0;0;55,49;11,76
1702;"Selandt";"no";0;0;0;55,49;11,76
1703;"Selandt";"no";0;0;0;55,49;11,76
1704;"Selandt";"no";0;0;0;55,49;11,76
1705;"Selandt";"no";0;0;0;55,49;11,76
1706;"Selandt";"no";0;0;0;55,49;11,76
1707;"Selandt";"no";0;0;0;55,49;11,76
1708;"Selandt";"no";0;0;0;55,49;11,76
1709;"Selandt";"no";0;0;0;55,49;11,76
1710;"Selandt";"no";0;0;0;55,49;11,76
1711;"Selandt";"no";0;0;0;55,49;11,76
1712;"Selandt";"no";0;0;0;55,49;11,76
1713;"Selandt";"no";0;0;0;55,49;11,76
1714;"Selandt";"no";0;0;0;55,49;11,76
1715;"Selandt";"no";0;0;0;55,49;11,76
1716;"Selandt";"no";0;0;0;55,49;11,76
1717;"Selandt";"no";0;0;0;55,49;11,76
1718;"Selandt";"no";0;0;0;55,49;11,76
1719;"Selandt";"no";0;0;0;55,49;11,76
1720;"Selandt";"no";0;0;0;55,49;11,76
1721;"Selandt";"no";0;0;0;55,49;11,76
1722;"Selandt";"no";0;0;0;55,49;11,76
1723;"Selandt";"no";0;0;0;55,49;11,76
1724;"Selandt";"no";0;0;0;55,49;11,76
1725;"Selandt";"no";0;0;0;55,49;11,76
1726;"Selandt";"no";0;0;0;55,49;11,76
1727;"Selandt";"no";0;0;0;55,49;11,76
1728;"Selandt";"no";0;0;0;55,49;11,76
1729;"Selandt";"no";0;0;0;55,49;11,76
1730;"Selandt";"no";0;0;0;55,49;11,76
1731;"Selandt";"no";0;0;0;55,49;11,76
1732;"Selandt";"no";0;0;0;55,49;11,76
1733;"Selandt";"no";0;0;0;55,49;11,76
1734;"Selandt";"no";0;0;0;55,49;11,76
1735;"Selandt";"no";0;0;0;55,49;11,76
1736;"Selandt";"no";0;0;0;55,49;11,76
1737;"Selandt";"no";0;0;0;55,49;11,76
1738;"Selandt";"no";0;0;0;55,49;11,76
1739;"Selandt";"no";0;0;0;55,49;11,76
1740;"Selandt";"no";0;0;0;55,49;11,76
1741;"Selandt";"no";0;0;0;55,49;11,76
1742;"Selandt";"no";0;0;0;55,49;11,76
1743;"Selandt";"no";0;0;0;55,49;11,76
1744;"Selandt";"no";0;0;0;55,49;11,76
1745;"Selandt";"no";0;0;0;55,49;11,76
1746;"Selandt";"no";0;0;0;55,49;11,76
1747;"Selandt";"no";0;0;0;55,49;11,76
1748;"Selandt";"no";0;0;0;55,49;11,76
1749;"Selandt";"no";0;0;0;55,49;11,76
1750;"Selandt";"no";0;0;0;55,49;11,76
1751;"Selandt";"no";0;0;0;55,49;11,76
1752;"Selandt";"no";0;0;0;55,49;11,76
1753;"Selandt";"no";0;0;0;55,49;11,76
1754;"Selandt";"no";0;0;0;55,49;11,76
1755;"Selandt";"no";0;0;0;55,49;11,76
1756;"Selandt";"no";0;0;0;55,49;11,76
1757;"Selandt";"no";0;0;0;55,49;11,76
1758;"Selandt";"no";0;0;0;55,49;11,76
1759;"Selandt";"no";0;0;0;55,49;11,76
1760;"Selandt";"no";0;0;0;55,49;11,76
1761;"Selandt";"no";0;0;0;55,49;11,76
1762;"Selandt";"no";0;0;0;55,49;11,76
1763;"Selandt";"no";0;0;0;55,49;11,76
1764;"Selandt";"no";0;0;0;55,49;11,76
1765;"Selandt";"no";0;0;0;55,49;11,76
1766;"Selandt";"no";0;0;0;55,49;11,76
1767;"Selandt";"no";0;0;0;55,49;11,76
1768;"Selandt";"no";0;0;0;55,49;11,76
1769;"Selandt";"no";0;0;0;55,49;11,76
1770;"Selandt";"no";0;0;0;55,49;11,76
1771;"Selandt";"no";0;0;0;55,49;11,76
1772;"Selandt";"no";0;0;0;55,49;11,76
1773;"Selandt";"no";0;0;0;55,49;11,76
1774;"Selandt";"no";0;0;0;55,49;11,76
1775;"Selandt";"no";0;0;0;55,49;11,76
1776;"Selandt";"no";0;0;0;55,49;11,76
1777;"Selandt";"no";0;0;0;55,49;11,76
1778;"Selandt";"no";0;0;0;55,49;11,76
1779;"Selandt";"no";0;0;0;55,49;11,76
1780;"Selandt";"no";0;0;0;55,49;11,76
1781;"Selandt";"no";0;0;0;55,49;11,76
1782;"Selandt";"no";0;0;0;55,49;11,76
1783;"Selandt";"no";0;0;0;55,49;11,76
1784;"Selandt";"no";0;0;0;55,49;11,76
1785;"Selandt";"no";0;0;0;55,49;11,76
1786;"Selandt";"no";0;0;0;55,49;11,76
1787;"Selandt";"no";0;0;0;55,49;11,76
1788;"Selandt";"no";0;0;0;55,49;11,76
1789;"Selandt";"no";0;0;0;55,49;11,76
1790;"Selandt";"no";0;0;0;55,49;11,76
1791;"Selandt";"no";0;0;0;55,49;11,76
1792;"Selandt";"no";0;0;0;55,49;11,76
1793;"Selandt";"no";0;0;0;55,49;11,76
1794;"Selandt";"no";0;0;0;55,49;11,76
1795;"Selandt";"no";0;0;0;55,49;11,76
1796;"Selandt";"no";0;0;0;55,49;11,76
1797;"Selandt";"no";0;0;0;55,49;11,76
1798;"Selandt";"no";0;0;0;55,49;11,76
1799;"Selandt";"no";0;0;0;55,49;11,76
1800;"Selandt";"no";0;0;0;55,49;11,76
1801;"Selandt";"no";0;0;0;55,49;11,76
1802;"Selandt";"no";0;0;0;55,49;11,76
1803;"Selandt";"no";0;0;0;55,49;11,76
1804;"Selandt";"no";0;0;0;55,49;11,76
1805;"Selandt";"no";0;0;0;55,49;11,76
1806;"Selandt";"no";0;0;0;55,49;11,76
1807;"Selandt";"no";0;0;0;55,49;11,76
1808;"Selandt";"no";0;0;0;55,49;11,76
1809;"Selandt";"no";0;0;0;55,49;11,76
1810;"Selandt";"no";0;0;0;55,49;11,76
1811;"Selandt";"no";0;0;0;55,49;11,76
1812;"Selandt";"no";0;0;0;55,49;11,76
1813;"Selandt";"no";0;0;0;55,49;11,76
1814;"Selandt";"no";0;0;0;55,49;11,76
1815;"Selandt";"no";0;0;0;55,49;11,76
1816;"Selandt";"no";0;0;0;55,49;11,76
1817;"Selandt";"no";0;0;0;55,49;11,76
1818;"Selandt";"no";0;0;0;55,49;11,76
1819;"Selandt";"no";0;0;0;55,49;11,76
1820;"Selandt";"no";0;0;0;55,49;11,76
1821;"Selandt";"no";0;0;0;55,49;11,76
1822;"Selandt";"no";0;0;0;55,49;11,76
1823;"Selandt";"no";0;0;0;55,49;11,76
1824;"Selandt";"no";0;0;0;55,49;11,76
1825;"Selandt";"no";0;0;0;55,49;11,76
1826;"Selandt";"no";0;0;0;55,49;11,76
1827;"Selandt";"no";0;0;0;55,49;11,76
1828;"Selandt";"no";0;0;0;55,49;11,76
1829;"Selandt";"no";0;0;0;55,49;11,76
1830;"Selandt";"no";0;0;0;55,49;11,76
1831;"Selandt";"no";0;0;0;55,49;11,76
1832;"Selandt";"no";0;0;0;55,49;11,76
1833;"Selandt";"no";0;0;0;55,49;11,76
1834;"Selandt";"no";0;0;0;55,49;11,76
1835;"Selandt";"no";0;0;0;55,49;11,76
1836;"Selandt";"no";0;0;0;55,49;11,76
1837;"Selandt";"no";0;0;0;55,49;11,76
1838;"Selandt";"no";0;0;0;55,49;11,76
1839;"Selandt";"no";0;0;0;55,49;11,76
1840;"Selandt";"no";0;0;0;55,49;11,76
1841;"Selandt";"no";0;0;0;55,49;11,76
1842;"Selandt";"no";0;0;0;55,49;11,76
1843;"Selandt";"no";0;0;0;55,49;11,76
1844;"Selandt";"no";0;0;0;55,49;11,76
1845;"Selandt";"no";0;0;0;55,49;11,76
1846;"Selandt";"no";0;0;0;55,49;11,76
1847;"Selandt";"no";0;0;0;55,49;11,76
1848;"Selandt";"no";0;0;0;55,49;11,76
1849;"Selandt";"no";0;0;0;55,49;11,76
1850;"Selandt";"no";0;0;0;55,49;11,76
1851;"Selandt";"no";0;0;0;55,49;11,76
1852;"Selandt";"no";0;0;0;55,49;11,76
1853;"Selandt";"no";0;0;0;55,49;11,76
1854;"Selandt";"no";0;0;0;55,49;11,76
1855;"Selandt";"no";0;0;0;55,49;11,76
1856;"Selandt";"no";0;3;3;55,49;11,76
1857;"Selandt";"no";0;0;0;55,49;11,76
1634;"Blegind";"no";0;0;0;56,0668932;10,0626102
1635;"Blegind";"no";0;0;0;56,0668932;10,0626102
1636;"Blegind";"no";0;0;0;56,0668932;10,0626102
1637;"Blegind";"no";0;0;0;56,0668932;10,0626102
1638;"Blegind";"no";0;0;0;56,0668932;10,0626102
1639;"Blegind";"no";0;0;0;56,0668932;10,0626102
1640;"Blegind";"no";0;0;0;56,0668932;10,0626102
1641;"Blegind";"no";0;0;0;56,0668932;10,0626102
1642;"Blegind";"no";0;0;0;56,0668932;10,0626102
1643;"Blegind";"no";0;0;0;56,0668932;10,0626102
1644;"Blegind";"no";0;0;0;56,0668932;10,0626102
1645;"Blegind";"no";0;0;0;56,0668932;10,0626102
1646;"Blegind";"no";0;0;0;56,0668932;10,0626102
1647;"Blegind";"no";0;0;0;56,0668932;10,0626102
1648;"Blegind";"no";0;0;0;56,0668932;10,0626102
1649;"Blegind";"no";2;0;2;56,0668932;10,0626102
1650;"Blegind";"no";1;0;1;56,0668932;10,0626102
1651;"Blegind";"no";0;1;1;56,0668932;10,0626102
1652;"Blegind";"no";0;0;0;56,0668932;10,0626102
1653;"Blegind";"no";0;0;0;56,0668932;10,0626102
1654;"Blegind";"no";0;0;0;56,0668932;10,0626102
1655;"Blegind";"no";0;0;0;56,0668932;10,0626102
1656;"Blegind";"no";0;0;0;56,0668932;10,0626102
1657;"Blegind";"no";0;0;0;56,0668932;10,0626102
1658;"Blegind";"no";0;0;0;56,0668932;10,0626102
1659;"Blegind";"no";0;0;0;56,0668932;10,0626102
1660;"Blegind";"no";0;0;0;56,0668932;10,0626102
1661;"Blegind";"no";0;0;0;56,0668932;10,0626102
1662;"Blegind";"no";0;0;0;56,0668932;10,0626102
1663;"Blegind";"no";0;0;0;56,0668932;10,0626102
1664;"Blegind";"no";0;0;0;56,0668932;10,0626102
1665;"Blegind";"no";0;0;0;56,0668932;10,0626102
1666;"Blegind";"no";0;0;0;56,0668932;10,0626102
1667;"Blegind";"no";0;0;0;56,0668932;10,0626102
1668;"Blegind";"no";0;0;0;56,0668932;10,0626102
1669;"Blegind";"no";0;0;0;56,0668932;10,0626102
1670;"Blegind";"no";0;0;0;56,0668932;10,0626102
1671;"Blegind";"no";0;0;0;56,0668932;10,0626102
1672;"Blegind";"no";0;0;0;56,0668932;10,0626102
1673;"Blegind";"no";0;0;0;56,0668932;10,0626102
1674;"Blegind";"no";0;0;0;56,0668932;10,0626102
1675;"Blegind";"no";0;0;0;56,0668932;10,0626102
1676;"Blegind";"no";0;0;0;56,0668932;10,0626102
1677;"Blegind";"no";0;0;0;56,0668932;10,0626102
1678;"Blegind";"no";0;0;0;56,0668932;10,0626102
1679;"Blegind";"no";0;0;0;56,0668932;10,0626102
1680;"Blegind";"no";0;0;0;56,0668932;10,0626102
1681;"Blegind";"no";0;0;0;56,0668932;10,0626102
1682;"Blegind";"no";0;0;0;56,0668932;10,0626102
1683;"Blegind";"no";0;0;0;56,0668932;10,0626102
1684;"Blegind";"no";0;0;0;56,0668932;10,0626102
1685;"Blegind";"no";0;1;1;56,0668932;10,0626102
1686;"Blegind";"no";0;0;0;56,0668932;10,0626102
1687;"Blegind";"no";0;0;0;56,0668932;10,0626102
1688;"Blegind";"no";0;0;0;56,0668932;10,0626102
1689;"Blegind";"no";0;0;0;56,0668932;10,0626102
1690;"Blegind";"no";0;0;0;56,0668932;10,0626102
1691;"Blegind";"no";0;0;0;56,0668932;10,0626102
1692;"Blegind";"no";0;0;0;56,0668932;10,0626102
1693;"Blegind";"no";0;0;0;56,0668932;10,0626102
1694;"Blegind";"no";0;0;0;56,0668932;10,0626102
1695;"Blegind";"no";0;0;0;56,0668932;10,0626102
1696;"Blegind";"no";0;0;0;56,0668932;10,0626102
1697;"Blegind";"no";0;0;0;56,0668932;10,0626102
1698;"Blegind";"no";0;0;0;56,0668932;10,0626102
1699;"Blegind";"no";0;0;0;56,0668932;10,0626102
1700;"Blegind";"no";0;0;0;56,0668932;10,0626102
1701;"Blegind";"no";0;0;0;56,0668932;10,0626102
1702;"Blegind";"no";0;0;0;56,0668932;10,0626102
1703;"Blegind";"no";0;0;0;56,0668932;10,0626102
1704;"Blegind";"no";0;0;0;56,0668932;10,0626102
1705;"Blegind";"no";0;0;0;56,0668932;10,0626102
1706;"Blegind";"no";0;0;0;56,0668932;10,0626102
1707;"Blegind";"no";0;0;0;56,0668932;10,0626102
1708;"Blegind";"no";0;0;0;56,0668932;10,0626102
1709;"Blegind";"no";0;0;0;56,0668932;10,0626102
1710;"Blegind";"no";0;0;0;56,0668932;10,0626102
1711;"Blegind";"no";0;0;0;56,0668932;10,0626102
1712;"Blegind";"no";0;0;0;56,0668932;10,0626102
1713;"Blegind";"no";0;0;0;56,0668932;10,0626102
1714;"Blegind";"no";0;0;0;56,0668932;10,0626102
1715;"Blegind";"no";0;0;0;56,0668932;10,0626102
1716;"Blegind";"no";0;0;0;56,0668932;10,0626102
1717;"Blegind";"no";0;0;0;56,0668932;10,0626102
1718;"Blegind";"no";0;0;0;56,0668932;10,0626102
1719;"Blegind";"no";0;0;0;56,0668932;10,0626102
1720;"Blegind";"no";0;0;0;56,0668932;10,0626102
1721;"Blegind";"no";0;0;0;56,0668932;10,0626102
1722;"Blegind";"no";0;0;0;56,0668932;10,0626102
1723;"Blegind";"no";0;0;0;56,0668932;10,0626102
1724;"Blegind";"no";0;0;0;56,0668932;10,0626102
1725;"Blegind";"no";0;0;0;56,0668932;10,0626102
1726;"Blegind";"no";0;0;0;56,0668932;10,0626102
1727;"Blegind";"no";0;0;0;56,0668932;10,0626102
1728;"Blegind";"no";0;0;0;56,0668932;10,0626102
1729;"Blegind";"no";0;0;0;56,0668932;10,0626102
1730;"Blegind";"no";0;0;0;56,0668932;10,0626102
1731;"Blegind";"no";0;0;0;56,0668932;10,0626102
1732;"Blegind";"no";0;0;0;56,0668932;10,0626102
1733;"Blegind";"no";0;0;0;56,0668932;10,0626102
1734;"Blegind";"no";0;0;0;56,0668932;10,0626102
1735;"Blegind";"no";0;0;0;56,0668932;10,0626102
1736;"Blegind";"no";0;0;0;56,0668932;10,0626102
1737;"Blegind";"no";0;0;0;56,0668932;10,0626102
1738;"Blegind";"no";0;0;0;56,0668932;10,0626102
1739;"Blegind";"no";0;0;0;56,0668932;10,0626102
1740;"Blegind";"no";0;0;0;56,0668932;10,0626102
1741;"Blegind";"no";0;0;0;56,0668932;10,0626102
1742;"Blegind";"no";0;0;0;56,0668932;10,0626102
1743;"Blegind";"no";0;0;0;56,0668932;10,0626102
1744;"Blegind";"no";0;0;0;56,0668932;10,0626102
1745;"Blegind";"no";0;0;0;56,0668932;10,0626102
1746;"Blegind";"no";0;0;0;56,0668932;10,0626102
1747;"Blegind";"no";0;0;0;56,0668932;10,0626102
1748;"Blegind";"no";0;0;0;56,0668932;10,0626102
1749;"Blegind";"no";0;0;0;56,0668932;10,0626102
1750;"Blegind";"no";0;0;0;56,0668932;10,0626102
1751;"Blegind";"no";0;0;0;56,0668932;10,0626102
1752;"Blegind";"no";0;0;0;56,0668932;10,0626102
1753;"Blegind";"no";0;0;0;56,0668932;10,0626102
1754;"Blegind";"no";0;0;0;56,0668932;10,0626102
1755;"Blegind";"no";0;0;0;56,0668932;10,0626102
1756;"Blegind";"no";0;0;0;56,0668932;10,0626102
1757;"Blegind";"no";0;0;0;56,0668932;10,0626102
1758;"Blegind";"no";0;0;0;56,0668932;10,0626102
1759;"Blegind";"no";0;0;0;56,0668932;10,0626102
1760;"Blegind";"no";0;0;0;56,0668932;10,0626102
1761;"Blegind";"no";0;0;0;56,0668932;10,0626102
1762;"Blegind";"no";0;0;0;56,0668932;10,0626102
1763;"Blegind";"no";0;0;0;56,0668932;10,0626102
1764;"Blegind";"no";0;0;0;56,0668932;10,0626102
1765;"Blegind";"no";0;0;0;56,0668932;10,0626102
1766;"Blegind";"no";0;0;0;56,0668932;10,0626102
1767;"Blegind";"no";0;0;0;56,0668932;10,0626102
1768;"Blegind";"no";0;0;0;56,0668932;10,0626102
1769;"Blegind";"no";0;0;0;56,0668932;10,0626102
1770;"Blegind";"no";0;0;0;56,0668932;10,0626102
1771;"Blegind";"no";0;0;0;56,0668932;10,0626102
1772;"Blegind";"no";0;0;0;56,0668932;10,0626102
1773;"Blegind";"no";0;0;0;56,0668932;10,0626102
1774;"Blegind";"no";0;0;0;56,0668932;10,0626102
1775;"Blegind";"no";0;0;0;56,0668932;10,0626102
1776;"Blegind";"no";0;0;0;56,0668932;10,0626102
1777;"Blegind";"no";0;0;0;56,0668932;10,0626102
1778;"Blegind";"no";0;0;0;56,0668932;10,0626102
1779;"Blegind";"no";0;0;0;56,0668932;10,0626102
1780;"Blegind";"no";0;0;0;56,0668932;10,0626102
1781;"Blegind";"no";0;0;0;56,0668932;10,0626102
1782;"Blegind";"no";0;0;0;56,0668932;10,0626102
1783;"Blegind";"no";0;0;0;56,0668932;10,0626102
1784;"Blegind";"no";0;0;0;56,0668932;10,0626102
1785;"Blegind";"no";0;0;0;56,0668932;10,0626102
1786;"Blegind";"no";0;0;0;56,0668932;10,0626102
1787;"Blegind";"no";0;0;0;56,0668932;10,0626102
1788;"Blegind";"no";0;0;0;56,0668932;10,0626102
1789;"Blegind";"no";0;0;0;56,0668932;10,0626102
1790;"Blegind";"no";0;0;0;56,0668932;10,0626102
1791;"Blegind";"no";0;0;0;56,0668932;10,0626102
1792;"Blegind";"no";0;0;0;56,0668932;10,0626102
1793;"Blegind";"no";0;0;0;56,0668932;10,0626102
1794;"Blegind";"no";0;0;0;56,0668932;10,0626102
1795;"Blegind";"no";0;0;0;56,0668932;10,0626102
1796;"Blegind";"no";0;0;0;56,0668932;10,0626102
1797;"Blegind";"no";0;0;0;56,0668932;10,0626102
1798;"Blegind";"no";0;0;0;56,0668932;10,0626102
1799;"Blegind";"no";0;0;0;56,0668932;10,0626102
1800;"Blegind";"no";0;0;0;56,0668932;10,0626102
1801;"Blegind";"no";0;0;0;56,0668932;10,0626102
1802;"Blegind";"no";0;0;0;56,0668932;10,0626102
1803;"Blegind";"no";0;0;0;56,0668932;10,0626102
1804;"Blegind";"no";0;0;0;56,0668932;10,0626102
1805;"Blegind";"no";0;0;0;56,0668932;10,0626102
1806;"Blegind";"no";0;0;0;56,0668932;10,0626102
1807;"Blegind";"no";0;0;0;56,0668932;10,0626102
1808;"Blegind";"no";0;0;0;56,0668932;10,0626102
1809;"Blegind";"no";0;0;0;56,0668932;10,0626102
1810;"Blegind";"no";0;0;0;56,0668932;10,0626102
1811;"Blegind";"no";0;0;0;56,0668932;10,0626102
1812;"Blegind";"no";0;0;0;56,0668932;10,0626102
1813;"Blegind";"no";0;0;0;56,0668932;10,0626102
1814;"Blegind";"no";0;0;0;56,0668932;10,0626102
1815;"Blegind";"no";0;0;0;56,0668932;10,0626102
1816;"Blegind";"no";0;0;0;56,0668932;10,0626102
1817;"Blegind";"no";0;0;0;56,0668932;10,0626102
1818;"Blegind";"no";0;0;0;56,0668932;10,0626102
1819;"Blegind";"no";0;0;0;56,0668932;10,0626102
1820;"Blegind";"no";0;0;0;56,0668932;10,0626102
1821;"Blegind";"no";0;0;0;56,0668932;10,0626102
1822;"Blegind";"no";0;0;0;56,0668932;10,0626102
1823;"Blegind";"no";0;0;0;56,0668932;10,0626102
1824;"Blegind";"no";0;0;0;56,0668932;10,0626102
1825;"Blegind";"no";0;0;0;56,0668932;10,0626102
1826;"Blegind";"no";0;0;0;56,0668932;10,0626102
1827;"Blegind";"no";0;0;0;56,0668932;10,0626102
1828;"Blegind";"no";0;0;0;56,0668932;10,0626102
1829;"Blegind";"no";0;0;0;56,0668932;10,0626102
1830;"Blegind";"no";0;0;0;56,0668932;10,0626102
1831;"Blegind";"no";0;0;0;56,0668932;10,0626102
1832;"Blegind";"no";0;0;0;56,0668932;10,0626102
1833;"Blegind";"no";0;0;0;56,0668932;10,0626102
1834;"Blegind";"no";0;0;0;56,0668932;10,0626102
1835;"Blegind";"no";0;0;0;56,0668932;10,0626102
1836;"Blegind";"no";0;0;0;56,0668932;10,0626102
1837;"Blegind";"no";0;0;0;56,0668932;10,0626102
1838;"Blegind";"no";0;0;0;56,0668932;10,0626102
1839;"Blegind";"no";0;0;0;56,0668932;10,0626102
1840;"Blegind";"no";0;0;0;56,0668932;10,0626102
1841;"Blegind";"no";0;0;0;56,0668932;10,0626102
1842;"Blegind";"no";0;0;0;56,0668932;10,0626102
1843;"Blegind";"no";0;0;0;56,0668932;10,0626102
1844;"Blegind";"no";0;0;0;56,0668932;10,0626102
1845;"Blegind";"no";0;0;0;56,0668932;10,0626102
1846;"Blegind";"no";0;0;0;56,0668932;10,0626102
1847;"Blegind";"no";0;0;0;56,0668932;10,0626102
1848;"Blegind";"no";0;0;0;56,0668932;10,0626102
1849;"Blegind";"no";0;0;0;56,0668932;10,0626102
1850;"Blegind";"no";0;0;0;56,0668932;10,0626102
1851;"Blegind";"no";0;0;0;56,0668932;10,0626102
1852;"Blegind";"no";0;0;0;56,0668932;10,0626102
1853;"Blegind";"no";0;0;0;56,0668932;10,0626102
1854;"Blegind";"no";0;0;0;56,0668932;10,0626102
1855;"Blegind";"no";0;0;0;56,0668932;10,0626102
1856;"Blegind";"no";0;0;0;56,0668932;10,0626102
1857;"Blegind";"no";0;0;0;56,0668932;10,0626102
1634;"Skagen";"no";0;0;0;57,720833;10,583888
1635;"Skagen";"no";0;0;0;57,720833;10,583888
1636;"Skagen";"no";0;0;0;57,720833;10,583888
1637;"Skagen";"no";0;0;0;57,720833;10,583888
1638;"Skagen";"no";0;0;0;57,720833;10,583888
1639;"Skagen";"no";0;0;0;57,720833;10,583888
1640;"Skagen";"no";0;0;0;57,720833;10,583888
1641;"Skagen";"no";0;0;0;57,720833;10,583888
1642;"Skagen";"no";0;0;0;57,720833;10,583888
1643;"Skagen";"no";0;0;0;57,720833;10,583888
1644;"Skagen";"no";0;0;0;57,720833;10,583888
1645;"Skagen";"no";0;0;0;57,720833;10,583888
1646;"Skagen";"no";0;0;0;57,720833;10,583888
1647;"Skagen";"no";0;0;0;57,720833;10,583888
1648;"Skagen";"no";0;0;0;57,720833;10,583888
1649;"Skagen";"no";0;0;0;57,720833;10,583888
1650;"Skagen";"no";0;0;0;57,720833;10,583888
1651;"Skagen";"no";1;0;1;57,720833;10,583888
1652;"Skagen";"no";1;0;1;57,720833;10,583888
1653;"Skagen";"no";0;0;0;57,720833;10,583888
1654;"Skagen";"no";0;0;0;57,720833;10,583888
1655;"Skagen";"no";0;0;0;57,720833;10,583888
1656;"Skagen";"no";0;0;0;57,720833;10,583888
1657;"Skagen";"no";0;0;0;57,720833;10,583888
1658;"Skagen";"no";0;0;0;57,720833;10,583888
1659;"Skagen";"no";0;0;0;57,720833;10,583888
1660;"Skagen";"no";0;0;0;57,720833;10,583888
1661;"Skagen";"no";0;0;0;57,720833;10,583888
1662;"Skagen";"no";0;0;0;57,720833;10,583888
1663;"Skagen";"no";0;0;0;57,720833;10,583888
1664;"Skagen";"no";0;0;0;57,720833;10,583888
1665;"Skagen";"no";0;0;0;57,720833;10,583888
1666;"Skagen";"no";0;0;0;57,720833;10,583888
1667;"Skagen";"no";0;0;0;57,720833;10,583888
1668;"Skagen";"no";0;0;0;57,720833;10,583888
1669;"Skagen";"no";0;0;0;57,720833;10,583888
1670;"Skagen";"no";0;0;0;57,720833;10,583888
1671;"Skagen";"no";0;0;0;57,720833;10,583888
1672;"Skagen";"no";0;0;0;57,720833;10,583888
1673;"Skagen";"no";0;0;0;57,720833;10,583888
1674;"Skagen";"no";0;0;0;57,720833;10,583888
1675;"Skagen";"no";0;0;0;57,720833;10,583888
1676;"Skagen";"no";0;0;0;57,720833;10,583888
1677;"Skagen";"no";0;0;0;57,720833;10,583888
1678;"Skagen";"no";0;0;0;57,720833;10,583888
1679;"Skagen";"no";0;0;0;57,720833;10,583888
1680;"Skagen";"no";1;1;2;57,720833;10,583888
1681;"Skagen";"no";1;0;1;57,720833;10,583888
1682;"Skagen";"no";0;0;0;57,720833;10,583888
1683;"Skagen";"no";0;1;1;57,720833;10,583888
1684;"Skagen";"no";1;0;1;57,720833;10,583888
1685;"Skagen";"no";0;0;0;57,720833;10,583888
1686;"Skagen";"no";0;0;0;57,720833;10,583888
1687;"Skagen";"no";0;1;1;57,720833;10,583888
1688;"Skagen";"no";0;0;0;57,720833;10,583888
1689;"Skagen";"no";0;0;0;57,720833;10,583888
1690;"Skagen";"no";0;0;0;57,720833;10,583888
1691;"Skagen";"no";0;0;0;57,720833;10,583888
1692;"Skagen";"no";0;0;0;57,720833;10,583888
1693;"Skagen";"no";0;0;0;57,720833;10,583888
1694;"Skagen";"no";0;0;0;57,720833;10,583888
1695;"Skagen";"no";0;0;0;57,720833;10,583888
1696;"Skagen";"no";0;0;0;57,720833;10,583888
1697;"Skagen";"no";0;0;0;57,720833;10,583888
1698;"Skagen";"no";0;0;0;57,720833;10,583888
1699;"Skagen";"no";0;0;0;57,720833;10,583888
1700;"Skagen";"no";0;0;0;57,720833;10,583888
1701;"Skagen";"no";0;0;0;57,720833;10,583888
1702;"Skagen";"no";1;1;2;57,720833;10,583888
1703;"Skagen";"no";0;1;1;57,720833;10,583888
1704;"Skagen";"no";0;0;0;57,720833;10,583888
1705;"Skagen";"no";0;0;0;57,720833;10,583888
1706;"Skagen";"no";1;0;1;57,720833;10,583888
1707;"Skagen";"no";0;0;0;57,720833;10,583888
1708;"Skagen";"no";0;2;2;57,720833;10,583888
1709;"Skagen";"no";0;0;0;57,720833;10,583888
1710;"Skagen";"no";0;0;0;57,720833;10,583888
1711;"Skagen";"no";0;0;0;57,720833;10,583888
1712;"Skagen";"no";0;0;0;57,720833;10,583888
1713;"Skagen";"no";0;0;0;57,720833;10,583888
1714;"Skagen";"no";0;0;0;57,720833;10,583888
1715;"Skagen";"no";0;0;0;57,720833;10,583888
1716;"Skagen";"no";0;0;0;57,720833;10,583888
1717;"Skagen";"no";0;0;0;57,720833;10,583888
1718;"Skagen";"no";0;0;0;57,720833;10,583888
1719;"Skagen";"no";0;0;0;57,720833;10,583888
1720;"Skagen";"no";0;0;0;57,720833;10,583888
1721;"Skagen";"no";0;0;0;57,720833;10,583888
1722;"Skagen";"no";0;0;0;57,720833;10,583888
1723;"Skagen";"no";1;1;2;57,720833;10,583888
1724;"Skagen";"no";0;0;0;57,720833;10,583888
1725;"Skagen";"no";0;0;0;57,720833;10,583888
1726;"Skagen";"no";0;0;0;57,720833;10,583888
1727;"Skagen";"no";0;0;0;57,720833;10,583888
1728;"Skagen";"no";0;0;0;57,720833;10,583888
1729;"Skagen";"no";0;0;0;57,720833;10,583888
1730;"Skagen";"no";0;0;0;57,720833;10,583888
1731;"Skagen";"no";0;1;1;57,720833;10,583888
1732;"Skagen";"no";0;0;0;57,720833;10,583888
1733;"Skagen";"no";0;0;0;57,720833;10,583888
1734;"Skagen";"no";0;0;0;57,720833;10,583888
1735;"Skagen";"no";1;0;1;57,720833;10,583888
1736;"Skagen";"no";1;1;2;57,720833;10,583888
1737;"Skagen";"no";1;2;3;57,720833;10,583888
1738;"Skagen";"no";0;2;2;57,720833;10,583888
1739;"Skagen";"no";0;1;1;57,720833;10,583888
1740;"Skagen";"no";0;1;1;57,720833;10,583888
1741;"Skagen";"no";2;4;6;57,720833;10,583888
1742;"Skagen";"no";3;4;7;57,720833;10,583888
1743;"Skagen";"no";6;3;9;57,720833;10,583888
1744;"Skagen";"no";3;3;6;57,720833;10,583888
1745;"Skagen";"no";4;5;9;57,720833;10,583888
1746;"Skagen";"no";5;2;7;57,720833;10,583888
1747;"Skagen";"no";0;0;0;57,720833;10,583888
1748;"Skagen";"no";4;2;6;57,720833;10,583888
1749;"Skagen";"no";4;4;8;57,720833;10,583888
1750;"Skagen";"no";1;1;2;57,720833;10,583888
1751;"Skagen";"no";1;1;2;57,720833;10,583888
1752;"Skagen";"no";1;2;3;57,720833;10,583888
1753;"Skagen";"no";2;2;4;57,720833;10,583888
1754;"Skagen";"no";1;0;1;57,720833;10,583888
1755;"Skagen";"no";2;2;4;57,720833;10,583888
1756;"Skagen";"no";3;2;5;57,720833;10,583888
1757;"Skagen";"no";2;2;4;57,720833;10,583888
1758;"Skagen";"no";2;3;5;57,720833;10,583888
1759;"Skagen";"no";4;4;8;57,720833;10,583888
1760;"Skagen";"no";3;1;4;57,720833;10,583888
1761;"Skagen";"no";1;1;2;57,720833;10,583888
1762;"Skagen";"no";1;0;1;57,720833;10,583888
1763;"Skagen";"no";1;1;2;57,720833;10,583888
1764;"Skagen";"no";0;0;0;57,720833;10,583888
1765;"Skagen";"no";2;2;4;57,720833;10,583888
1766;"Skagen";"no";2;2;4;57,720833;10,583888
1767;"Skagen";"no";2;0;2;57,720833;10,583888
1768;"Skagen";"no";3;2;5;57,720833;10,583888
1769;"Skagen";"no";0;0;0;57,720833;10,583888
1770;"Skagen";"no";1;1;2;57,720833;10,583888
1771;"Skagen";"no";0;0;0;57,720833;10,583888
1772;"Skagen";"no";1;0;1;57,720833;10,583888
1773;"Skagen";"no";0;0;0;57,720833;10,583888
1774;"Skagen";"no";0;1;1;57,720833;10,583888
1775;"Skagen";"no";0;0;0;57,720833;10,583888
1776;"Skagen";"no";2;1;3;57,720833;10,583888
1777;"Skagen";"no";0;0;0;57,720833;10,583888
1778;"Skagen";"no";0;0;0;57,720833;10,583888
1779;"Skagen";"no";0;0;0;57,720833;10,583888
1780;"Skagen";"no";0;0;0;57,720833;10,583888
1781;"Skagen";"no";0;0;0;57,720833;10,583888
1782;"Skagen";"no";1;0;1;57,720833;10,583888
1783;"Skagen";"no";0;0;0;57,720833;10,583888
1784;"Skagen";"no";1;0;1;57,720833;10,583888
1785;"Skagen";"no";2;0;2;57,720833;10,583888
1786;"Skagen";"no";1;0;1;57,720833;10,583888
1787;"Skagen";"no";0;0;0;57,720833;10,583888
1788;"Skagen";"no";0;0;0;57,720833;10,583888
1789;"Skagen";"no";0;0;0;57,720833;10,583888
1790;"Skagen";"no";3;0;3;57,720833;10,583888
1791;"Skagen";"no";0;0;0;57,720833;10,583888
1792;"Skagen";"no";0;0;0;57,720833;10,583888
1793;"Skagen";"no";0;0;0;57,720833;10,583888
1794;"Skagen";"no";1;0;1;57,720833;10,583888
1795;"Skagen";"no";0;0;0;57,720833;10,583888
1796;"Skagen";"no";1;0;1;57,720833;10,583888
1797;"Skagen";"no";1;1;2;57,720833;10,583888
1798;"Skagen";"no";0;0;0;57,720833;10,583888
1799;"Skagen";"no";0;0;0;57,720833;10,583888
1800;"Skagen";"no";0;0;0;57,720833;10,583888
1801;"Skagen";"no";0;0;0;57,720833;10,583888
1802;"Skagen";"no";0;0;0;57,720833;10,583888
1803;"Skagen";"no";0;0;0;57,720833;10,583888
1804;"Skagen";"no";1;0;1;57,720833;10,583888
1805;"Skagen";"no";0;0;0;57,720833;10,583888
1806;"Skagen";"no";0;0;0;57,720833;10,583888
1807;"Skagen";"no";0;0;0;57,720833;10,583888
1808;"Skagen";"no";0;0;0;57,720833;10,583888
1809;"Skagen";"no";0;0;0;57,720833;10,583888
1810;"Skagen";"no";0;0;0;57,720833;10,583888
1811;"Skagen";"no";0;0;0;57,720833;10,583888
1812;"Skagen";"no";0;0;0;57,720833;10,583888
1813;"Skagen";"no";0;0;0;57,720833;10,583888
1814;"Skagen";"no";0;0;0;57,720833;10,583888
1815;"Skagen";"no";0;0;0;57,720833;10,583888
1816;"Skagen";"no";2;1;3;57,720833;10,583888
1817;"Skagen";"no";0;0;0;57,720833;10,583888
1818;"Skagen";"no";1;0;1;57,720833;10,583888
1819;"Skagen";"no";0;0;0;57,720833;10,583888
1820;"Skagen";"no";0;0;0;57,720833;10,583888
1821;"Skagen";"no";0;0;0;57,720833;10,583888
1822;"Skagen";"no";0;0;0;57,720833;10,583888
1823;"Skagen";"no";0;0;0;57,720833;10,583888
1824;"Skagen";"no";1;0;1;57,720833;10,583888
1825;"Skagen";"no";0;0;0;57,720833;10,583888
1826;"Skagen";"no";0;0;0;57,720833;10,583888
1827;"Skagen";"no";2;0;2;57,720833;10,583888
1828;"Skagen";"no";0;0;0;57,720833;10,583888
1829;"Skagen";"no";0;0;0;57,720833;10,583888
1830;"Skagen";"no";2;1;3;57,720833;10,583888
1831;"Skagen";"no";4;2;6;57,720833;10,583888
1832;"Skagen";"no";0;0;0;57,720833;10,583888
1833;"Skagen";"no";0;0;0;57,720833;10,583888
1834;"Skagen";"no";0;1;1;57,720833;10,583888
1835;"Skagen";"no";0;0;0;57,720833;10,583888
1836;"Skagen";"no";0;0;0;57,720833;10,583888
1837;"Skagen";"no";0;0;0;57,720833;10,583888
1838;"Skagen";"no";0;0;0;57,720833;10,583888
1839;"Skagen";"no";0;1;1;57,720833;10,583888
1840;"Skagen";"no";5;0;5;57,720833;10,583888
1841;"Skagen";"no";0;0;0;57,720833;10,583888
1842;"Skagen";"no";8;1;9;57,720833;10,583888
1843;"Skagen";"no";15;4;19;57,720833;10,583888
1844;"Skagen";"no";12;1;13;57,720833;10,583888
1845;"Skagen";"no";4;0;4;57,720833;10,583888
1846;"Skagen";"no";2;1;3;57,720833;10,583888
1847;"Skagen";"no";8;0;8;57,720833;10,583888
1848;"Skagen";"no";4;0;4;57,720833;10,583888
1849;"Skagen";"no";6;0;6;57,720833;10,583888
1850;"Skagen";"no";0;0;0;57,720833;10,583888
1851;"Skagen";"no";6;0;6;57,720833;10,583888
1852;"Skagen";"no";8;1;9;57,720833;10,583888
1853;"Skagen";"no";1;1;2;57,720833;10,583888
1854;"Skagen";"no";6;3;9;57,720833;10,583888
1855;"Skagen";"no";4;0;4;57,720833;10,583888
1856;"Skagen";"no";2;0;2;57,720833;10,583888
1857;"Skagen";"no";0;0;0;57,720833;10,583888
1634;"Rødby";"no";0;0;0;54,7;11,4
1635;"Rødby";"no";0;0;0;54,7;11,4
1636;"Rødby";"no";0;0;0;54,7;11,4
1637;"Rødby";"no";0;0;0;54,7;11,4
1638;"Rødby";"no";0;0;0;54,7;11,4
1639;"Rødby";"no";0;0;0;54,7;11,4
1640;"Rødby";"no";0;0;0;54,7;11,4
1641;"Rødby";"no";0;0;0;54,7;11,4
1642;"Rødby";"no";0;0;0;54,7;11,4
1643;"Rødby";"no";0;0;0;54,7;11,4
1644;"Rødby";"no";0;0;0;54,7;11,4
1645;"Rødby";"no";0;0;0;54,7;11,4
1646;"Rødby";"no";0;0;0;54,7;11,4
1647;"Rødby";"no";0;0;0;54,7;11,4
1648;"Rødby";"no";0;0;0;54,7;11,4
1649;"Rødby";"no";0;0;0;54,7;11,4
1650;"Rødby";"no";0;0;0;54,7;11,4
1651;"Rødby";"no";0;0;0;54,7;11,4
1652;"Rødby";"no";2;0;2;54,7;11,4
1653;"Rødby";"no";0;0;0;54,7;11,4
1654;"Rødby";"no";0;0;0;54,7;11,4
1655;"Rødby";"no";1;0;1;54,7;11,4
1656;"Rødby";"no";0;0;0;54,7;11,4
1657;"Rødby";"no";0;0;0;54,7;11,4
1658;"Rødby";"no";0;0;0;54,7;11,4
1659;"Rødby";"no";0;0;0;54,7;11,4
1660;"Rødby";"no";0;0;0;54,7;11,4
1661;"Rødby";"no";0;0;0;54,7;11,4
1662;"Rødby";"no";0;0;0;54,7;11,4
1663;"Rødby";"no";0;0;0;54,7;11,4
1664;"Rødby";"no";0;0;0;54,7;11,4
1665;"Rødby";"no";0;0;0;54,7;11,4
1666;"Rødby";"no";0;0;0;54,7;11,4
1667;"Rødby";"no";0;0;0;54,7;11,4
1668;"Rødby";"no";0;0;0;54,7;11,4
1669;"Rødby";"no";0;2;2;54,7;11,4
1670;"Rødby";"no";0;0;0;54,7;11,4
1671;"Rødby";"no";0;0;0;54,7;11,4
1672;"Rødby";"no";0;0;0;54,7;11,4
1673;"Rødby";"no";0;1;1;54,7;11,4
1674;"Rødby";"no";0;0;0;54,7;11,4
1675;"Rødby";"no";0;0;0;54,7;11,4
1676;"Rødby";"no";0;0;0;54,7;11,4
1677;"Rødby";"no";0;0;0;54,7;11,4
1678;"Rødby";"no";0;0;0;54,7;11,4
1679;"Rødby";"no";0;0;0;54,7;11,4
1680;"Rødby";"no";0;0;0;54,7;11,4
1681;"Rødby";"no";0;0;0;54,7;11,4
1682;"Rødby";"no";0;0;0;54,7;11,4
1683;"Rødby";"no";0;0;0;54,7;11,4
1684;"Rødby";"no";0;0;0;54,7;11,4
1685;"Rødby";"no";0;1;1;54,7;11,4
1686;"Rødby";"no";0;0;0;54,7;11,4
1687;"Rødby";"no";0;0;0;54,7;11,4
1688;"Rødby";"no";0;0;0;54,7;11,4
1689;"Rødby";"no";0;0;0;54,7;11,4
1690;"Rødby";"no";0;0;0;54,7;11,4
1691;"Rødby";"no";0;0;0;54,7;11,4
1692;"Rødby";"no";0;0;0;54,7;11,4
1693;"Rødby";"no";0;0;0;54,7;11,4
1694;"Rødby";"no";0;0;0;54,7;11,4
1695;"Rødby";"no";0;0;0;54,7;11,4
1696;"Rødby";"no";0;0;0;54,7;11,4
1697;"Rødby";"no";0;0;0;54,7;11,4
1698;"Rødby";"no";0;0;0;54,7;11,4
1699;"Rødby";"no";0;0;0;54,7;11,4
1700;"Rødby";"no";0;0;0;54,7;11,4
1701;"Rødby";"no";0;0;0;54,7;11,4
1702;"Rødby";"no";0;0;0;54,7;11,4
1703;"Rødby";"no";0;0;0;54,7;11,4
1704;"Rødby";"no";0;0;0;54,7;11,4
1705;"Rødby";"no";0;0;0;54,7;11,4
1706;"Rødby";"no";0;0;0;54,7;11,4
1707;"Rødby";"no";0;0;0;54,7;11,4
1708;"Rødby";"no";0;0;0;54,7;11,4
1709;"Rødby";"no";0;0;0;54,7;11,4
1710;"Rødby";"no";0;0;0;54,7;11,4
1711;"Rødby";"no";0;0;0;54,7;11,4
1712;"Rødby";"no";0;0;0;54,7;11,4
1713;"Rødby";"no";0;0;0;54,7;11,4
1714;"Rødby";"no";0;0;0;54,7;11,4
1715;"Rødby";"no";0;0;0;54,7;11,4
1716;"Rødby";"no";0;0;0;54,7;11,4
1717;"Rødby";"no";0;0;0;54,7;11,4
1718;"Rødby";"no";0;0;0;54,7;11,4
1719;"Rødby";"no";0;0;0;54,7;11,4
1720;"Rødby";"no";0;0;0;54,7;11,4
1721;"Rødby";"no";0;0;0;54,7;11,4
1722;"Rødby";"no";0;0;0;54,7;11,4
1723;"Rødby";"no";0;0;0;54,7;11,4
1724;"Rødby";"no";0;0;0;54,7;11,4
1725;"Rødby";"no";0;0;0;54,7;11,4
1726;"Rødby";"no";0;0;0;54,7;11,4
1727;"Rødby";"no";0;0;0;54,7;11,4
1728;"Rødby";"no";0;0;0;54,7;11,4
1729;"Rødby";"no";0;0;0;54,7;11,4
1730;"Rødby";"no";0;0;0;54,7;11,4
1731;"Rødby";"no";0;0;0;54,7;11,4
1732;"Rødby";"no";0;0;0;54,7;11,4
1733;"Rødby";"no";0;0;0;54,7;11,4
1734;"Rødby";"no";0;0;0;54,7;11,4
1735;"Rødby";"no";0;0;0;54,7;11,4
1736;"Rødby";"no";0;0;0;54,7;11,4
1737;"Rødby";"no";0;0;0;54,7;11,4
1738;"Rødby";"no";0;0;0;54,7;11,4
1739;"Rødby";"no";0;0;0;54,7;11,4
1740;"Rødby";"no";0;0;0;54,7;11,4
1741;"Rødby";"no";0;0;0;54,7;11,4
1742;"Rødby";"no";0;0;0;54,7;11,4
1743;"Rødby";"no";0;0;0;54,7;11,4
1744;"Rødby";"no";0;0;0;54,7;11,4
1745;"Rødby";"no";0;0;0;54,7;11,4
1746;"Rødby";"no";0;0;0;54,7;11,4
1747;"Rødby";"no";0;0;0;54,7;11,4
1748;"Rødby";"no";0;0;0;54,7;11,4
1749;"Rødby";"no";0;0;0;54,7;11,4
1750;"Rødby";"no";0;0;0;54,7;11,4
1751;"Rødby";"no";0;0;0;54,7;11,4
1752;"Rødby";"no";0;0;0;54,7;11,4
1753;"Rødby";"no";0;0;0;54,7;11,4
1754;"Rødby";"no";0;0;0;54,7;11,4
1755;"Rødby";"no";0;0;0;54,7;11,4
1756;"Rødby";"no";0;0;0;54,7;11,4
1757;"Rødby";"no";0;0;0;54,7;11,4
1758;"Rødby";"no";0;0;0;54,7;11,4
1759;"Rødby";"no";0;0;0;54,7;11,4
1760;"Rødby";"no";0;0;0;54,7;11,4
1761;"Rødby";"no";0;0;0;54,7;11,4
1762;"Rødby";"no";0;0;0;54,7;11,4
1763;"Rødby";"no";0;0;0;54,7;11,4
1764;"Rødby";"no";0;0;0;54,7;11,4
1765;"Rødby";"no";0;0;0;54,7;11,4
1766;"Rødby";"no";0;0;0;54,7;11,4
1767;"Rødby";"no";0;0;0;54,7;11,4
1768;"Rødby";"no";0;0;0;54,7;11,4
1769;"Rødby";"no";0;0;0;54,7;11,4
1770;"Rødby";"no";0;0;0;54,7;11,4
1771;"Rødby";"no";0;0;0;54,7;11,4
1772;"Rødby";"no";0;0;0;54,7;11,4
1773;"Rødby";"no";0;0;0;54,7;11,4
1774;"Rødby";"no";0;0;0;54,7;11,4
1775;"Rødby";"no";0;0;0;54,7;11,4
1776;"Rødby";"no";0;0;0;54,7;11,4
1777;"Rødby";"no";0;0;0;54,7;11,4
1778;"Rødby";"no";0;0;0;54,7;11,4
1779;"Rødby";"no";0;0;0;54,7;11,4
1780;"Rødby";"no";0;0;0;54,7;11,4
1781;"Rødby";"no";0;0;0;54,7;11,4
1782;"Rødby";"no";0;0;0;54,7;11,4
1783;"Rødby";"no";0;0;0;54,7;11,4
1784;"Rødby";"no";0;0;0;54,7;11,4
1785;"Rødby";"no";0;0;0;54,7;11,4
1786;"Rødby";"no";0;0;0;54,7;11,4
1787;"Rødby";"no";0;0;0;54,7;11,4
1788;"Rødby";"no";0;0;0;54,7;11,4
1789;"Rødby";"no";0;0;0;54,7;11,4
1790;"Rødby";"no";0;0;0;54,7;11,4
1791;"Rødby";"no";0;0;0;54,7;11,4
1792;"Rødby";"no";0;0;0;54,7;11,4
1793;"Rødby";"no";0;0;0;54,7;11,4
1794;"Rødby";"no";0;0;0;54,7;11,4
1795;"Rødby";"no";0;0;0;54,7;11,4
1796;"Rødby";"no";0;0;0;54,7;11,4
1797;"Rødby";"no";0;0;0;54,7;11,4
1798;"Rødby";"no";0;0;0;54,7;11,4
1799;"Rødby";"no";0;0;0;54,7;11,4
1800;"Rødby";"no";0;0;0;54,7;11,4
1801;"Rødby";"no";0;0;0;54,7;11,4
1802;"Rødby";"no";0;0;0;54,7;11,4
1803;"Rødby";"no";0;0;0;54,7;11,4
1804;"Rødby";"no";0;0;0;54,7;11,4
1805;"Rødby";"no";0;0;0;54,7;11,4
1806;"Rødby";"no";0;0;0;54,7;11,4
1807;"Rødby";"no";0;0;0;54,7;11,4
1808;"Rødby";"no";0;0;0;54,7;11,4
1809;"Rødby";"no";0;0;0;54,7;11,4
1810;"Rødby";"no";0;0;0;54,7;11,4
1811;"Rødby";"no";0;0;0;54,7;11,4
1812;"Rødby";"no";0;0;0;54,7;11,4
1813;"Rødby";"no";0;0;0;54,7;11,4
1814;"Rødby";"no";0;0;0;54,7;11,4
1815;"Rødby";"no";0;0;0;54,7;11,4
1816;"Rødby";"no";0;0;0;54,7;11,4
1817;"Rødby";"no";0;0;0;54,7;11,4
1818;"Rødby";"no";0;0;0;54,7;11,4
1819;"Rødby";"no";0;0;0;54,7;11,4
1820;"Rødby";"no";0;0;0;54,7;11,4
1821;"Rødby";"no";0;0;0;54,7;11,4
1822;"Rødby";"no";0;0;0;54,7;11,4
1823;"Rødby";"no";0;0;0;54,7;11,4
1824;"Rødby";"no";0;0;0;54,7;11,4
1825;"Rødby";"no";0;0;0;54,7;11,4
1826;"Rødby";"no";0;0;0;54,7;11,4
1827;"Rødby";"no";0;0;0;54,7;11,4
1828;"Rødby";"no";0;0;0;54,7;11,4
1829;"Rødby";"no";0;0;0;54,7;11,4
1830;"Rødby";"no";0;0;0;54,7;11,4
1831;"Rødby";"no";0;0;0;54,7;11,4
1832;"Rødby";"no";0;0;0;54,7;11,4
1833;"Rødby";"no";1;0;1;54,7;11,4
1834;"Rødby";"no";0;0;0;54,7;11,4
1835;"Rødby";"no";0;0;0;54,7;11,4
1836;"Rødby";"no";0;0;0;54,7;11,4
1837;"Rødby";"no";1;0;1;54,7;11,4
1838;"Rødby";"no";0;0;0;54,7;11,4
1839;"Rødby";"no";0;0;0;54,7;11,4
1840;"Rødby";"no";0;0;0;54,7;11,4
1841;"Rødby";"no";1;0;1;54,7;11,4
1842;"Rødby";"no";0;0;0;54,7;11,4
1843;"Rødby";"no";0;0;0;54,7;11,4
1844;"Rødby";"no";0;0;0;54,7;11,4
1845;"Rødby";"no";0;0;0;54,7;11,4
1846;"Rødby";"no";0;0;0;54,7;11,4
1847;"Rødby";"no";0;0;0;54,7;11,4
1848;"Rødby";"no";0;0;0;54,7;11,4
1849;"Rødby";"no";0;0;0;54,7;11,4
1850;"Rødby";"no";0;0;0;54,7;11,4
1851;"Rødby";"no";1;1;2;54,7;11,4
1852;"Rødby";"no";1;0;1;54,7;11,4
1853;"Rødby";"no";0;0;0;54,7;11,4
1854;"Rødby";"no";0;0;0;54,7;11,4
1855;"Rødby";"no";0;0;0;54,7;11,4
1856;"Rødby";"no";0;0;0;54,7;11,4
1857;"Rødby";"no";0;0;0;54,7;11,4
1634;"Viborg";"no";0;0;0;56,453055;9,401944
1635;"Viborg";"no";0;0;0;56,453055;9,401944
1636;"Viborg";"no";0;0;0;56,453055;9,401944
1637;"Viborg";"no";0;0;0;56,453055;9,401944
1638;"Viborg";"no";0;0;0;56,453055;9,401944
1639;"Viborg";"no";0;0;0;56,453055;9,401944
1640;"Viborg";"no";0;0;0;56,453055;9,401944
1641;"Viborg";"no";0;0;0;56,453055;9,401944
1642;"Viborg";"no";0;0;0;56,453055;9,401944
1643;"Viborg";"no";0;0;0;56,453055;9,401944
1644;"Viborg";"no";0;0;0;56,453055;9,401944
1645;"Viborg";"no";0;0;0;56,453055;9,401944
1646;"Viborg";"no";0;0;0;56,453055;9,401944
1647;"Viborg";"no";0;0;0;56,453055;9,401944
1648;"Viborg";"no";0;0;0;56,453055;9,401944
1649;"Viborg";"no";0;0;0;56,453055;9,401944
1650;"Viborg";"no";0;0;0;56,453055;9,401944
1651;"Viborg";"no";0;0;0;56,453055;9,401944
1652;"Viborg";"no";0;0;0;56,453055;9,401944
1653;"Viborg";"no";0;0;0;56,453055;9,401944
1654;"Viborg";"no";0;0;0;56,453055;9,401944
1655;"Viborg";"no";2;0;2;56,453055;9,401944
1656;"Viborg";"no";0;0;0;56,453055;9,401944
1657;"Viborg";"no";0;0;0;56,453055;9,401944
1658;"Viborg";"no";0;0;0;56,453055;9,401944
1659;"Viborg";"no";0;0;0;56,453055;9,401944
1660;"Viborg";"no";0;0;0;56,453055;9,401944
1661;"Viborg";"no";0;0;0;56,453055;9,401944
1662;"Viborg";"no";0;0;0;56,453055;9,401944
1663;"Viborg";"no";0;0;0;56,453055;9,401944
1664;"Viborg";"no";0;0;0;56,453055;9,401944
1665;"Viborg";"no";0;0;0;56,453055;9,401944
1666;"Viborg";"no";0;0;0;56,453055;9,401944
1667;"Viborg";"no";0;0;0;56,453055;9,401944
1668;"Viborg";"no";0;0;0;56,453055;9,401944
1669;"Viborg";"no";0;0;0;56,453055;9,401944
1670;"Viborg";"no";0;0;0;56,453055;9,401944
1671;"Viborg";"no";0;0;0;56,453055;9,401944
1672;"Viborg";"no";0;0;0;56,453055;9,401944
1673;"Viborg";"no";0;0;0;56,453055;9,401944
1674;"Viborg";"no";0;0;0;56,453055;9,401944
1675;"Viborg";"no";0;0;0;56,453055;9,401944
1676;"Viborg";"no";0;0;0;56,453055;9,401944
1677;"Viborg";"no";0;0;0;56,453055;9,401944
1678;"Viborg";"no";0;3;3;56,453055;9,401944
1679;"Viborg";"no";0;0;0;56,453055;9,401944
1680;"Viborg";"no";0;0;0;56,453055;9,401944
1681;"Viborg";"no";0;0;0;56,453055;9,401944
1682;"Viborg";"no";0;0;0;56,453055;9,401944
1683;"Viborg";"no";0;1;1;56,453055;9,401944
1684;"Viborg";"no";0;0;0;56,453055;9,401944
1685;"Viborg";"no";0;0;0;56,453055;9,401944
1686;"Viborg";"no";0;0;0;56,453055;9,401944
1687;"Viborg";"no";0;0;0;56,453055;9,401944
1688;"Viborg";"no";0;2;2;56,453055;9,401944
1689;"Viborg";"no";0;1;1;56,453055;9,401944
1690;"Viborg";"no";0;0;0;56,453055;9,401944
1691;"Viborg";"no";0;0;0;56,453055;9,401944
1692;"Viborg";"no";0;0;0;56,453055;9,401944
1693;"Viborg";"no";0;0;0;56,453055;9,401944
1694;"Viborg";"no";0;0;0;56,453055;9,401944
1695;"Viborg";"no";0;0;0;56,453055;9,401944
1696;"Viborg";"no";0;0;0;56,453055;9,401944
1697;"Viborg";"no";0;0;0;56,453055;9,401944
1698;"Viborg";"no";0;0;0;56,453055;9,401944
1699;"Viborg";"no";0;0;0;56,453055;9,401944
1700;"Viborg";"no";0;0;0;56,453055;9,401944
1701;"Viborg";"no";0;0;0;56,453055;9,401944
1702;"Viborg";"no";0;0;0;56,453055;9,401944
1703;"Viborg";"no";0;0;0;56,453055;9,401944
1704;"Viborg";"no";0;0;0;56,453055;9,401944
1705;"Viborg";"no";0;0;0;56,453055;9,401944
1706;"Viborg";"no";0;0;0;56,453055;9,401944
1707;"Viborg";"no";0;0;0;56,453055;9,401944
1708;"Viborg";"no";0;0;0;56,453055;9,401944
1709;"Viborg";"no";0;0;0;56,453055;9,401944
1710;"Viborg";"no";0;0;0;56,453055;9,401944
1711;"Viborg";"no";0;0;0;56,453055;9,401944
1712;"Viborg";"no";0;0;0;56,453055;9,401944
1713;"Viborg";"no";0;0;0;56,453055;9,401944
1714;"Viborg";"no";0;0;0;56,453055;9,401944
1715;"Viborg";"no";0;0;0;56,453055;9,401944
1716;"Viborg";"no";0;0;0;56,453055;9,401944
1717;"Viborg";"no";0;0;0;56,453055;9,401944
1718;"Viborg";"no";0;0;0;56,453055;9,401944
1719;"Viborg";"no";0;0;0;56,453055;9,401944
1720;"Viborg";"no";0;0;0;56,453055;9,401944
1721;"Viborg";"no";0;0;0;56,453055;9,401944
1722;"Viborg";"no";0;0;0;56,453055;9,401944
1723;"Viborg";"no";0;0;0;56,453055;9,401944
1724;"Viborg";"no";0;0;0;56,453055;9,401944
1725;"Viborg";"no";0;0;0;56,453055;9,401944
1726;"Viborg";"no";0;0;0;56,453055;9,401944
1727;"Viborg";"no";0;0;0;56,453055;9,401944
1728;"Viborg";"no";0;0;0;56,453055;9,401944
1729;"Viborg";"no";0;0;0;56,453055;9,401944
1730;"Viborg";"no";0;0;0;56,453055;9,401944
1731;"Viborg";"no";0;0;0;56,453055;9,401944
1732;"Viborg";"no";0;0;0;56,453055;9,401944
1733;"Viborg";"no";0;0;0;56,453055;9,401944
1734;"Viborg";"no";0;0;0;56,453055;9,401944
1735;"Viborg";"no";0;0;0;56,453055;9,401944
1736;"Viborg";"no";0;0;0;56,453055;9,401944
1737;"Viborg";"no";0;0;0;56,453055;9,401944
1738;"Viborg";"no";0;0;0;56,453055;9,401944
1739;"Viborg";"no";0;0;0;56,453055;9,401944
1740;"Viborg";"no";0;0;0;56,453055;9,401944
1741;"Viborg";"no";0;0;0;56,453055;9,401944
1742;"Viborg";"no";0;0;0;56,453055;9,401944
1743;"Viborg";"no";0;0;0;56,453055;9,401944
1744;"Viborg";"no";0;0;0;56,453055;9,401944
1745;"Viborg";"no";0;0;0;56,453055;9,401944
1746;"Viborg";"no";0;0;0;56,453055;9,401944
1747;"Viborg";"no";0;0;0;56,453055;9,401944
1748;"Viborg";"no";0;0;0;56,453055;9,401944
1749;"Viborg";"no";0;0;0;56,453055;9,401944
1750;"Viborg";"no";0;0;0;56,453055;9,401944
1751;"Viborg";"no";0;0;0;56,453055;9,401944
1752;"Viborg";"no";0;0;0;56,453055;9,401944
1753;"Viborg";"no";0;0;0;56,453055;9,401944
1754;"Viborg";"no";0;0;0;56,453055;9,401944
1755;"Viborg";"no";0;0;0;56,453055;9,401944
1756;"Viborg";"no";0;0;0;56,453055;9,401944
1757;"Viborg";"no";0;0;0;56,453055;9,401944
1758;"Viborg";"no";0;0;0;56,453055;9,401944
1759;"Viborg";"no";0;0;0;56,453055;9,401944
1760;"Viborg";"no";0;0;0;56,453055;9,401944
1761;"Viborg";"no";0;0;0;56,453055;9,401944
1762;"Viborg";"no";0;0;0;56,453055;9,401944
1763;"Viborg";"no";0;0;0;56,453055;9,401944
1764;"Viborg";"no";0;0;0;56,453055;9,401944
1765;"Viborg";"no";0;0;0;56,453055;9,401944
1766;"Viborg";"no";0;0;0;56,453055;9,401944
1767;"Viborg";"no";0;0;0;56,453055;9,401944
1768;"Viborg";"no";0;0;0;56,453055;9,401944
1769;"Viborg";"no";0;0;0;56,453055;9,401944
1770;"Viborg";"no";0;0;0;56,453055;9,401944
1771;"Viborg";"no";0;0;0;56,453055;9,401944
1772;"Viborg";"no";0;0;0;56,453055;9,401944
1773;"Viborg";"no";0;0;0;56,453055;9,401944
1774;"Viborg";"no";0;0;0;56,453055;9,401944
1775;"Viborg";"no";0;0;0;56,453055;9,401944
1776;"Viborg";"no";0;0;0;56,453055;9,401944
1777;"Viborg";"no";0;0;0;56,453055;9,401944
1778;"Viborg";"no";0;0;0;56,453055;9,401944
1779;"Viborg";"no";0;0;0;56,453055;9,401944
1780;"Viborg";"no";0;0;0;56,453055;9,401944
1781;"Viborg";"no";0;0;0;56,453055;9,401944
1782;"Viborg";"no";0;0;0;56,453055;9,401944
1783;"Viborg";"no";0;0;0;56,453055;9,401944
1784;"Viborg";"no";0;0;0;56,453055;9,401944
1785;"Viborg";"no";0;0;0;56,453055;9,401944
1786;"Viborg";"no";0;0;0;56,453055;9,401944
1787;"Viborg";"no";0;0;0;56,453055;9,401944
1788;"Viborg";"no";0;0;0;56,453055;9,401944
1789;"Viborg";"no";0;0;0;56,453055;9,401944
1790;"Viborg";"no";0;0;0;56,453055;9,401944
1791;"Viborg";"no";0;0;0;56,453055;9,401944
1792;"Viborg";"no";0;0;0;56,453055;9,401944
1793;"Viborg";"no";0;0;0;56,453055;9,401944
1794;"Viborg";"no";0;0;0;56,453055;9,401944
1795;"Viborg";"no";0;0;0;56,453055;9,401944
1796;"Viborg";"no";0;0;0;56,453055;9,401944
1797;"Viborg";"no";0;0;0;56,453055;9,401944
1798;"Viborg";"no";0;0;0;56,453055;9,401944
1799;"Viborg";"no";0;0;0;56,453055;9,401944
1800;"Viborg";"no";0;0;0;56,453055;9,401944
1801;"Viborg";"no";0;0;0;56,453055;9,401944
1802;"Viborg";"no";0;0;0;56,453055;9,401944
1803;"Viborg";"no";0;0;0;56,453055;9,401944
1804;"Viborg";"no";0;0;0;56,453055;9,401944
1805;"Viborg";"no";0;0;0;56,453055;9,401944
1806;"Viborg";"no";0;0;0;56,453055;9,401944
1807;"Viborg";"no";0;0;0;56,453055;9,401944
1808;"Viborg";"no";0;0;0;56,453055;9,401944
1809;"Viborg";"no";0;0;0;56,453055;9,401944
1810;"Viborg";"no";0;0;0;56,453055;9,401944
1811;"Viborg";"no";0;0;0;56,453055;9,401944
1812;"Viborg";"no";0;0;0;56,453055;9,401944
1813;"Viborg";"no";0;0;0;56,453055;9,401944
1814;"Viborg";"no";0;0;0;56,453055;9,401944
1815;"Viborg";"no";0;0;0;56,453055;9,401944
1816;"Viborg";"no";0;0;0;56,453055;9,401944
1817;"Viborg";"no";0;0;0;56,453055;9,401944
1818;"Viborg";"no";0;0;0;56,453055;9,401944
1819;"Viborg";"no";0;0;0;56,453055;9,401944
1820;"Viborg";"no";0;0;0;56,453055;9,401944
1821;"Viborg";"no";0;0;0;56,453055;9,401944
1822;"Viborg";"no";0;0;0;56,453055;9,401944
1823;"Viborg";"no";0;0;0;56,453055;9,401944
1824;"Viborg";"no";0;0;0;56,453055;9,401944
1825;"Viborg";"no";0;0;0;56,453055;9,401944
1826;"Viborg";"no";0;0;0;56,453055;9,401944
1827;"Viborg";"no";0;0;0;56,453055;9,401944
1828;"Viborg";"no";0;0;0;56,453055;9,401944
1829;"Viborg";"no";0;0;0;56,453055;9,401944
1830;"Viborg";"no";0;0;0;56,453055;9,401944
1831;"Viborg";"no";0;0;0;56,453055;9,401944
1832;"Viborg";"no";0;0;0;56,453055;9,401944
1833;"Viborg";"no";0;0;0;56,453055;9,401944
1834;"Viborg";"no";0;0;0;56,453055;9,401944
1835;"Viborg";"no";0;0;0;56,453055;9,401944
1836;"Viborg";"no";0;0;0;56,453055;9,401944
1837;"Viborg";"no";0;0;0;56,453055;9,401944
1838;"Viborg";"no";0;0;0;56,453055;9,401944
1839;"Viborg";"no";0;0;0;56,453055;9,401944
1840;"Viborg";"no";0;0;0;56,453055;9,401944
1841;"Viborg";"no";0;0;0;56,453055;9,401944
1842;"Viborg";"no";0;0;0;56,453055;9,401944
1843;"Viborg";"no";0;0;0;56,453055;9,401944
1844;"Viborg";"no";0;0;0;56,453055;9,401944
1845;"Viborg";"no";0;0;0;56,453055;9,401944
1846;"Viborg";"no";1;0;1;56,453055;9,401944
1847;"Viborg";"no";0;0;0;56,453055;9,401944
1848;"Viborg";"no";1;1;2;56,453055;9,401944
1849;"Viborg";"no";0;0;0;56,453055;9,401944
1850;"Viborg";"no";1;2;3;56,453055;9,401944
1851;"Viborg";"no";2;2;4;56,453055;9,401944
1852;"Viborg";"no";1;1;2;56,453055;9,401944
1853;"Viborg";"no";1;0;1;56,453055;9,401944
1854;"Viborg";"no";1;0;1;56,453055;9,401944
1855;"Viborg";"no";2;1;3;56,453055;9,401944
1856;"Viborg";"no";0;0;0;56,453055;9,401944
1857;"Viborg";"no";0;0;0;56,453055;9,401944
1634;"Søby";"no";0;0;0;56,530833;9,112777
1635;"Søby";"no";0;0;0;56,530833;9,112777
1636;"Søby";"no";0;0;0;56,530833;9,112777
1637;"Søby";"no";0;0;0;56,530833;9,112777
1638;"Søby";"no";0;0;0;56,530833;9,112777
1639;"Søby";"no";0;0;0;56,530833;9,112777
1640;"Søby";"no";0;0;0;56,530833;9,112777
1641;"Søby";"no";0;0;0;56,530833;9,112777
1642;"Søby";"no";0;0;0;56,530833;9,112777
1643;"Søby";"no";0;0;0;56,530833;9,112777
1644;"Søby";"no";0;0;0;56,530833;9,112777
1645;"Søby";"no";0;0;0;56,530833;9,112777
1646;"Søby";"no";0;0;0;56,530833;9,112777
1647;"Søby";"no";0;0;0;56,530833;9,112777
1648;"Søby";"no";0;0;0;56,530833;9,112777
1649;"Søby";"no";0;0;0;56,530833;9,112777
1650;"Søby";"no";0;0;0;56,530833;9,112777
1651;"Søby";"no";0;0;0;56,530833;9,112777
1652;"Søby";"no";0;0;0;56,530833;9,112777
1653;"Søby";"no";0;0;0;56,530833;9,112777
1654;"Søby";"no";0;0;0;56,530833;9,112777
1655;"Søby";"no";0;0;0;56,530833;9,112777
1656;"Søby";"no";0;0;0;56,530833;9,112777
1657;"Søby";"no";0;0;0;56,530833;9,112777
1658;"Søby";"no";0;0;0;56,530833;9,112777
1659;"Søby";"no";0;0;0;56,530833;9,112777
1660;"Søby";"no";0;0;0;56,530833;9,112777
1661;"Søby";"no";0;0;0;56,530833;9,112777
1662;"Søby";"no";0;0;0;56,530833;9,112777
1663;"Søby";"no";0;0;0;56,530833;9,112777
1664;"Søby";"no";0;0;0;56,530833;9,112777
1665;"Søby";"no";1;0;1;56,530833;9,112777
1666;"Søby";"no";0;0;0;56,530833;9,112777
1667;"Søby";"no";0;0;0;56,530833;9,112777
1668;"Søby";"no";0;0;0;56,530833;9,112777
1669;"Søby";"no";0;0;0;56,530833;9,112777
1670;"Søby";"no";0;0;0;56,530833;9,112777
1671;"Søby";"no";0;0;0;56,530833;9,112777
1672;"Søby";"no";0;0;0;56,530833;9,112777
1673;"Søby";"no";0;0;0;56,530833;9,112777
1674;"Søby";"no";0;0;0;56,530833;9,112777
1675;"Søby";"no";0;0;0;56,530833;9,112777
1676;"Søby";"no";0;0;0;56,530833;9,112777
1677;"Søby";"no";0;0;0;56,530833;9,112777
1678;"Søby";"no";0;0;0;56,530833;9,112777
1679;"Søby";"no";0;0;0;56,530833;9,112777
1680;"Søby";"no";0;0;0;56,530833;9,112777
1681;"Søby";"no";0;0;0;56,530833;9,112777
1682;"Søby";"no";0;0;0;56,530833;9,112777
1683;"Søby";"no";0;0;0;56,530833;9,112777
1684;"Søby";"no";0;0;0;56,530833;9,112777
1685;"Søby";"no";0;0;0;56,530833;9,112777
1686;"Søby";"no";0;0;0;56,530833;9,112777
1687;"Søby";"no";0;0;0;56,530833;9,112777
1688;"Søby";"no";0;0;0;56,530833;9,112777
1689;"Søby";"no";0;0;0;56,530833;9,112777
1690;"Søby";"no";0;0;0;56,530833;9,112777
1691;"Søby";"no";0;0;0;56,530833;9,112777
1692;"Søby";"no";0;0;0;56,530833;9,112777
1693;"Søby";"no";0;0;0;56,530833;9,112777
1694;"Søby";"no";0;0;0;56,530833;9,112777
1695;"Søby";"no";0;0;0;56,530833;9,112777
1696;"Søby";"no";0;0;0;56,530833;9,112777
1697;"Søby";"no";0;0;0;56,530833;9,112777
1698;"Søby";"no";0;0;0;56,530833;9,112777
1699;"Søby";"no";0;0;0;56,530833;9,112777
1700;"Søby";"no";0;0;0;56,530833;9,112777
1701;"Søby";"no";0;0;0;56,530833;9,112777
1702;"Søby";"no";0;0;0;56,530833;9,112777
1703;"Søby";"no";0;0;0;56,530833;9,112777
1704;"Søby";"no";0;0;0;56,530833;9,112777
1705;"Søby";"no";0;0;0;56,530833;9,112777
1706;"Søby";"no";0;0;0;56,530833;9,112777
1707;"Søby";"no";0;0;0;56,530833;9,112777
1708;"Søby";"no";0;0;0;56,530833;9,112777
1709;"Søby";"no";0;0;0;56,530833;9,112777
1710;"Søby";"no";0;0;0;56,530833;9,112777
1711;"Søby";"no";0;0;0;56,530833;9,112777
1712;"Søby";"no";0;0;0;56,530833;9,112777
1713;"Søby";"no";0;0;0;56,530833;9,112777
1714;"Søby";"no";0;0;0;56,530833;9,112777
1715;"Søby";"no";0;0;0;56,530833;9,112777
1716;"Søby";"no";0;0;0;56,530833;9,112777
1717;"Søby";"no";0;0;0;56,530833;9,112777
1718;"Søby";"no";0;0;0;56,530833;9,112777
1719;"Søby";"no";0;0;0;56,530833;9,112777
1720;"Søby";"no";0;0;0;56,530833;9,112777
1721;"Søby";"no";0;0;0;56,530833;9,112777
1722;"Søby";"no";0;0;0;56,530833;9,112777
1723;"Søby";"no";0;0;0;56,530833;9,112777
1724;"Søby";"no";0;0;0;56,530833;9,112777
1725;"Søby";"no";0;0;0;56,530833;9,112777
1726;"Søby";"no";0;0;0;56,530833;9,112777
1727;"Søby";"no";0;0;0;56,530833;9,112777
1728;"Søby";"no";0;0;0;56,530833;9,112777
1729;"Søby";"no";0;0;0;56,530833;9,112777
1730;"Søby";"no";0;0;0;56,530833;9,112777
1731;"Søby";"no";0;0;0;56,530833;9,112777
1732;"Søby";"no";0;0;0;56,530833;9,112777
1733;"Søby";"no";0;0;0;56,530833;9,112777
1734;"Søby";"no";0;0;0;56,530833;9,112777
1735;"Søby";"no";0;0;0;56,530833;9,112777
1736;"Søby";"no";0;0;0;56,530833;9,112777
1737;"Søby";"no";0;0;0;56,530833;9,112777
1738;"Søby";"no";0;0;0;56,530833;9,112777
1739;"Søby";"no";0;0;0;56,530833;9,112777
1740;"Søby";"no";0;0;0;56,530833;9,112777
1741;"Søby";"no";0;0;0;56,530833;9,112777
1742;"Søby";"no";0;0;0;56,530833;9,112777
1743;"Søby";"no";0;0;0;56,530833;9,112777
1744;"Søby";"no";0;0;0;56,530833;9,112777
1745;"Søby";"no";0;0;0;56,530833;9,112777
1746;"Søby";"no";0;0;0;56,530833;9,112777
1747;"Søby";"no";0;0;0;56,530833;9,112777
1748;"Søby";"no";0;0;0;56,530833;9,112777
1749;"Søby";"no";0;0;0;56,530833;9,112777
1750;"Søby";"no";0;0;0;56,530833;9,112777
1751;"Søby";"no";0;0;0;56,530833;9,112777
1752;"Søby";"no";0;0;0;56,530833;9,112777
1753;"Søby";"no";0;0;0;56,530833;9,112777
1754;"Søby";"no";0;0;0;56,530833;9,112777
1755;"Søby";"no";0;0;0;56,530833;9,112777
1756;"Søby";"no";0;0;0;56,530833;9,112777
1757;"Søby";"no";0;0;0;56,530833;9,112777
1758;"Søby";"no";0;0;0;56,530833;9,112777
1759;"Søby";"no";0;0;0;56,530833;9,112777
1760;"Søby";"no";0;0;0;56,530833;9,112777
1761;"Søby";"no";0;0;0;56,530833;9,112777
1762;"Søby";"no";0;0;0;56,530833;9,112777
1763;"Søby";"no";0;0;0;56,530833;9,112777
1764;"Søby";"no";0;0;0;56,530833;9,112777
1765;"Søby";"no";0;0;0;56,530833;9,112777
1766;"Søby";"no";0;0;0;56,530833;9,112777
1767;"Søby";"no";0;0;0;56,530833;9,112777
1768;"Søby";"no";0;0;0;56,530833;9,112777
1769;"Søby";"no";0;0;0;56,530833;9,112777
1770;"Søby";"no";0;0;0;56,530833;9,112777
1771;"Søby";"no";0;0;0;56,530833;9,112777
1772;"Søby";"no";0;0;0;56,530833;9,112777
1773;"Søby";"no";0;0;0;56,530833;9,112777
1774;"Søby";"no";0;0;0;56,530833;9,112777
1775;"Søby";"no";0;0;0;56,530833;9,112777
1776;"Søby";"no";0;0;0;56,530833;9,112777
1777;"Søby";"no";0;0;0;56,530833;9,112777
1778;"Søby";"no";0;0;0;56,530833;9,112777
1779;"Søby";"no";0;0;0;56,530833;9,112777
1780;"Søby";"no";0;0;0;56,530833;9,112777
1781;"Søby";"no";0;0;0;56,530833;9,112777
1782;"Søby";"no";0;0;0;56,530833;9,112777
1783;"Søby";"no";0;0;0;56,530833;9,112777
1784;"Søby";"no";0;0;0;56,530833;9,112777
1785;"Søby";"no";0;0;0;56,530833;9,112777
1786;"Søby";"no";0;0;0;56,530833;9,112777
1787;"Søby";"no";0;0;0;56,530833;9,112777
1788;"Søby";"no";0;0;0;56,530833;9,112777
1789;"Søby";"no";0;0;0;56,530833;9,112777
1790;"Søby";"no";0;0;0;56,530833;9,112777
1791;"Søby";"no";0;0;0;56,530833;9,112777
1792;"Søby";"no";0;0;0;56,530833;9,112777
1793;"Søby";"no";0;0;0;56,530833;9,112777
1794;"Søby";"no";0;0;0;56,530833;9,112777
1795;"Søby";"no";0;0;0;56,530833;9,112777
1796;"Søby";"no";0;0;0;56,530833;9,112777
1797;"Søby";"no";0;0;0;56,530833;9,112777
1798;"Søby";"no";0;0;0;56,530833;9,112777
1799;"Søby";"no";0;0;0;56,530833;9,112777
1800;"Søby";"no";0;0;0;56,530833;9,112777
1801;"Søby";"no";0;0;0;56,530833;9,112777
1802;"Søby";"no";0;0;0;56,530833;9,112777
1803;"Søby";"no";0;0;0;56,530833;9,112777
1804;"Søby";"no";0;0;0;56,530833;9,112777
1805;"Søby";"no";0;0;0;56,530833;9,112777
1806;"Søby";"no";0;0;0;56,530833;9,112777
1807;"Søby";"no";0;0;0;56,530833;9,112777
1808;"Søby";"no";0;0;0;56,530833;9,112777
1809;"Søby";"no";0;0;0;56,530833;9,112777
1810;"Søby";"no";0;0;0;56,530833;9,112777
1811;"Søby";"no";0;0;0;56,530833;9,112777
1812;"Søby";"no";0;0;0;56,530833;9,112777
1813;"Søby";"no";0;0;0;56,530833;9,112777
1814;"Søby";"no";0;0;0;56,530833;9,112777
1815;"Søby";"no";0;0;0;56,530833;9,112777
1816;"Søby";"no";0;0;0;56,530833;9,112777
1817;"Søby";"no";0;0;0;56,530833;9,112777
1818;"Søby";"no";0;0;0;56,530833;9,112777
1819;"Søby";"no";0;0;0;56,530833;9,112777
1820;"Søby";"no";0;0;0;56,530833;9,112777
1821;"Søby";"no";0;0;0;56,530833;9,112777
1822;"Søby";"no";0;0;0;56,530833;9,112777
1823;"Søby";"no";0;0;0;56,530833;9,112777
1824;"Søby";"no";0;0;0;56,530833;9,112777
1825;"Søby";"no";0;0;0;56,530833;9,112777
1826;"Søby";"no";0;0;0;56,530833;9,112777
1827;"Søby";"no";0;0;0;56,530833;9,112777
1828;"Søby";"no";0;0;0;56,530833;9,112777
1829;"Søby";"no";0;0;0;56,530833;9,112777
1830;"Søby";"no";0;0;0;56,530833;9,112777
1831;"Søby";"no";0;0;0;56,530833;9,112777
1832;"Søby";"no";0;0;0;56,530833;9,112777
1833;"Søby";"no";0;0;0;56,530833;9,112777
1834;"Søby";"no";0;0;0;56,530833;9,112777
1835;"Søby";"no";0;0;0;56,530833;9,112777
1836;"Søby";"no";0;0;0;56,530833;9,112777
1837;"Søby";"no";0;0;0;56,530833;9,112777
1838;"Søby";"no";0;0;0;56,530833;9,112777
1839;"Søby";"no";0;0;0;56,530833;9,112777
1840;"Søby";"no";0;0;0;56,530833;9,112777
1841;"Søby";"no";0;0;0;56,530833;9,112777
1842;"Søby";"no";0;0;0;56,530833;9,112777
1843;"Søby";"no";0;0;0;56,530833;9,112777
1844;"Søby";"no";0;0;0;56,530833;9,112777
1845;"Søby";"no";0;0;0;56,530833;9,112777
1846;"Søby";"no";1;0;1;56,530833;9,112777
1847;"Søby";"no";0;0;0;56,530833;9,112777
1848;"Søby";"no";0;0;0;56,530833;9,112777
1849;"Søby";"no";0;0;0;56,530833;9,112777
1850;"Søby";"no";0;0;0;56,530833;9,112777
1851;"Søby";"no";0;0;0;56,530833;9,112777
1852;"Søby";"no";0;0;0;56,530833;9,112777
1853;"Søby";"no";0;0;0;56,530833;9,112777
1854;"Søby";"no";0;0;0;56,530833;9,112777
1855;"Søby";"no";0;0;0;56,530833;9,112777
1856;"Søby";"no";0;0;0;56,530833;9,112777
1857;"Søby";"no";0;0;0;56,530833;9,112777
1634;"Ølstad";"no";0;0;0;55,921;12,0644
1635;"Ølstad";"no";0;0;0;55,921;12,0644
1636;"Ølstad";"no";0;0;0;55,921;12,0644
1637;"Ølstad";"no";0;0;0;55,921;12,0644
1638;"Ølstad";"no";0;0;0;55,921;12,0644
1639;"Ølstad";"no";0;0;0;55,921;12,0644
1640;"Ølstad";"no";0;0;0;55,921;12,0644
1641;"Ølstad";"no";0;0;0;55,921;12,0644
1642;"Ølstad";"no";0;0;0;55,921;12,0644
1643;"Ølstad";"no";0;0;0;55,921;12,0644
1644;"Ølstad";"no";0;0;0;55,921;12,0644
1645;"Ølstad";"no";0;0;0;55,921;12,0644
1646;"Ølstad";"no";0;0;0;55,921;12,0644
1647;"Ølstad";"no";0;0;0;55,921;12,0644
1648;"Ølstad";"no";0;0;0;55,921;12,0644
1649;"Ølstad";"no";0;0;0;55,921;12,0644
1650;"Ølstad";"no";0;0;0;55,921;12,0644
1651;"Ølstad";"no";0;0;0;55,921;12,0644
1652;"Ølstad";"no";0;0;0;55,921;12,0644
1653;"Ølstad";"no";0;0;0;55,921;12,0644
1654;"Ølstad";"no";0;0;0;55,921;12,0644
1655;"Ølstad";"no";0;0;0;55,921;12,0644
1656;"Ølstad";"no";0;0;0;55,921;12,0644
1657;"Ølstad";"no";0;0;0;55,921;12,0644
1658;"Ølstad";"no";0;0;0;55,921;12,0644
1659;"Ølstad";"no";0;0;0;55,921;12,0644
1660;"Ølstad";"no";0;0;0;55,921;12,0644
1661;"Ølstad";"no";0;0;0;55,921;12,0644
1662;"Ølstad";"no";0;0;0;55,921;12,0644
1663;"Ølstad";"no";0;0;0;55,921;12,0644
1664;"Ølstad";"no";0;0;0;55,921;12,0644
1665;"Ølstad";"no";1;0;1;55,921;12,0644
1666;"Ølstad";"no";0;0;0;55,921;12,0644
1667;"Ølstad";"no";0;0;0;55,921;12,0644
1668;"Ølstad";"no";0;0;0;55,921;12,0644
1669;"Ølstad";"no";0;0;0;55,921;12,0644
1670;"Ølstad";"no";0;0;0;55,921;12,0644
1671;"Ølstad";"no";0;0;0;55,921;12,0644
1672;"Ølstad";"no";0;0;0;55,921;12,0644
1673;"Ølstad";"no";0;0;0;55,921;12,0644
1674;"Ølstad";"no";0;0;0;55,921;12,0644
1675;"Ølstad";"no";0;0;0;55,921;12,0644
1676;"Ølstad";"no";0;0;0;55,921;12,0644
1677;"Ølstad";"no";0;0;0;55,921;12,0644
1678;"Ølstad";"no";0;0;0;55,921;12,0644
1679;"Ølstad";"no";0;0;0;55,921;12,0644
1680;"Ølstad";"no";0;0;0;55,921;12,0644
1681;"Ølstad";"no";0;0;0;55,921;12,0644
1682;"Ølstad";"no";0;0;0;55,921;12,0644
1683;"Ølstad";"no";0;0;0;55,921;12,0644
1684;"Ølstad";"no";0;0;0;55,921;12,0644
1685;"Ølstad";"no";0;0;0;55,921;12,0644
1686;"Ølstad";"no";0;0;0;55,921;12,0644
1687;"Ølstad";"no";0;0;0;55,921;12,0644
1688;"Ølstad";"no";0;0;0;55,921;12,0644
1689;"Ølstad";"no";0;0;0;55,921;12,0644
1690;"Ølstad";"no";0;0;0;55,921;12,0644
1691;"Ølstad";"no";0;0;0;55,921;12,0644
1692;"Ølstad";"no";0;0;0;55,921;12,0644
1693;"Ølstad";"no";0;0;0;55,921;12,0644
1694;"Ølstad";"no";0;0;0;55,921;12,0644
1695;"Ølstad";"no";0;0;0;55,921;12,0644
1696;"Ølstad";"no";0;0;0;55,921;12,0644
1697;"Ølstad";"no";0;0;0;55,921;12,0644
1698;"Ølstad";"no";0;0;0;55,921;12,0644
1699;"Ølstad";"no";0;0;0;55,921;12,0644
1700;"Ølstad";"no";0;0;0;55,921;12,0644
1701;"Ølstad";"no";0;0;0;55,921;12,0644
1702;"Ølstad";"no";0;0;0;55,921;12,0644
1703;"Ølstad";"no";0;0;0;55,921;12,0644
1704;"Ølstad";"no";0;0;0;55,921;12,0644
1705;"Ølstad";"no";0;0;0;55,921;12,0644
1706;"Ølstad";"no";0;0;0;55,921;12,0644
1707;"Ølstad";"no";0;0;0;55,921;12,0644
1708;"Ølstad";"no";0;0;0;55,921;12,0644
1709;"Ølstad";"no";0;0;0;55,921;12,0644
1710;"Ølstad";"no";0;0;0;55,921;12,0644
1711;"Ølstad";"no";0;0;0;55,921;12,0644
1712;"Ølstad";"no";0;0;0;55,921;12,0644
1713;"Ølstad";"no";0;0;0;55,921;12,0644
1714;"Ølstad";"no";0;0;0;55,921;12,0644
1715;"Ølstad";"no";0;0;0;55,921;12,0644
1716;"Ølstad";"no";0;0;0;55,921;12,0644
1717;"Ølstad";"no";0;0;0;55,921;12,0644
1718;"Ølstad";"no";0;0;0;55,921;12,0644
1719;"Ølstad";"no";0;0;0;55,921;12,0644
1720;"Ølstad";"no";0;0;0;55,921;12,0644
1721;"Ølstad";"no";0;0;0;55,921;12,0644
1722;"Ølstad";"no";0;0;0;55,921;12,0644
1723;"Ølstad";"no";0;0;0;55,921;12,0644
1724;"Ølstad";"no";0;0;0;55,921;12,0644
1725;"Ølstad";"no";0;0;0;55,921;12,0644
1726;"Ølstad";"no";0;0;0;55,921;12,0644
1727;"Ølstad";"no";0;0;0;55,921;12,0644
1728;"Ølstad";"no";0;0;0;55,921;12,0644
1729;"Ølstad";"no";0;0;0;55,921;12,0644
1730;"Ølstad";"no";0;0;0;55,921;12,0644
1731;"Ølstad";"no";0;0;0;55,921;12,0644
1732;"Ølstad";"no";0;0;0;55,921;12,0644
1733;"Ølstad";"no";0;0;0;55,921;12,0644
1734;"Ølstad";"no";0;0;0;55,921;12,0644
1735;"Ølstad";"no";0;0;0;55,921;12,0644
1736;"Ølstad";"no";0;0;0;55,921;12,0644
1737;"Ølstad";"no";0;0;0;55,921;12,0644
1738;"Ølstad";"no";0;0;0;55,921;12,0644
1739;"Ølstad";"no";0;0;0;55,921;12,0644
1740;"Ølstad";"no";0;0;0;55,921;12,0644
1741;"Ølstad";"no";0;0;0;55,921;12,0644
1742;"Ølstad";"no";0;0;0;55,921;12,0644
1743;"Ølstad";"no";0;0;0;55,921;12,0644
1744;"Ølstad";"no";0;0;0;55,921;12,0644
1745;"Ølstad";"no";0;0;0;55,921;12,0644
1746;"Ølstad";"no";0;0;0;55,921;12,0644
1747;"Ølstad";"no";0;0;0;55,921;12,0644
1748;"Ølstad";"no";0;0;0;55,921;12,0644
1749;"Ølstad";"no";0;0;0;55,921;12,0644
1750;"Ølstad";"no";0;0;0;55,921;12,0644
1751;"Ølstad";"no";0;0;0;55,921;12,0644
1752;"Ølstad";"no";0;0;0;55,921;12,0644
1753;"Ølstad";"no";0;0;0;55,921;12,0644
1754;"Ølstad";"no";0;0;0;55,921;12,0644
1755;"Ølstad";"no";0;0;0;55,921;12,0644
1756;"Ølstad";"no";0;0;0;55,921;12,0644
1757;"Ølstad";"no";0;0;0;55,921;12,0644
1758;"Ølstad";"no";0;0;0;55,921;12,0644
1759;"Ølstad";"no";0;0;0;55,921;12,0644
1760;"Ølstad";"no";0;0;0;55,921;12,0644
1761;"Ølstad";"no";0;0;0;55,921;12,0644
1762;"Ølstad";"no";0;0;0;55,921;12,0644
1763;"Ølstad";"no";0;0;0;55,921;12,0644
1764;"Ølstad";"no";0;0;0;55,921;12,0644
1765;"Ølstad";"no";0;0;0;55,921;12,0644
1766;"Ølstad";"no";0;0;0;55,921;12,0644
1767;"Ølstad";"no";0;0;0;55,921;12,0644
1768;"Ølstad";"no";0;0;0;55,921;12,0644
1769;"Ølstad";"no";0;0;0;55,921;12,0644
1770;"Ølstad";"no";0;0;0;55,921;12,0644
1771;"Ølstad";"no";0;0;0;55,921;12,0644
1772;"Ølstad";"no";0;0;0;55,921;12,0644
1773;"Ølstad";"no";0;0;0;55,921;12,0644
1774;"Ølstad";"no";0;0;0;55,921;12,0644
1775;"Ølstad";"no";0;0;0;55,921;12,0644
1776;"Ølstad";"no";0;0;0;55,921;12,0644
1777;"Ølstad";"no";0;0;0;55,921;12,0644
1778;"Ølstad";"no";0;0;0;55,921;12,0644
1779;"Ølstad";"no";0;0;0;55,921;12,0644
1780;"Ølstad";"no";0;0;0;55,921;12,0644
1781;"Ølstad";"no";0;0;0;55,921;12,0644
1782;"Ølstad";"no";0;0;0;55,921;12,0644
1783;"Ølstad";"no";0;0;0;55,921;12,0644
1784;"Ølstad";"no";0;0;0;55,921;12,0644
1785;"Ølstad";"no";0;0;0;55,921;12,0644
1786;"Ølstad";"no";0;0;0;55,921;12,0644
1787;"Ølstad";"no";0;0;0;55,921;12,0644
1788;"Ølstad";"no";0;0;0;55,921;12,0644
1789;"Ølstad";"no";0;0;0;55,921;12,0644
1790;"Ølstad";"no";0;0;0;55,921;12,0644
1791;"Ølstad";"no";0;0;0;55,921;12,0644
1792;"Ølstad";"no";0;0;0;55,921;12,0644
1793;"Ølstad";"no";0;0;0;55,921;12,0644
1794;"Ølstad";"no";0;0;0;55,921;12,0644
1795;"Ølstad";"no";0;0;0;55,921;12,0644
1796;"Ølstad";"no";0;0;0;55,921;12,0644
1797;"Ølstad";"no";0;0;0;55,921;12,0644
1798;"Ølstad";"no";0;0;0;55,921;12,0644
1799;"Ølstad";"no";0;0;0;55,921;12,0644
1800;"Ølstad";"no";0;0;0;55,921;12,0644
1801;"Ølstad";"no";0;0;0;55,921;12,0644
1802;"Ølstad";"no";0;0;0;55,921;12,0644
1803;"Ølstad";"no";0;0;0;55,921;12,0644
1804;"Ølstad";"no";0;0;0;55,921;12,0644
1805;"Ølstad";"no";0;0;0;55,921;12,0644
1806;"Ølstad";"no";0;0;0;55,921;12,0644
1807;"Ølstad";"no";0;0;0;55,921;12,0644
1808;"Ølstad";"no";0;0;0;55,921;12,0644
1809;"Ølstad";"no";0;0;0;55,921;12,0644
1810;"Ølstad";"no";0;0;0;55,921;12,0644
1811;"Ølstad";"no";0;0;0;55,921;12,0644
1812;"Ølstad";"no";0;0;0;55,921;12,0644
1813;"Ølstad";"no";0;0;0;55,921;12,0644
1814;"Ølstad";"no";0;0;0;55,921;12,0644
1815;"Ølstad";"no";0;0;0;55,921;12,0644
1816;"Ølstad";"no";0;0;0;55,921;12,0644
1817;"Ølstad";"no";0;0;0;55,921;12,0644
1818;"Ølstad";"no";0;0;0;55,921;12,0644
1819;"Ølstad";"no";0;0;0;55,921;12,0644
1820;"Ølstad";"no";0;0;0;55,921;12,0644
1821;"Ølstad";"no";0;0;0;55,921;12,0644
1822;"Ølstad";"no";0;0;0;55,921;12,0644
1823;"Ølstad";"no";0;0;0;55,921;12,0644
1824;"Ølstad";"no";0;0;0;55,921;12,0644
1825;"Ølstad";"no";0;0;0;55,921;12,0644
1826;"Ølstad";"no";0;0;0;55,921;12,0644
1827;"Ølstad";"no";0;0;0;55,921;12,0644
1828;"Ølstad";"no";0;0;0;55,921;12,0644
1829;"Ølstad";"no";0;0;0;55,921;12,0644
1830;"Ølstad";"no";0;0;0;55,921;12,0644
1831;"Ølstad";"no";0;0;0;55,921;12,0644
1832;"Ølstad";"no";0;0;0;55,921;12,0644
1833;"Ølstad";"no";0;0;0;55,921;12,0644
1834;"Ølstad";"no";0;0;0;55,921;12,0644
1835;"Ølstad";"no";0;0;0;55,921;12,0644
1836;"Ølstad";"no";0;0;0;55,921;12,0644
1837;"Ølstad";"no";0;0;0;55,921;12,0644
1838;"Ølstad";"no";0;0;0;55,921;12,0644
1839;"Ølstad";"no";0;0;0;55,921;12,0644
1840;"Ølstad";"no";0;0;0;55,921;12,0644
1841;"Ølstad";"no";0;0;0;55,921;12,0644
1842;"Ølstad";"no";0;0;0;55,921;12,0644
1843;"Ølstad";"no";0;0;0;55,921;12,0644
1844;"Ølstad";"no";0;0;0;55,921;12,0644
1845;"Ølstad";"no";0;0;0;55,921;12,0644
1846;"Ølstad";"no";0;0;0;55,921;12,0644
1847;"Ølstad";"no";0;0;0;55,921;12,0644
1848;"Ølstad";"no";0;0;0;55,921;12,0644
1849;"Ølstad";"no";0;0;0;55,921;12,0644
1850;"Ølstad";"no";0;0;0;55,921;12,0644
1851;"Ølstad";"no";0;0;0;55,921;12,0644
1852;"Ølstad";"no";0;0;0;55,921;12,0644
1853;"Ølstad";"no";0;0;0;55,921;12,0644
1854;"Ølstad";"no";0;0;0;55,921;12,0644
1855;"Ølstad";"no";0;0;0;55,921;12,0644
1856;"Ølstad";"no";0;0;0;55,921;12,0644
1857;"Ølstad";"no";0;0;0;55,921;12,0644
1634;"Fredericia";"no";0;0;0;55,565555;9,7525
1635;"Fredericia";"no";0;0;0;55,565555;9,7525
1636;"Fredericia";"no";0;0;0;55,565555;9,7525
1637;"Fredericia";"no";0;0;0;55,565555;9,7525
1638;"Fredericia";"no";0;0;0;55,565555;9,7525
1639;"Fredericia";"no";0;0;0;55,565555;9,7525
1640;"Fredericia";"no";0;0;0;55,565555;9,7525
1641;"Fredericia";"no";0;0;0;55,565555;9,7525
1642;"Fredericia";"no";0;0;0;55,565555;9,7525
1643;"Fredericia";"no";0;0;0;55,565555;9,7525
1644;"Fredericia";"no";0;0;0;55,565555;9,7525
1645;"Fredericia";"no";0;0;0;55,565555;9,7525
1646;"Fredericia";"no";0;0;0;55,565555;9,7525
1647;"Fredericia";"no";0;0;0;55,565555;9,7525
1648;"Fredericia";"no";0;0;0;55,565555;9,7525
1649;"Fredericia";"no";0;0;0;55,565555;9,7525
1650;"Fredericia";"no";0;0;0;55,565555;9,7525
1651;"Fredericia";"no";0;0;0;55,565555;9,7525
1652;"Fredericia";"no";0;0;0;55,565555;9,7525
1653;"Fredericia";"no";0;0;0;55,565555;9,7525
1654;"Fredericia";"no";0;0;0;55,565555;9,7525
1655;"Fredericia";"no";0;0;0;55,565555;9,7525
1656;"Fredericia";"no";0;0;0;55,565555;9,7525
1657;"Fredericia";"no";0;1;1;55,565555;9,7525
1658;"Fredericia";"no";0;0;0;55,565555;9,7525
1659;"Fredericia";"no";0;0;0;55,565555;9,7525
1660;"Fredericia";"no";0;0;0;55,565555;9,7525
1661;"Fredericia";"no";0;0;0;55,565555;9,7525
1662;"Fredericia";"no";0;0;0;55,565555;9,7525
1663;"Fredericia";"no";0;0;0;55,565555;9,7525
1664;"Fredericia";"no";0;0;0;55,565555;9,7525
1665;"Fredericia";"no";0;0;0;55,565555;9,7525
1666;"Fredericia";"no";1;1;2;55,565555;9,7525
1667;"Fredericia";"no";0;0;0;55,565555;9,7525
1668;"Fredericia";"no";0;0;0;55,565555;9,7525
1669;"Fredericia";"no";0;0;0;55,565555;9,7525
1670;"Fredericia";"no";0;0;0;55,565555;9,7525
1671;"Fredericia";"no";0;0;0;55,565555;9,7525
1672;"Fredericia";"no";0;0;0;55,565555;9,7525
1673;"Fredericia";"no";0;0;0;55,565555;9,7525
1674;"Fredericia";"no";0;0;0;55,565555;9,7525
1675;"Fredericia";"no";0;0;0;55,565555;9,7525
1676;"Fredericia";"no";0;0;0;55,565555;9,7525
1677;"Fredericia";"no";1;0;1;55,565555;9,7525
1678;"Fredericia";"no";0;1;1;55,565555;9,7525
1679;"Fredericia";"no";0;0;0;55,565555;9,7525
1680;"Fredericia";"no";0;0;0;55,565555;9,7525
1681;"Fredericia";"no";0;0;0;55,565555;9,7525
1682;"Fredericia";"no";0;0;0;55,565555;9,7525
1683;"Fredericia";"no";0;0;0;55,565555;9,7525
1684;"Fredericia";"no";0;0;0;55,565555;9,7525
1685;"Fredericia";"no";0;0;0;55,565555;9,7525
1686;"Fredericia";"no";0;0;0;55,565555;9,7525
1687;"Fredericia";"no";0;0;0;55,565555;9,7525
1688;"Fredericia";"no";0;0;0;55,565555;9,7525
1689;"Fredericia";"no";0;0;0;55,565555;9,7525
1690;"Fredericia";"no";0;0;0;55,565555;9,7525
1691;"Fredericia";"no";0;0;0;55,565555;9,7525
1692;"Fredericia";"no";0;0;0;55,565555;9,7525
1693;"Fredericia";"no";0;0;0;55,565555;9,7525
1694;"Fredericia";"no";0;0;0;55,565555;9,7525
1695;"Fredericia";"no";0;0;0;55,565555;9,7525
1696;"Fredericia";"no";0;0;0;55,565555;9,7525
1697;"Fredericia";"no";0;0;0;55,565555;9,7525
1698;"Fredericia";"no";0;0;0;55,565555;9,7525
1699;"Fredericia";"no";0;0;0;55,565555;9,7525
1700;"Fredericia";"no";0;0;0;55,565555;9,7525
1701;"Fredericia";"no";0;0;0;55,565555;9,7525
1702;"Fredericia";"no";0;0;0;55,565555;9,7525
1703;"Fredericia";"no";0;0;0;55,565555;9,7525
1704;"Fredericia";"no";0;0;0;55,565555;9,7525
1705;"Fredericia";"no";0;0;0;55,565555;9,7525
1706;"Fredericia";"no";0;0;0;55,565555;9,7525
1707;"Fredericia";"no";0;0;0;55,565555;9,7525
1708;"Fredericia";"no";0;0;0;55,565555;9,7525
1709;"Fredericia";"no";0;0;0;55,565555;9,7525
1710;"Fredericia";"no";0;0;0;55,565555;9,7525
1711;"Fredericia";"no";0;0;0;55,565555;9,7525
1712;"Fredericia";"no";0;0;0;55,565555;9,7525
1713;"Fredericia";"no";0;0;0;55,565555;9,7525
1714;"Fredericia";"no";0;0;0;55,565555;9,7525
1715;"Fredericia";"no";0;0;0;55,565555;9,7525
1716;"Fredericia";"no";0;0;0;55,565555;9,7525
1717;"Fredericia";"no";0;0;0;55,565555;9,7525
1718;"Fredericia";"no";0;0;0;55,565555;9,7525
1719;"Fredericia";"no";0;0;0;55,565555;9,7525
1720;"Fredericia";"no";0;0;0;55,565555;9,7525
1721;"Fredericia";"no";0;0;0;55,565555;9,7525
1722;"Fredericia";"no";0;0;0;55,565555;9,7525
1723;"Fredericia";"no";0;0;0;55,565555;9,7525
1724;"Fredericia";"no";0;0;0;55,565555;9,7525
1725;"Fredericia";"no";0;0;0;55,565555;9,7525
1726;"Fredericia";"no";0;0;0;55,565555;9,7525
1727;"Fredericia";"no";0;0;0;55,565555;9,7525
1728;"Fredericia";"no";0;0;0;55,565555;9,7525
1729;"Fredericia";"no";0;0;0;55,565555;9,7525
1730;"Fredericia";"no";0;0;0;55,565555;9,7525
1731;"Fredericia";"no";0;0;0;55,565555;9,7525
1732;"Fredericia";"no";0;0;0;55,565555;9,7525
1733;"Fredericia";"no";0;0;0;55,565555;9,7525
1734;"Fredericia";"no";0;0;0;55,565555;9,7525
1735;"Fredericia";"no";0;0;0;55,565555;9,7525
1736;"Fredericia";"no";0;0;0;55,565555;9,7525
1737;"Fredericia";"no";0;0;0;55,565555;9,7525
1738;"Fredericia";"no";0;0;0;55,565555;9,7525
1739;"Fredericia";"no";0;0;0;55,565555;9,7525
1740;"Fredericia";"no";0;0;0;55,565555;9,7525
1741;"Fredericia";"no";0;0;0;55,565555;9,7525
1742;"Fredericia";"no";0;0;0;55,565555;9,7525
1743;"Fredericia";"no";0;0;0;55,565555;9,7525
1744;"Fredericia";"no";0;0;0;55,565555;9,7525
1745;"Fredericia";"no";0;0;0;55,565555;9,7525
1746;"Fredericia";"no";0;0;0;55,565555;9,7525
1747;"Fredericia";"no";0;0;0;55,565555;9,7525
1748;"Fredericia";"no";0;0;0;55,565555;9,7525
1749;"Fredericia";"no";0;0;0;55,565555;9,7525
1750;"Fredericia";"no";0;0;0;55,565555;9,7525
1751;"Fredericia";"no";0;0;0;55,565555;9,7525
1752;"Fredericia";"no";0;0;0;55,565555;9,7525
1753;"Fredericia";"no";0;0;0;55,565555;9,7525
1754;"Fredericia";"no";0;0;0;55,565555;9,7525
1755;"Fredericia";"no";0;0;0;55,565555;9,7525
1756;"Fredericia";"no";0;0;0;55,565555;9,7525
1757;"Fredericia";"no";0;0;0;55,565555;9,7525
1758;"Fredericia";"no";0;1;1;55,565555;9,7525
1759;"Fredericia";"no";0;0;0;55,565555;9,7525
1760;"Fredericia";"no";0;0;0;55,565555;9,7525
1761;"Fredericia";"no";0;0;0;55,565555;9,7525
1762;"Fredericia";"no";0;0;0;55,565555;9,7525
1763;"Fredericia";"no";1;1;2;55,565555;9,7525
1764;"Fredericia";"no";0;0;0;55,565555;9,7525
1765;"Fredericia";"no";0;0;0;55,565555;9,7525
1766;"Fredericia";"no";0;0;0;55,565555;9,7525
1767;"Fredericia";"no";0;0;0;55,565555;9,7525
1768;"Fredericia";"no";0;0;0;55,565555;9,7525
1769;"Fredericia";"no";0;0;0;55,565555;9,7525
1770;"Fredericia";"no";0;0;0;55,565555;9,7525
1771;"Fredericia";"no";0;0;0;55,565555;9,7525
1772;"Fredericia";"no";0;0;0;55,565555;9,7525
1773;"Fredericia";"no";0;1;1;55,565555;9,7525
1774;"Fredericia";"no";0;0;0;55,565555;9,7525
1775;"Fredericia";"no";0;0;0;55,565555;9,7525
1776;"Fredericia";"no";0;0;0;55,565555;9,7525
1777;"Fredericia";"no";0;0;0;55,565555;9,7525
1778;"Fredericia";"no";0;0;0;55,565555;9,7525
1779;"Fredericia";"no";0;0;0;55,565555;9,7525
1780;"Fredericia";"no";0;0;0;55,565555;9,7525
1781;"Fredericia";"no";0;0;0;55,565555;9,7525
1782;"Fredericia";"no";0;0;0;55,565555;9,7525
1783;"Fredericia";"no";0;0;0;55,565555;9,7525
1784;"Fredericia";"no";0;0;0;55,565555;9,7525
1785;"Fredericia";"no";0;0;0;55,565555;9,7525
1786;"Fredericia";"no";0;0;0;55,565555;9,7525
1787;"Fredericia";"no";0;0;0;55,565555;9,7525
1788;"Fredericia";"no";0;0;0;55,565555;9,7525
1789;"Fredericia";"no";0;0;0;55,565555;9,7525
1790;"Fredericia";"no";0;0;0;55,565555;9,7525
1791;"Fredericia";"no";0;0;0;55,565555;9,7525
1792;"Fredericia";"no";0;0;0;55,565555;9,7525
1793;"Fredericia";"no";0;0;0;55,565555;9,7525
1794;"Fredericia";"no";0;0;0;55,565555;9,7525
1795;"Fredericia";"no";0;0;0;55,565555;9,7525
1796;"Fredericia";"no";0;0;0;55,565555;9,7525
1797;"Fredericia";"no";0;0;0;55,565555;9,7525
1798;"Fredericia";"no";0;1;1;55,565555;9,7525
1799;"Fredericia";"no";0;0;0;55,565555;9,7525
1800;"Fredericia";"no";0;0;0;55,565555;9,7525
1801;"Fredericia";"no";0;1;1;55,565555;9,7525
1802;"Fredericia";"no";0;0;0;55,565555;9,7525
1803;"Fredericia";"no";0;0;0;55,565555;9,7525
1804;"Fredericia";"no";0;0;0;55,565555;9,7525
1805;"Fredericia";"no";0;0;0;55,565555;9,7525
1806;"Fredericia";"no";0;0;0;55,565555;9,7525
1807;"Fredericia";"no";0;0;0;55,565555;9,7525
1808;"Fredericia";"no";0;0;0;55,565555;9,7525
1809;"Fredericia";"no";0;0;0;55,565555;9,7525
1810;"Fredericia";"no";0;0;0;55,565555;9,7525
1811;"Fredericia";"no";0;0;0;55,565555;9,7525
1812;"Fredericia";"no";0;1;1;55,565555;9,7525
1813;"Fredericia";"no";0;1;1;55,565555;9,7525
1814;"Fredericia";"no";0;0;0;55,565555;9,7525
1815;"Fredericia";"no";0;0;0;55,565555;9,7525
1816;"Fredericia";"no";0;0;0;55,565555;9,7525
1817;"Fredericia";"no";0;0;0;55,565555;9,7525
1818;"Fredericia";"no";1;0;1;55,565555;9,7525
1819;"Fredericia";"no";0;0;0;55,565555;9,7525
1820;"Fredericia";"no";0;0;0;55,565555;9,7525
1821;"Fredericia";"no";0;1;1;55,565555;9,7525
1822;"Fredericia";"no";0;0;0;55,565555;9,7525
1823;"Fredericia";"no";0;0;0;55,565555;9,7525
1824;"Fredericia";"no";0;0;0;55,565555;9,7525
1825;"Fredericia";"no";0;0;0;55,565555;9,7525
1826;"Fredericia";"no";0;0;0;55,565555;9,7525
1827;"Fredericia";"no";2;0;2;55,565555;9,7525
1828;"Fredericia";"no";0;0;0;55,565555;9,7525
1829;"Fredericia";"no";3;0;3;55,565555;9,7525
1830;"Fredericia";"no";1;0;1;55,565555;9,7525
1831;"Fredericia";"no";0;0;0;55,565555;9,7525
1832;"Fredericia";"no";3;0;3;55,565555;9,7525
1833;"Fredericia";"no";0;0;0;55,565555;9,7525
1834;"Fredericia";"no";0;0;0;55,565555;9,7525
1835;"Fredericia";"no";0;0;0;55,565555;9,7525
1836;"Fredericia";"no";0;0;0;55,565555;9,7525
1837;"Fredericia";"no";0;1;1;55,565555;9,7525
1838;"Fredericia";"no";0;0;0;55,565555;9,7525
1839;"Fredericia";"no";0;0;0;55,565555;9,7525
1840;"Fredericia";"no";0;0;0;55,565555;9,7525
1841;"Fredericia";"no";0;0;0;55,565555;9,7525
1842;"Fredericia";"no";1;0;1;55,565555;9,7525
1843;"Fredericia";"no";0;0;0;55,565555;9,7525
1844;"Fredericia";"no";0;0;0;55,565555;9,7525
1845;"Fredericia";"no";0;0;0;55,565555;9,7525
1846;"Fredericia";"no";0;1;1;55,565555;9,7525
1847;"Fredericia";"no";2;0;2;55,565555;9,7525
1848;"Fredericia";"no";1;0;1;55,565555;9,7525
1849;"Fredericia";"no";2;4;6;55,565555;9,7525
1850;"Fredericia";"no";1;0;1;55,565555;9,7525
1851;"Fredericia";"no";2;0;2;55,565555;9,7525
1852;"Fredericia";"no";2;0;2;55,565555;9,7525
1853;"Fredericia";"no";0;0;0;55,565555;9,7525
1854;"Fredericia";"no";2;0;2;55,565555;9,7525
1855;"Fredericia";"no";2;0;2;55,565555;9,7525
1856;"Fredericia";"no";0;2;2;55,565555;9,7525
1857;"Fredericia";"no";0;0;0;55,565555;9,7525
1634;"Frederikssund";"no";0;0;0;55,839444;12,068888
1635;"Frederikssund";"no";0;0;0;55,839444;12,068888
1636;"Frederikssund";"no";0;0;0;55,839444;12,068888
1637;"Frederikssund";"no";0;0;0;55,839444;12,068888
1638;"Frederikssund";"no";0;0;0;55,839444;12,068888
1639;"Frederikssund";"no";0;0;0;55,839444;12,068888
1640;"Frederikssund";"no";0;0;0;55,839444;12,068888
1641;"Frederikssund";"no";0;0;0;55,839444;12,068888
1642;"Frederikssund";"no";0;0;0;55,839444;12,068888
1643;"Frederikssund";"no";0;0;0;55,839444;12,068888
1644;"Frederikssund";"no";0;0;0;55,839444;12,068888
1645;"Frederikssund";"no";0;0;0;55,839444;12,068888
1646;"Frederikssund";"no";0;0;0;55,839444;12,068888
1647;"Frederikssund";"no";0;0;0;55,839444;12,068888
1648;"Frederikssund";"no";0;0;0;55,839444;12,068888
1649;"Frederikssund";"no";0;0;0;55,839444;12,068888
1650;"Frederikssund";"no";0;0;0;55,839444;12,068888
1651;"Frederikssund";"no";0;0;0;55,839444;12,068888
1652;"Frederikssund";"no";0;0;0;55,839444;12,068888
1653;"Frederikssund";"no";0;0;0;55,839444;12,068888
1654;"Frederikssund";"no";0;0;0;55,839444;12,068888
1655;"Frederikssund";"no";0;0;0;55,839444;12,068888
1656;"Frederikssund";"no";0;0;0;55,839444;12,068888
1657;"Frederikssund";"no";0;0;0;55,839444;12,068888
1658;"Frederikssund";"no";0;0;0;55,839444;12,068888
1659;"Frederikssund";"no";0;0;0;55,839444;12,068888
1660;"Frederikssund";"no";0;0;0;55,839444;12,068888
1661;"Frederikssund";"no";0;0;0;55,839444;12,068888
1662;"Frederikssund";"no";0;0;0;55,839444;12,068888
1663;"Frederikssund";"no";0;2;2;55,839444;12,068888
1664;"Frederikssund";"no";0;1;1;55,839444;12,068888
1665;"Frederikssund";"no";0;0;0;55,839444;12,068888
1666;"Frederikssund";"no";1;1;2;55,839444;12,068888
1667;"Frederikssund";"no";1;0;1;55,839444;12,068888
1668;"Frederikssund";"no";2;3;5;55,839444;12,068888
1669;"Frederikssund";"no";0;0;0;55,839444;12,068888
1670;"Frederikssund";"no";0;1;1;55,839444;12,068888
1671;"Frederikssund";"no";1;2;3;55,839444;12,068888
1672;"Frederikssund";"no";0;0;0;55,839444;12,068888
1673;"Frederikssund";"no";0;1;1;55,839444;12,068888
1674;"Frederikssund";"no";0;0;0;55,839444;12,068888
1675;"Frederikssund";"no";0;0;0;55,839444;12,068888
1676;"Frederikssund";"no";0;0;0;55,839444;12,068888
1677;"Frederikssund";"no";0;0;0;55,839444;12,068888
1678;"Frederikssund";"no";0;0;0;55,839444;12,068888
1679;"Frederikssund";"no";0;0;0;55,839444;12,068888
1680;"Frederikssund";"no";0;0;0;55,839444;12,068888
1681;"Frederikssund";"no";0;0;0;55,839444;12,068888
1682;"Frederikssund";"no";0;0;0;55,839444;12,068888
1683;"Frederikssund";"no";0;0;0;55,839444;12,068888
1684;"Frederikssund";"no";0;0;0;55,839444;12,068888
1685;"Frederikssund";"no";0;0;0;55,839444;12,068888
1686;"Frederikssund";"no";0;0;0;55,839444;12,068888
1687;"Frederikssund";"no";0;0;0;55,839444;12,068888
1688;"Frederikssund";"no";0;0;0;55,839444;12,068888
1689;"Frederikssund";"no";0;0;0;55,839444;12,068888
1690;"Frederikssund";"no";0;0;0;55,839444;12,068888
1691;"Frederikssund";"no";0;0;0;55,839444;12,068888
1692;"Frederikssund";"no";0;0;0;55,839444;12,068888
1693;"Frederikssund";"no";0;0;0;55,839444;12,068888
1694;"Frederikssund";"no";0;0;0;55,839444;12,068888
1695;"Frederikssund";"no";0;0;0;55,839444;12,068888
1696;"Frederikssund";"no";0;1;1;55,839444;12,068888
1697;"Frederikssund";"no";0;0;0;55,839444;12,068888
1698;"Frederikssund";"no";0;0;0;55,839444;12,068888
1699;"Frederikssund";"no";0;0;0;55,839444;12,068888
1700;"Frederikssund";"no";0;0;0;55,839444;12,068888
1701;"Frederikssund";"no";0;0;0;55,839444;12,068888
1702;"Frederikssund";"no";0;0;0;55,839444;12,068888
1703;"Frederikssund";"no";0;0;0;55,839444;12,068888
1704;"Frederikssund";"no";0;0;0;55,839444;12,068888
1705;"Frederikssund";"no";0;0;0;55,839444;12,068888
1706;"Frederikssund";"no";0;0;0;55,839444;12,068888
1707;"Frederikssund";"no";0;0;0;55,839444;12,068888
1708;"Frederikssund";"no";0;0;0;55,839444;12,068888
1709;"Frederikssund";"no";0;0;0;55,839444;12,068888
1710;"Frederikssund";"no";0;0;0;55,839444;12,068888
1711;"Frederikssund";"no";0;0;0;55,839444;12,068888
1712;"Frederikssund";"no";0;0;0;55,839444;12,068888
1713;"Frederikssund";"no";0;0;0;55,839444;12,068888
1714;"Frederikssund";"no";0;0;0;55,839444;12,068888
1715;"Frederikssund";"no";0;0;0;55,839444;12,068888
1716;"Frederikssund";"no";0;0;0;55,839444;12,068888
1717;"Frederikssund";"no";0;0;0;55,839444;12,068888
1718;"Frederikssund";"no";0;0;0;55,839444;12,068888
1719;"Frederikssund";"no";0;0;0;55,839444;12,068888
1720;"Frederikssund";"no";0;0;0;55,839444;12,068888
1721;"Frederikssund";"no";0;0;0;55,839444;12,068888
1722;"Frederikssund";"no";0;0;0;55,839444;12,068888
1723;"Frederikssund";"no";0;0;0;55,839444;12,068888
1724;"Frederikssund";"no";0;0;0;55,839444;12,068888
1725;"Frederikssund";"no";0;0;0;55,839444;12,068888
1726;"Frederikssund";"no";0;0;0;55,839444;12,068888
1727;"Frederikssund";"no";0;0;0;55,839444;12,068888
1728;"Frederikssund";"no";0;0;0;55,839444;12,068888
1729;"Frederikssund";"no";0;0;0;55,839444;12,068888
1730;"Frederikssund";"no";0;0;0;55,839444;12,068888
1731;"Frederikssund";"no";0;0;0;55,839444;12,068888
1732;"Frederikssund";"no";0;1;1;55,839444;12,068888
1733;"Frederikssund";"no";0;0;0;55,839444;12,068888
1734;"Frederikssund";"no";0;0;0;55,839444;12,068888
1735;"Frederikssund";"no";0;0;0;55,839444;12,068888
1736;"Frederikssund";"no";0;0;0;55,839444;12,068888
1737;"Frederikssund";"no";0;0;0;55,839444;12,068888
1738;"Frederikssund";"no";0;0;0;55,839444;12,068888
1739;"Frederikssund";"no";0;0;0;55,839444;12,068888
1740;"Frederikssund";"no";0;0;0;55,839444;12,068888
1741;"Frederikssund";"no";0;0;0;55,839444;12,068888
1742;"Frederikssund";"no";0;0;0;55,839444;12,068888
1743;"Frederikssund";"no";0;0;0;55,839444;12,068888
1744;"Frederikssund";"no";0;0;0;55,839444;12,068888
1745;"Frederikssund";"no";0;0;0;55,839444;12,068888
1746;"Frederikssund";"no";0;0;0;55,839444;12,068888
1747;"Frederikssund";"no";0;0;0;55,839444;12,068888
1748;"Frederikssund";"no";0;0;0;55,839444;12,068888
1749;"Frederikssund";"no";0;0;0;55,839444;12,068888
1750;"Frederikssund";"no";0;0;0;55,839444;12,068888
1751;"Frederikssund";"no";0;0;0;55,839444;12,068888
1752;"Frederikssund";"no";0;0;0;55,839444;12,068888
1753;"Frederikssund";"no";0;0;0;55,839444;12,068888
1754;"Frederikssund";"no";0;0;0;55,839444;12,068888
1755;"Frederikssund";"no";0;0;0;55,839444;12,068888
1756;"Frederikssund";"no";0;0;0;55,839444;12,068888
1757;"Frederikssund";"no";0;0;0;55,839444;12,068888
1758;"Frederikssund";"no";0;0;0;55,839444;12,068888
1759;"Frederikssund";"no";0;0;0;55,839444;12,068888
1760;"Frederikssund";"no";0;0;0;55,839444;12,068888
1761;"Frederikssund";"no";0;0;0;55,839444;12,068888
1762;"Frederikssund";"no";0;0;0;55,839444;12,068888
1763;"Frederikssund";"no";0;1;1;55,839444;12,068888
1764;"Frederikssund";"no";0;0;0;55,839444;12,068888
1765;"Frederikssund";"no";0;0;0;55,839444;12,068888
1766;"Frederikssund";"no";0;0;0;55,839444;12,068888
1767;"Frederikssund";"no";0;0;0;55,839444;12,068888
1768;"Frederikssund";"no";0;0;0;55,839444;12,068888
1769;"Frederikssund";"no";0;0;0;55,839444;12,068888
1770;"Frederikssund";"no";0;0;0;55,839444;12,068888
1771;"Frederikssund";"no";0;0;0;55,839444;12,068888
1772;"Frederikssund";"no";0;0;0;55,839444;12,068888
1773;"Frederikssund";"no";0;0;0;55,839444;12,068888
1774;"Frederikssund";"no";0;0;0;55,839444;12,068888
1775;"Frederikssund";"no";0;0;0;55,839444;12,068888
1776;"Frederikssund";"no";0;0;0;55,839444;12,068888
1777;"Frederikssund";"no";0;0;0;55,839444;12,068888
1778;"Frederikssund";"no";0;0;0;55,839444;12,068888
1779;"Frederikssund";"no";0;0;0;55,839444;12,068888
1780;"Frederikssund";"no";0;0;0;55,839444;12,068888
1781;"Frederikssund";"no";0;1;1;55,839444;12,068888
1782;"Frederikssund";"no";0;0;0;55,839444;12,068888
1783;"Frederikssund";"no";0;0;0;55,839444;12,068888
1784;"Frederikssund";"no";0;0;0;55,839444;12,068888
1785;"Frederikssund";"no";0;0;0;55,839444;12,068888
1786;"Frederikssund";"no";0;1;1;55,839444;12,068888
1787;"Frederikssund";"no";0;0;0;55,839444;12,068888
1788;"Frederikssund";"no";0;0;0;55,839444;12,068888
1789;"Frederikssund";"no";0;0;0;55,839444;12,068888
1790;"Frederikssund";"no";0;1;1;55,839444;12,068888
1791;"Frederikssund";"no";0;0;0;55,839444;12,068888
1792;"Frederikssund";"no";0;0;0;55,839444;12,068888
1793;"Frederikssund";"no";0;0;0;55,839444;12,068888
1794;"Frederikssund";"no";0;0;0;55,839444;12,068888
1795;"Frederikssund";"no";0;0;0;55,839444;12,068888
1796;"Frederikssund";"no";0;0;0;55,839444;12,068888
1797;"Frederikssund";"no";0;0;0;55,839444;12,068888
1798;"Frederikssund";"no";0;0;0;55,839444;12,068888
1799;"Frederikssund";"no";0;0;0;55,839444;12,068888
1800;"Frederikssund";"no";0;0;0;55,839444;12,068888
1801;"Frederikssund";"no";0;0;0;55,839444;12,068888
1802;"Frederikssund";"no";0;0;0;55,839444;12,068888
1803;"Frederikssund";"no";0;0;0;55,839444;12,068888
1804;"Frederikssund";"no";0;0;0;55,839444;12,068888
1805;"Frederikssund";"no";0;0;0;55,839444;12,068888
1806;"Frederikssund";"no";0;0;0;55,839444;12,068888
1807;"Frederikssund";"no";0;0;0;55,839444;12,068888
1808;"Frederikssund";"no";0;0;0;55,839444;12,068888
1809;"Frederikssund";"no";0;0;0;55,839444;12,068888
1810;"Frederikssund";"no";0;0;0;55,839444;12,068888
1811;"Frederikssund";"no";0;0;0;55,839444;12,068888
1812;"Frederikssund";"no";0;1;1;55,839444;12,068888
1813;"Frederikssund";"no";0;0;0;55,839444;12,068888
1814;"Frederikssund";"no";0;0;0;55,839444;12,068888
1815;"Frederikssund";"no";0;0;0;55,839444;12,068888
1816;"Frederikssund";"no";0;2;2;55,839444;12,068888
1817;"Frederikssund";"no";0;0;0;55,839444;12,068888
1818;"Frederikssund";"no";0;0;0;55,839444;12,068888
1819;"Frederikssund";"no";0;0;0;55,839444;12,068888
1820;"Frederikssund";"no";0;0;0;55,839444;12,068888
1821;"Frederikssund";"no";0;0;0;55,839444;12,068888
1822;"Frederikssund";"no";0;0;0;55,839444;12,068888
1823;"Frederikssund";"no";0;0;0;55,839444;12,068888
1824;"Frederikssund";"no";0;0;0;55,839444;12,068888
1825;"Frederikssund";"no";0;0;0;55,839444;12,068888
1826;"Frederikssund";"no";0;0;0;55,839444;12,068888
1827;"Frederikssund";"no";0;0;0;55,839444;12,068888
1828;"Frederikssund";"no";0;0;0;55,839444;12,068888
1829;"Frederikssund";"no";0;0;0;55,839444;12,068888
1830;"Frederikssund";"no";0;0;0;55,839444;12,068888
1831;"Frederikssund";"no";0;0;0;55,839444;12,068888
1832;"Frederikssund";"no";0;1;1;55,839444;12,068888
1833;"Frederikssund";"no";0;0;0;55,839444;12,068888
1834;"Frederikssund";"no";0;0;0;55,839444;12,068888
1835;"Frederikssund";"no";0;0;0;55,839444;12,068888
1836;"Frederikssund";"no";0;0;0;55,839444;12,068888
1837;"Frederikssund";"no";1;1;2;55,839444;12,068888
1838;"Frederikssund";"no";1;1;2;55,839444;12,068888
1839;"Frederikssund";"no";5;0;5;55,839444;12,068888
1840;"Frederikssund";"no";1;3;4;55,839444;12,068888
1841;"Frederikssund";"no";1;0;1;55,839444;12,068888
1842;"Frederikssund";"no";1;4;5;55,839444;12,068888
1843;"Frederikssund";"no";2;5;7;55,839444;12,068888
1844;"Frederikssund";"no";3;5;8;55,839444;12,068888
1845;"Frederikssund";"no";1;1;2;55,839444;12,068888
1846;"Frederikssund";"no";4;4;8;55,839444;12,068888
1847;"Frederikssund";"no";0;0;0;55,839444;12,068888
1848;"Frederikssund";"no";1;1;2;55,839444;12,068888
1849;"Frederikssund";"no";1;4;5;55,839444;12,068888
1850;"Frederikssund";"no";1;0;1;55,839444;12,068888
1851;"Frederikssund";"no";4;3;7;55,839444;12,068888
1852;"Frederikssund";"no";0;3;3;55,839444;12,068888
1853;"Frederikssund";"no";3;4;7;55,839444;12,068888
1854;"Frederikssund";"no";3;5;8;55,839444;12,068888
1855;"Frederikssund";"no";3;2;5;55,839444;12,068888
1856;"Frederikssund";"no";2;1;3;55,839444;12,068888
1857;"Frederikssund";"no";0;0;0;55,839444;12,068888
1634;"Tønder";"no";0;0;0;54,933055;8,866666
1635;"Tønder";"no";0;0;0;54,933055;8,866666
1636;"Tønder";"no";0;0;0;54,933055;8,866666
1637;"Tønder";"no";0;0;0;54,933055;8,866666
1638;"Tønder";"no";0;0;0;54,933055;8,866666
1639;"Tønder";"no";0;0;0;54,933055;8,866666
1640;"Tønder";"no";0;0;0;54,933055;8,866666
1641;"Tønder";"no";0;0;0;54,933055;8,866666
1642;"Tønder";"no";0;0;0;54,933055;8,866666
1643;"Tønder";"no";0;0;0;54,933055;8,866666
1644;"Tønder";"no";0;0;0;54,933055;8,866666
1645;"Tønder";"no";0;0;0;54,933055;8,866666
1646;"Tønder";"no";0;0;0;54,933055;8,866666
1647;"Tønder";"no";0;0;0;54,933055;8,866666
1648;"Tønder";"no";0;0;0;54,933055;8,866666
1649;"Tønder";"no";0;0;0;54,933055;8,866666
1650;"Tønder";"no";0;0;0;54,933055;8,866666
1651;"Tønder";"no";0;0;0;54,933055;8,866666
1652;"Tønder";"no";0;0;0;54,933055;8,866666
1653;"Tønder";"no";0;0;0;54,933055;8,866666
1654;"Tønder";"no";0;0;0;54,933055;8,866666
1655;"Tønder";"no";0;0;0;54,933055;8,866666
1656;"Tønder";"no";0;0;0;54,933055;8,866666
1657;"Tønder";"no";0;0;0;54,933055;8,866666
1658;"Tønder";"no";0;0;0;54,933055;8,866666
1659;"Tønder";"no";0;0;0;54,933055;8,866666
1660;"Tønder";"no";0;0;0;54,933055;8,866666
1661;"Tønder";"no";0;0;0;54,933055;8,866666
1662;"Tønder";"no";0;0;0;54,933055;8,866666
1663;"Tønder";"no";0;1;1;54,933055;8,866666
1664;"Tønder";"no";0;1;1;54,933055;8,866666
1665;"Tønder";"no";0;0;0;54,933055;8,866666
1666;"Tønder";"no";0;2;2;54,933055;8,866666
1667;"Tønder";"no";0;0;0;54,933055;8,866666
1668;"Tønder";"no";1;1;2;54,933055;8,866666
1669;"Tønder";"no";0;1;1;54,933055;8,866666
1670;"Tønder";"no";1;0;1;54,933055;8,866666
1671;"Tønder";"no";0;0;0;54,933055;8,866666
1672;"Tønder";"no";0;0;0;54,933055;8,866666
1673;"Tønder";"no";0;0;0;54,933055;8,866666
1674;"Tønder";"no";0;1;1;54,933055;8,866666
1675;"Tønder";"no";0;0;0;54,933055;8,866666
1676;"Tønder";"no";0;1;1;54,933055;8,866666
1677;"Tønder";"no";0;0;0;54,933055;8,866666
1678;"Tønder";"no";0;0;0;54,933055;8,866666
1679;"Tønder";"no";0;0;0;54,933055;8,866666
1680;"Tønder";"no";1;1;2;54,933055;8,866666
1681;"Tønder";"no";0;0;0;54,933055;8,866666
1682;"Tønder";"no";0;0;0;54,933055;8,866666
1683;"Tønder";"no";0;0;0;54,933055;8,866666
1684;"Tønder";"no";0;0;0;54,933055;8,866666
1685;"Tønder";"no";0;0;0;54,933055;8,866666
1686;"Tønder";"no";0;0;0;54,933055;8,866666
1687;"Tønder";"no";0;0;0;54,933055;8,866666
1688;"Tønder";"no";0;0;0;54,933055;8,866666
1689;"Tønder";"no";0;0;0;54,933055;8,866666
1690;"Tønder";"no";0;0;0;54,933055;8,866666
1691;"Tønder";"no";0;0;0;54,933055;8,866666
1692;"Tønder";"no";0;0;0;54,933055;8,866666
1693;"Tønder";"no";0;0;0;54,933055;8,866666
1694;"Tønder";"no";0;0;0;54,933055;8,866666
1695;"Tønder";"no";0;0;0;54,933055;8,866666
1696;"Tønder";"no";0;0;0;54,933055;8,866666
1697;"Tønder";"no";0;0;0;54,933055;8,866666
1698;"Tønder";"no";0;0;0;54,933055;8,866666
1699;"Tønder";"no";0;0;0;54,933055;8,866666
1700;"Tønder";"no";0;0;0;54,933055;8,866666
1701;"Tønder";"no";0;0;0;54,933055;8,866666
1702;"Tønder";"no";0;0;0;54,933055;8,866666
1703;"Tønder";"no";0;0;0;54,933055;8,866666
1704;"Tønder";"no";0;0;0;54,933055;8,866666
1705;"Tønder";"no";0;0;0;54,933055;8,866666
1706;"Tønder";"no";0;0;0;54,933055;8,866666
1707;"Tønder";"no";0;0;0;54,933055;8,866666
1708;"Tønder";"no";0;0;0;54,933055;8,866666
1709;"Tønder";"no";0;0;0;54,933055;8,866666
1710;"Tønder";"no";0;0;0;54,933055;8,866666
1711;"Tønder";"no";0;0;0;54,933055;8,866666
1712;"Tønder";"no";0;1;1;54,933055;8,866666
1713;"Tønder";"no";0;0;0;54,933055;8,866666
1714;"Tønder";"no";0;1;1;54,933055;8,866666
1715;"Tønder";"no";0;0;0;54,933055;8,866666
1716;"Tønder";"no";0;0;0;54,933055;8,866666
1717;"Tønder";"no";0;0;0;54,933055;8,866666
1718;"Tønder";"no";0;0;0;54,933055;8,866666
1719;"Tønder";"no";0;0;0;54,933055;8,866666
1720;"Tønder";"no";0;0;0;54,933055;8,866666
1721;"Tønder";"no";0;0;0;54,933055;8,866666
1722;"Tønder";"no";0;0;0;54,933055;8,866666
1723;"Tønder";"no";0;0;0;54,933055;8,866666
1724;"Tønder";"no";0;0;0;54,933055;8,866666
1725;"Tønder";"no";0;0;0;54,933055;8,866666
1726;"Tønder";"no";0;0;0;54,933055;8,866666
1727;"Tønder";"no";0;0;0;54,933055;8,866666
1728;"Tønder";"no";0;0;0;54,933055;8,866666
1729;"Tønder";"no";0;0;0;54,933055;8,866666
1730;"Tønder";"no";0;0;0;54,933055;8,866666
1731;"Tønder";"no";0;0;0;54,933055;8,866666
1732;"Tønder";"no";0;0;0;54,933055;8,866666
1733;"Tønder";"no";0;0;0;54,933055;8,866666
1734;"Tønder";"no";0;0;0;54,933055;8,866666
1735;"Tønder";"no";0;0;0;54,933055;8,866666
1736;"Tønder";"no";0;0;0;54,933055;8,866666
1737;"Tønder";"no";0;0;0;54,933055;8,866666
1738;"Tønder";"no";0;0;0;54,933055;8,866666
1739;"Tønder";"no";0;0;0;54,933055;8,866666
1740;"Tønder";"no";0;0;0;54,933055;8,866666
1741;"Tønder";"no";1;0;1;54,933055;8,866666
1742;"Tønder";"no";0;0;0;54,933055;8,866666
1743;"Tønder";"no";0;0;0;54,933055;8,866666
1744;"Tønder";"no";0;0;0;54,933055;8,866666
1745;"Tønder";"no";0;0;0;54,933055;8,866666
1746;"Tønder";"no";0;0;0;54,933055;8,866666
1747;"Tønder";"no";0;0;0;54,933055;8,866666
1748;"Tønder";"no";0;0;0;54,933055;8,866666
1749;"Tønder";"no";0;0;0;54,933055;8,866666
1750;"Tønder";"no";0;0;0;54,933055;8,866666
1751;"Tønder";"no";0;0;0;54,933055;8,866666
1752;"Tønder";"no";0;0;0;54,933055;8,866666
1753;"Tønder";"no";0;0;0;54,933055;8,866666
1754;"Tønder";"no";0;0;0;54,933055;8,866666
1755;"Tønder";"no";0;0;0;54,933055;8,866666
1756;"Tønder";"no";0;0;0;54,933055;8,866666
1757;"Tønder";"no";0;0;0;54,933055;8,866666
1758;"Tønder";"no";0;0;0;54,933055;8,866666
1759;"Tønder";"no";0;0;0;54,933055;8,866666
1760;"Tønder";"no";0;0;0;54,933055;8,866666
1761;"Tønder";"no";0;0;0;54,933055;8,866666
1762;"Tønder";"no";0;0;0;54,933055;8,866666
1763;"Tønder";"no";0;0;0;54,933055;8,866666
1764;"Tønder";"no";0;0;0;54,933055;8,866666
1765;"Tønder";"no";1;0;1;54,933055;8,866666
1766;"Tønder";"no";0;0;0;54,933055;8,866666
1767;"Tønder";"no";0;0;0;54,933055;8,866666
1768;"Tønder";"no";0;0;0;54,933055;8,866666
1769;"Tønder";"no";0;1;1;54,933055;8,866666
1770;"Tønder";"no";0;0;0;54,933055;8,866666
1771;"Tønder";"no";0;0;0;54,933055;8,866666
1772;"Tønder";"no";0;0;0;54,933055;8,866666
1773;"Tønder";"no";0;0;0;54,933055;8,866666
1774;"Tønder";"no";0;0;0;54,933055;8,866666
1775;"Tønder";"no";1;0;1;54,933055;8,866666
1776;"Tønder";"no";0;0;0;54,933055;8,866666
1777;"Tønder";"no";0;0;0;54,933055;8,866666
1778;"Tønder";"no";0;0;0;54,933055;8,866666
1779;"Tønder";"no";0;0;0;54,933055;8,866666
1780;"Tønder";"no";0;0;0;54,933055;8,866666
1781;"Tønder";"no";0;0;0;54,933055;8,866666
1782;"Tønder";"no";1;0;1;54,933055;8,866666
1783;"Tønder";"no";0;0;0;54,933055;8,866666
1784;"Tønder";"no";0;0;0;54,933055;8,866666
1785;"Tønder";"no";0;0;0;54,933055;8,866666
1786;"Tønder";"no";0;0;0;54,933055;8,866666
1787;"Tønder";"no";0;0;0;54,933055;8,866666
1788;"Tønder";"no";0;0;0;54,933055;8,866666
1789;"Tønder";"no";0;0;0;54,933055;8,866666
1790;"Tønder";"no";1;1;2;54,933055;8,866666
1791;"Tønder";"no";0;0;0;54,933055;8,866666
1792;"Tønder";"no";0;0;0;54,933055;8,866666
1793;"Tønder";"no";1;0;1;54,933055;8,866666
1794;"Tønder";"no";0;0;0;54,933055;8,866666
1795;"Tønder";"no";0;0;0;54,933055;8,866666
1796;"Tønder";"no";0;0;0;54,933055;8,866666
1797;"Tønder";"no";0;0;0;54,933055;8,866666
1798;"Tønder";"no";0;0;0;54,933055;8,866666
1799;"Tønder";"no";1;0;1;54,933055;8,866666
1800;"Tønder";"no";0;0;0;54,933055;8,866666
1801;"Tønder";"no";0;0;0;54,933055;8,866666
1802;"Tønder";"no";0;0;0;54,933055;8,866666
1803;"Tønder";"no";0;0;0;54,933055;8,866666
1804;"Tønder";"no";0;0;0;54,933055;8,866666
1805;"Tønder";"no";0;0;0;54,933055;8,866666
1806;"Tønder";"no";0;0;0;54,933055;8,866666
1807;"Tønder";"no";0;0;0;54,933055;8,866666
1808;"Tønder";"no";0;0;0;54,933055;8,866666
1809;"Tønder";"no";0;0;0;54,933055;8,866666
1810;"Tønder";"no";0;0;0;54,933055;8,866666
1811;"Tønder";"no";0;0;0;54,933055;8,866666
1812;"Tønder";"no";0;0;0;54,933055;8,866666
1813;"Tønder";"no";0;0;0;54,933055;8,866666
1814;"Tønder";"no";0;0;0;54,933055;8,866666
1815;"Tønder";"no";0;0;0;54,933055;8,866666
1816;"Tønder";"no";0;0;0;54,933055;8,866666
1817;"Tønder";"no";0;0;0;54,933055;8,866666
1818;"Tønder";"no";0;0;0;54,933055;8,866666
1819;"Tønder";"no";0;0;0;54,933055;8,866666
1820;"Tønder";"no";0;0;0;54,933055;8,866666
1821;"Tønder";"no";0;0;0;54,933055;8,866666
1822;"Tønder";"no";0;0;0;54,933055;8,866666
1823;"Tønder";"no";0;0;0;54,933055;8,866666
1824;"Tønder";"no";0;0;0;54,933055;8,866666
1825;"Tønder";"no";0;0;0;54,933055;8,866666
1826;"Tønder";"no";0;0;0;54,933055;8,866666
1827;"Tønder";"no";0;0;0;54,933055;8,866666
1828;"Tønder";"no";0;0;0;54,933055;8,866666
1829;"Tønder";"no";0;0;0;54,933055;8,866666
1830;"Tønder";"no";0;0;0;54,933055;8,866666
1831;"Tønder";"no";0;0;0;54,933055;8,866666
1832;"Tønder";"no";0;0;0;54,933055;8,866666
1833;"Tønder";"no";0;0;0;54,933055;8,866666
1834;"Tønder";"no";6;0;6;54,933055;8,866666
1835;"Tønder";"no";0;0;0;54,933055;8,866666
1836;"Tønder";"no";0;0;0;54,933055;8,866666
1837;"Tønder";"no";0;0;0;54,933055;8,866666
1838;"Tønder";"no";0;0;0;54,933055;8,866666
1839;"Tønder";"no";0;0;0;54,933055;8,866666
1840;"Tønder";"no";0;0;0;54,933055;8,866666
1841;"Tønder";"no";0;1;1;54,933055;8,866666
1842;"Tønder";"no";1;0;1;54,933055;8,866666
1843;"Tønder";"no";0;1;1;54,933055;8,866666
1844;"Tønder";"no";0;0;0;54,933055;8,866666
1845;"Tønder";"no";0;0;0;54,933055;8,866666
1846;"Tønder";"no";0;0;0;54,933055;8,866666
1847;"Tønder";"no";0;0;0;54,933055;8,866666
1848;"Tønder";"no";0;0;0;54,933055;8,866666
1849;"Tønder";"no";0;0;0;54,933055;8,866666
1850;"Tønder";"no";0;0;0;54,933055;8,866666
1851;"Tønder";"no";0;0;0;54,933055;8,866666
1852;"Tønder";"no";0;0;0;54,933055;8,866666
1853;"Tønder";"no";0;0;0;54,933055;8,866666
1854;"Tønder";"no";0;0;0;54,933055;8,866666
1855;"Tønder";"no";0;0;0;54,933055;8,866666
1856;"Tønder";"no";0;0;0;54,933055;8,866666
1857;"Tønder";"no";0;0;0;54,933055;8,866666
1634;"Højer";"no";0;0;0;54,966666;8,716666
1635;"Højer";"no";0;0;0;54,966666;8,716666
1636;"Højer";"no";0;0;0;54,966666;8,716666
1637;"Højer";"no";0;0;0;54,966666;8,716666
1638;"Højer";"no";0;0;0;54,966666;8,716666
1639;"Højer";"no";0;0;0;54,966666;8,716666
1640;"Højer";"no";0;0;0;54,966666;8,716666
1641;"Højer";"no";0;0;0;54,966666;8,716666
1642;"Højer";"no";0;0;0;54,966666;8,716666
1643;"Højer";"no";0;0;0;54,966666;8,716666
1644;"Højer";"no";0;0;0;54,966666;8,716666
1645;"Højer";"no";0;0;0;54,966666;8,716666
1646;"Højer";"no";0;0;0;54,966666;8,716666
1647;"Højer";"no";0;0;0;54,966666;8,716666
1648;"Højer";"no";0;0;0;54,966666;8,716666
1649;"Højer";"no";0;0;0;54,966666;8,716666
1650;"Højer";"no";0;0;0;54,966666;8,716666
1651;"Højer";"no";0;0;0;54,966666;8,716666
1652;"Højer";"no";0;0;0;54,966666;8,716666
1653;"Højer";"no";0;0;0;54,966666;8,716666
1654;"Højer";"no";0;0;0;54,966666;8,716666
1655;"Højer";"no";0;0;0;54,966666;8,716666
1656;"Højer";"no";0;0;0;54,966666;8,716666
1657;"Højer";"no";0;0;0;54,966666;8,716666
1658;"Højer";"no";0;0;0;54,966666;8,716666
1659;"Højer";"no";0;0;0;54,966666;8,716666
1660;"Højer";"no";0;0;0;54,966666;8,716666
1661;"Højer";"no";0;0;0;54,966666;8,716666
1662;"Højer";"no";0;0;0;54,966666;8,716666
1663;"Højer";"no";0;0;0;54,966666;8,716666
1664;"Højer";"no";0;0;0;54,966666;8,716666
1665;"Højer";"no";0;0;0;54,966666;8,716666
1666;"Højer";"no";0;0;0;54,966666;8,716666
1667;"Højer";"no";0;0;0;54,966666;8,716666
1668;"Højer";"no";0;0;0;54,966666;8,716666
1669;"Højer";"no";0;0;0;54,966666;8,716666
1670;"Højer";"no";1;1;2;54,966666;8,716666
1671;"Højer";"no";0;0;0;54,966666;8,716666
1672;"Højer";"no";0;0;0;54,966666;8,716666
1673;"Højer";"no";0;0;0;54,966666;8,716666
1674;"Højer";"no";1;0;1;54,966666;8,716666
1675;"Højer";"no";0;0;0;54,966666;8,716666
1676;"Højer";"no";0;0;0;54,966666;8,716666
1677;"Højer";"no";0;0;0;54,966666;8,716666
1678;"Højer";"no";0;0;0;54,966666;8,716666
1679;"Højer";"no";0;0;0;54,966666;8,716666
1680;"Højer";"no";0;0;0;54,966666;8,716666
1681;"Højer";"no";0;0;0;54,966666;8,716666
1682;"Højer";"no";0;0;0;54,966666;8,716666
1683;"Højer";"no";0;0;0;54,966666;8,716666
1684;"Højer";"no";0;0;0;54,966666;8,716666
1685;"Højer";"no";1;0;1;54,966666;8,716666
1686;"Højer";"no";0;0;0;54,966666;8,716666
1687;"Højer";"no";0;1;1;54,966666;8,716666
1688;"Højer";"no";1;0;1;54,966666;8,716666
1689;"Højer";"no";1;0;1;54,966666;8,716666
1690;"Højer";"no";0;0;0;54,966666;8,716666
1691;"Højer";"no";0;0;0;54,966666;8,716666
1692;"Højer";"no";0;0;0;54,966666;8,716666
1693;"Højer";"no";0;0;0;54,966666;8,716666
1694;"Højer";"no";0;0;0;54,966666;8,716666
1695;"Højer";"no";0;0;0;54,966666;8,716666
1696;"Højer";"no";0;0;0;54,966666;8,716666
1697;"Højer";"no";0;0;0;54,966666;8,716666
1698;"Højer";"no";0;0;0;54,966666;8,716666
1699;"Højer";"no";0;0;0;54,966666;8,716666
1700;"Højer";"no";0;0;0;54,966666;8,716666
1701;"Højer";"no";0;0;0;54,966666;8,716666
1702;"Højer";"no";0;0;0;54,966666;8,716666
1703;"Højer";"no";0;0;0;54,966666;8,716666
1704;"Højer";"no";0;0;0;54,966666;8,716666
1705;"Højer";"no";0;0;0;54,966666;8,716666
1706;"Højer";"no";0;0;0;54,966666;8,716666
1707;"Højer";"no";0;0;0;54,966666;8,716666
1708;"Højer";"no";0;0;0;54,966666;8,716666
1709;"Højer";"no";0;0;0;54,966666;8,716666
1710;"Højer";"no";0;0;0;54,966666;8,716666
1711;"Højer";"no";0;0;0;54,966666;8,716666
1712;"Højer";"no";0;0;0;54,966666;8,716666
1713;"Højer";"no";0;0;0;54,966666;8,716666
1714;"Højer";"no";0;0;0;54,966666;8,716666
1715;"Højer";"no";0;0;0;54,966666;8,716666
1716;"Højer";"no";0;0;0;54,966666;8,716666
1717;"Højer";"no";0;0;0;54,966666;8,716666
1718;"Højer";"no";0;0;0;54,966666;8,716666
1719;"Højer";"no";0;0;0;54,966666;8,716666
1720;"Højer";"no";0;0;0;54,966666;8,716666
1721;"Højer";"no";0;0;0;54,966666;8,716666
1722;"Højer";"no";0;0;0;54,966666;8,716666
1723;"Højer";"no";0;0;0;54,966666;8,716666
1724;"Højer";"no";0;0;0;54,966666;8,716666
1725;"Højer";"no";0;0;0;54,966666;8,716666
1726;"Højer";"no";0;0;0;54,966666;8,716666
1727;"Højer";"no";0;0;0;54,966666;8,716666
1728;"Højer";"no";0;0;0;54,966666;8,716666
1729;"Højer";"no";0;0;0;54,966666;8,716666
1730;"Højer";"no";0;0;0;54,966666;8,716666
1731;"Højer";"no";0;0;0;54,966666;8,716666
1732;"Højer";"no";0;0;0;54,966666;8,716666
1733;"Højer";"no";0;0;0;54,966666;8,716666
1734;"Højer";"no";0;0;0;54,966666;8,716666
1735;"Højer";"no";0;0;0;54,966666;8,716666
1736;"Højer";"no";0;0;0;54,966666;8,716666
1737;"Højer";"no";0;0;0;54,966666;8,716666
1738;"Højer";"no";0;0;0;54,966666;8,716666
1739;"Højer";"no";0;0;0;54,966666;8,716666
1740;"Højer";"no";0;0;0;54,966666;8,716666
1741;"Højer";"no";0;0;0;54,966666;8,716666
1742;"Højer";"no";0;0;0;54,966666;8,716666
1743;"Højer";"no";0;0;0;54,966666;8,716666
1744;"Højer";"no";0;0;0;54,966666;8,716666
1745;"Højer";"no";0;0;0;54,966666;8,716666
1746;"Højer";"no";0;0;0;54,966666;8,716666
1747;"Højer";"no";0;0;0;54,966666;8,716666
1748;"Højer";"no";0;0;0;54,966666;8,716666
1749;"Højer";"no";0;0;0;54,966666;8,716666
1750;"Højer";"no";0;0;0;54,966666;8,716666
1751;"Højer";"no";0;0;0;54,966666;8,716666
1752;"Højer";"no";0;0;0;54,966666;8,716666
1753;"Højer";"no";0;0;0;54,966666;8,716666
1754;"Højer";"no";0;0;0;54,966666;8,716666
1755;"Højer";"no";0;0;0;54,966666;8,716666
1756;"Højer";"no";0;0;0;54,966666;8,716666
1757;"Højer";"no";0;0;0;54,966666;8,716666
1758;"Højer";"no";0;0;0;54,966666;8,716666
1759;"Højer";"no";0;0;0;54,966666;8,716666
1760;"Højer";"no";0;0;0;54,966666;8,716666
1761;"Højer";"no";0;0;0;54,966666;8,716666
1762;"Højer";"no";0;0;0;54,966666;8,716666
1763;"Højer";"no";0;0;0;54,966666;8,716666
1764;"Højer";"no";0;0;0;54,966666;8,716666
1765;"Højer";"no";0;0;0;54,966666;8,716666
1766;"Højer";"no";0;0;0;54,966666;8,716666
1767;"Højer";"no";0;0;0;54,966666;8,716666
1768;"Højer";"no";0;0;0;54,966666;8,716666
1769;"Højer";"no";0;0;0;54,966666;8,716666
1770;"Højer";"no";0;0;0;54,966666;8,716666
1771;"Højer";"no";0;0;0;54,966666;8,716666
1772;"Højer";"no";0;0;0;54,966666;8,716666
1773;"Højer";"no";0;0;0;54,966666;8,716666
1774;"Højer";"no";0;0;0;54,966666;8,716666
1775;"Højer";"no";0;0;0;54,966666;8,716666
1776;"Højer";"no";0;0;0;54,966666;8,716666
1777;"Højer";"no";0;0;0;54,966666;8,716666
1778;"Højer";"no";0;0;0;54,966666;8,716666
1779;"Højer";"no";0;0;0;54,966666;8,716666
1780;"Højer";"no";0;0;0;54,966666;8,716666
1781;"Højer";"no";0;0;0;54,966666;8,716666
1782;"Højer";"no";0;0;0;54,966666;8,716666
1783;"Højer";"no";0;0;0;54,966666;8,716666
1784;"Højer";"no";0;0;0;54,966666;8,716666
1785;"Højer";"no";0;0;0;54,966666;8,716666
1786;"Højer";"no";0;0;0;54,966666;8,716666
1787;"Højer";"no";0;0;0;54,966666;8,716666
1788;"Højer";"no";0;0;0;54,966666;8,716666
1789;"Højer";"no";0;0;0;54,966666;8,716666
1790;"Højer";"no";0;0;0;54,966666;8,716666
1791;"Højer";"no";0;0;0;54,966666;8,716666
1792;"Højer";"no";0;0;0;54,966666;8,716666
1793;"Højer";"no";0;0;0;54,966666;8,716666
1794;"Højer";"no";0;0;0;54,966666;8,716666
1795;"Højer";"no";0;0;0;54,966666;8,716666
1796;"Højer";"no";0;0;0;54,966666;8,716666
1797;"Højer";"no";0;0;0;54,966666;8,716666
1798;"Højer";"no";0;0;0;54,966666;8,716666
1799;"Højer";"no";0;0;0;54,966666;8,716666
1800;"Højer";"no";0;0;0;54,966666;8,716666
1801;"Højer";"no";0;0;0;54,966666;8,716666
1802;"Højer";"no";0;0;0;54,966666;8,716666
1803;"Højer";"no";0;0;0;54,966666;8,716666
1804;"Højer";"no";0;0;0;54,966666;8,716666
1805;"Højer";"no";0;0;0;54,966666;8,716666
1806;"Højer";"no";0;0;0;54,966666;8,716666
1807;"Højer";"no";0;0;0;54,966666;8,716666
1808;"Højer";"no";0;0;0;54,966666;8,716666
1809;"Højer";"no";0;0;0;54,966666;8,716666
1810;"Højer";"no";0;0;0;54,966666;8,716666
1811;"Højer";"no";0;0;0;54,966666;8,716666
1812;"Højer";"no";0;0;0;54,966666;8,716666
1813;"Højer";"no";0;0;0;54,966666;8,716666
1814;"Højer";"no";0;0;0;54,966666;8,716666
1815;"Højer";"no";0;0;0;54,966666;8,716666
1816;"Højer";"no";0;0;0;54,966666;8,716666
1817;"Højer";"no";0;0;0;54,966666;8,716666
1818;"Højer";"no";0;0;0;54,966666;8,716666
1819;"Højer";"no";0;0;0;54,966666;8,716666
1820;"Højer";"no";0;0;0;54,966666;8,716666
1821;"Højer";"no";0;0;0;54,966666;8,716666
1822;"Højer";"no";0;0;0;54,966666;8,716666
1823;"Højer";"no";0;0;0;54,966666;8,716666
1824;"Højer";"no";0;0;0;54,966666;8,716666
1825;"Højer";"no";0;0;0;54,966666;8,716666
1826;"Højer";"no";0;0;0;54,966666;8,716666
1827;"Højer";"no";0;0;0;54,966666;8,716666
1828;"Højer";"no";0;0;0;54,966666;8,716666
1829;"Højer";"no";0;0;0;54,966666;8,716666
1830;"Højer";"no";0;0;0;54,966666;8,716666
1831;"Højer";"no";0;0;0;54,966666;8,716666
1832;"Højer";"no";0;0;0;54,966666;8,716666
1833;"Højer";"no";0;0;0;54,966666;8,716666
1834;"Højer";"no";0;1;1;54,966666;8,716666
1835;"Højer";"no";0;0;0;54,966666;8,716666
1836;"Højer";"no";0;0;0;54,966666;8,716666
1837;"Højer";"no";0;0;0;54,966666;8,716666
1838;"Højer";"no";0;0;0;54,966666;8,716666
1839;"Højer";"no";0;0;0;54,966666;8,716666
1840;"Højer";"no";0;0;0;54,966666;8,716666
1841;"Højer";"no";0;0;0;54,966666;8,716666
1842;"Højer";"no";0;0;0;54,966666;8,716666
1843;"Højer";"no";2;3;5;54,966666;8,716666
1844;"Højer";"no";1;2;3;54,966666;8,716666
1845;"Højer";"no";2;1;3;54,966666;8,716666
1846;"Højer";"no";1;1;2;54,966666;8,716666
1847;"Højer";"no";1;2;3;54,966666;8,716666
1848;"Højer";"no";0;0;0;54,966666;8,716666
1849;"Højer";"no";0;1;1;54,966666;8,716666
1850;"Højer";"no";0;1;1;54,966666;8,716666
1851;"Højer";"no";1;2;3;54,966666;8,716666
1852;"Højer";"no";1;0;1;54,966666;8,716666
1853;"Højer";"no";0;1;1;54,966666;8,716666
1854;"Højer";"no";1;1;2;54,966666;8,716666
1855;"Højer";"no";0;0;0;54,966666;8,716666
1856;"Højer";"no";0;0;0;54,966666;8,716666
1857;"Højer";"no";0;0;0;54,966666;8,716666
1634;"Møn";"no";0;0;0;55;12,333333
1635;"Møn";"no";0;0;0;55;12,333333
1636;"Møn";"no";0;0;0;55;12,333333
1637;"Møn";"no";0;0;0;55;12,333333
1638;"Møn";"no";0;0;0;55;12,333333
1639;"Møn";"no";0;0;0;55;12,333333
1640;"Møn";"no";0;0;0;55;12,333333
1641;"Møn";"no";0;0;0;55;12,333333
1642;"Møn";"no";0;0;0;55;12,333333
1643;"Møn";"no";0;0;0;55;12,333333
1644;"Møn";"no";0;0;0;55;12,333333
1645;"Møn";"no";0;0;0;55;12,333333
1646;"Møn";"no";0;0;0;55;12,333333
1647;"Møn";"no";0;0;0;55;12,333333
1648;"Møn";"no";0;0;0;55;12,333333
1649;"Møn";"no";0;0;0;55;12,333333
1650;"Møn";"no";0;0;0;55;12,333333
1651;"Møn";"no";0;1;1;55;12,333333
1652;"Møn";"no";0;0;0;55;12,333333
1653;"Møn";"no";0;0;0;55;12,333333
1654;"Møn";"no";0;0;0;55;12,333333
1655;"Møn";"no";0;0;0;55;12,333333
1656;"Møn";"no";0;0;0;55;12,333333
1657;"Møn";"no";0;0;0;55;12,333333
1658;"Møn";"no";0;0;0;55;12,333333
1659;"Møn";"no";0;0;0;55;12,333333
1660;"Møn";"no";0;0;0;55;12,333333
1661;"Møn";"no";0;0;0;55;12,333333
1662;"Møn";"no";0;0;0;55;12,333333
1663;"Møn";"no";0;0;0;55;12,333333
1664;"Møn";"no";0;0;0;55;12,333333
1665;"Møn";"no";0;0;0;55;12,333333
1666;"Møn";"no";0;0;0;55;12,333333
1667;"Møn";"no";0;0;0;55;12,333333
1668;"Møn";"no";0;0;0;55;12,333333
1669;"Møn";"no";0;0;0;55;12,333333
1670;"Møn";"no";1;1;2;55;12,333333
1671;"Møn";"no";0;0;0;55;12,333333
1672;"Møn";"no";0;1;1;55;12,333333
1673;"Møn";"no";0;1;1;55;12,333333
1674;"Møn";"no";0;1;1;55;12,333333
1675;"Møn";"no";0;0;0;55;12,333333
1676;"Møn";"no";0;0;0;55;12,333333
1677;"Møn";"no";0;0;0;55;12,333333
1678;"Møn";"no";0;0;0;55;12,333333
1679;"Møn";"no";0;0;0;55;12,333333
1680;"Møn";"no";0;0;0;55;12,333333
1681;"Møn";"no";0;0;0;55;12,333333
1682;"Møn";"no";0;0;0;55;12,333333
1683;"Møn";"no";0;0;0;55;12,333333
1684;"Møn";"no";0;0;0;55;12,333333
1685;"Møn";"no";7;6;13;55;12,333333
1686;"Møn";"no";1;2;3;55;12,333333
1687;"Møn";"no";0;2;2;55;12,333333
1688;"Møn";"no";0;0;0;55;12,333333
1689;"Møn";"no";0;0;0;55;12,333333
1690;"Møn";"no";0;0;0;55;12,333333
1691;"Møn";"no";1;0;1;55;12,333333
1692;"Møn";"no";0;0;0;55;12,333333
1693;"Møn";"no";0;0;0;55;12,333333
1694;"Møn";"no";1;0;1;55;12,333333
1695;"Møn";"no";0;0;0;55;12,333333
1696;"Møn";"no";0;0;0;55;12,333333
1697;"Møn";"no";0;1;1;55;12,333333
1698;"Møn";"no";0;0;0;55;12,333333
1699;"Møn";"no";0;2;2;55;12,333333
1700;"Møn";"no";0;0;0;55;12,333333
1701;"Møn";"no";0;0;0;55;12,333333
1702;"Møn";"no";0;1;1;55;12,333333
1703;"Møn";"no";0;0;0;55;12,333333
1704;"Møn";"no";0;0;0;55;12,333333
1705;"Møn";"no";0;0;0;55;12,333333
1706;"Møn";"no";0;0;0;55;12,333333
1707;"Møn";"no";0;0;0;55;12,333333
1708;"Møn";"no";0;0;0;55;12,333333
1709;"Møn";"no";0;0;0;55;12,333333
1710;"Møn";"no";0;0;0;55;12,333333
1711;"Møn";"no";0;0;0;55;12,333333
1712;"Møn";"no";0;0;0;55;12,333333
1713;"Møn";"no";0;0;0;55;12,333333
1714;"Møn";"no";0;0;0;55;12,333333
1715;"Møn";"no";0;0;0;55;12,333333
1716;"Møn";"no";0;0;0;55;12,333333
1717;"Møn";"no";0;0;0;55;12,333333
1718;"Møn";"no";0;0;0;55;12,333333
1719;"Møn";"no";0;0;0;55;12,333333
1720;"Møn";"no";0;0;0;55;12,333333
1721;"Møn";"no";0;0;0;55;12,333333
1722;"Møn";"no";0;0;0;55;12,333333
1723;"Møn";"no";0;0;0;55;12,333333
1724;"Møn";"no";0;0;0;55;12,333333
1725;"Møn";"no";0;0;0;55;12,333333
1726;"Møn";"no";0;0;0;55;12,333333
1727;"Møn";"no";0;0;0;55;12,333333
1728;"Møn";"no";0;0;0;55;12,333333
1729;"Møn";"no";0;0;0;55;12,333333
1730;"Møn";"no";0;0;0;55;12,333333
1731;"Møn";"no";0;0;0;55;12,333333
1732;"Møn";"no";0;0;0;55;12,333333
1733;"Møn";"no";0;0;0;55;12,333333
1734;"Møn";"no";0;0;0;55;12,333333
1735;"Møn";"no";0;0;0;55;12,333333
1736;"Møn";"no";0;0;0;55;12,333333
1737;"Møn";"no";0;0;0;55;12,333333
1738;"Møn";"no";0;0;0;55;12,333333
1739;"Møn";"no";0;0;0;55;12,333333
1740;"Møn";"no";0;0;0;55;12,333333
1741;"Møn";"no";0;0;0;55;12,333333
1742;"Møn";"no";0;0;0;55;12,333333
1743;"Møn";"no";0;0;0;55;12,333333
1744;"Møn";"no";0;0;0;55;12,333333
1745;"Møn";"no";0;0;0;55;12,333333
1746;"Møn";"no";0;0;0;55;12,333333
1747;"Møn";"no";0;0;0;55;12,333333
1748;"Møn";"no";0;0;0;55;12,333333
1749;"Møn";"no";0;0;0;55;12,333333
1750;"Møn";"no";0;0;0;55;12,333333
1751;"Møn";"no";0;0;0;55;12,333333
1752;"Møn";"no";0;0;0;55;12,333333
1753;"Møn";"no";2;0;2;55;12,333333
1754;"Møn";"no";0;0;0;55;12,333333
1755;"Møn";"no";0;0;0;55;12,333333
1756;"Møn";"no";1;0;1;55;12,333333
1757;"Møn";"no";0;0;0;55;12,333333
1758;"Møn";"no";0;0;0;55;12,333333
1759;"Møn";"no";0;0;0;55;12,333333
1760;"Møn";"no";0;0;0;55;12,333333
1761;"Møn";"no";0;0;0;55;12,333333
1762;"Møn";"no";0;0;0;55;12,333333
1763;"Møn";"no";0;0;0;55;12,333333
1764;"Møn";"no";0;0;0;55;12,333333
1765;"Møn";"no";0;0;0;55;12,333333
1766;"Møn";"no";0;0;0;55;12,333333
1767;"Møn";"no";0;0;0;55;12,333333
1768;"Møn";"no";0;0;0;55;12,333333
1769;"Møn";"no";0;0;0;55;12,333333
1770;"Møn";"no";0;0;0;55;12,333333
1771;"Møn";"no";1;0;1;55;12,333333
1772;"Møn";"no";1;0;1;55;12,333333
1773;"Møn";"no";0;0;0;55;12,333333
1774;"Møn";"no";0;2;2;55;12,333333
1775;"Møn";"no";0;2;2;55;12,333333
1776;"Møn";"no";0;0;0;55;12,333333
1777;"Møn";"no";0;0;0;55;12,333333
1778;"Møn";"no";0;0;0;55;12,333333
1779;"Møn";"no";0;0;0;55;12,333333
1780;"Møn";"no";0;0;0;55;12,333333
1781;"Møn";"no";0;0;0;55;12,333333
1782;"Møn";"no";0;0;0;55;12,333333
1783;"Møn";"no";0;0;0;55;12,333333
1784;"Møn";"no";0;0;0;55;12,333333
1785;"Møn";"no";0;0;0;55;12,333333
1786;"Møn";"no";0;0;0;55;12,333333
1787;"Møn";"no";0;0;0;55;12,333333
1788;"Møn";"no";0;0;0;55;12,333333
1789;"Møn";"no";0;0;0;55;12,333333
1790;"Møn";"no";0;0;0;55;12,333333
1791;"Møn";"no";0;1;1;55;12,333333
1792;"Møn";"no";0;1;1;55;12,333333
1793;"Møn";"no";0;0;0;55;12,333333
1794;"Møn";"no";0;0;0;55;12,333333
1795;"Møn";"no";0;0;0;55;12,333333
1796;"Møn";"no";0;0;0;55;12,333333
1797;"Møn";"no";0;0;0;55;12,333333
1798;"Møn";"no";0;0;0;55;12,333333
1799;"Møn";"no";0;0;0;55;12,333333
1800;"Møn";"no";0;0;0;55;12,333333
1801;"Møn";"no";0;0;0;55;12,333333
1802;"Møn";"no";0;0;0;55;12,333333
1803;"Møn";"no";0;0;0;55;12,333333
1804;"Møn";"no";0;0;0;55;12,333333
1805;"Møn";"no";0;0;0;55;12,333333
1806;"Møn";"no";0;0;0;55;12,333333
1807;"Møn";"no";0;0;0;55;12,333333
1808;"Møn";"no";0;0;0;55;12,333333
1809;"Møn";"no";0;0;0;55;12,333333
1810;"Møn";"no";0;0;0;55;12,333333
1811;"Møn";"no";0;0;0;55;12,333333
1812;"Møn";"no";0;0;0;55;12,333333
1813;"Møn";"no";0;0;0;55;12,333333
1814;"Møn";"no";0;0;0;55;12,333333
1815;"Møn";"no";0;0;0;55;12,333333
1816;"Møn";"no";0;0;0;55;12,333333
1817;"Møn";"no";0;0;0;55;12,333333
1818;"Møn";"no";0;0;0;55;12,333333
1819;"Møn";"no";0;0;0;55;12,333333
1820;"Møn";"no";0;0;0;55;12,333333
1821;"Møn";"no";0;0;0;55;12,333333
1822;"Møn";"no";0;0;0;55;12,333333
1823;"Møn";"no";0;0;0;55;12,333333
1824;"Møn";"no";0;0;0;55;12,333333
1825;"Møn";"no";0;1;1;55;12,333333
1826;"Møn";"no";0;0;0;55;12,333333
1827;"Møn";"no";0;0;0;55;12,333333
1828;"Møn";"no";0;0;0;55;12,333333
1829;"Møn";"no";0;0;0;55;12,333333
1830;"Møn";"no";0;0;0;55;12,333333
1831;"Møn";"no";0;0;0;55;12,333333
1832;"Møn";"no";0;0;0;55;12,333333
1833;"Møn";"no";0;0;0;55;12,333333
1834;"Møn";"no";0;0;0;55;12,333333
1835;"Møn";"no";0;0;0;55;12,333333
1836;"Møn";"no";0;0;0;55;12,333333
1837;"Møn";"no";0;0;0;55;12,333333
1838;"Møn";"no";0;0;0;55;12,333333
1839;"Møn";"no";0;0;0;55;12,333333
1840;"Møn";"no";0;0;0;55;12,333333
1841;"Møn";"no";0;0;0;55;12,333333
1842;"Møn";"no";0;0;0;55;12,333333
1843;"Møn";"no";0;0;0;55;12,333333
1844;"Møn";"no";0;0;0;55;12,333333
1845;"Møn";"no";0;0;0;55;12,333333
1846;"Møn";"no";0;0;0;55;12,333333
1847;"Møn";"no";0;0;0;55;12,333333
1848;"Møn";"no";0;0;0;55;12,333333
1849;"Møn";"no";0;0;0;55;12,333333
1850;"Møn";"no";0;0;0;55;12,333333
1851;"Møn";"no";0;0;0;55;12,333333
1852;"Møn";"no";0;0;0;55;12,333333
1853;"Møn";"no";0;0;0;55;12,333333
1854;"Møn";"no";1;0;1;55;12,333333
1855;"Møn";"no";0;0;0;55;12,333333
1856;"Møn";"no";1;0;1;55;12,333333
1857;"Møn";"no";0;0;0;55;12,333333
1634;"Svaneke";"no";0;0;0;55,135555;15,141388
1635;"Svaneke";"no";0;0;0;55,135555;15,141388
1636;"Svaneke";"no";0;0;0;55,135555;15,141388
1637;"Svaneke";"no";0;0;0;55,135555;15,141388
1638;"Svaneke";"no";0;0;0;55,135555;15,141388
1639;"Svaneke";"no";0;0;0;55,135555;15,141388
1640;"Svaneke";"no";0;0;0;55,135555;15,141388
1641;"Svaneke";"no";0;0;0;55,135555;15,141388
1642;"Svaneke";"no";0;0;0;55,135555;15,141388
1643;"Svaneke";"no";0;0;0;55,135555;15,141388
1644;"Svaneke";"no";0;0;0;55,135555;15,141388
1645;"Svaneke";"no";0;0;0;55,135555;15,141388
1646;"Svaneke";"no";0;0;0;55,135555;15,141388
1647;"Svaneke";"no";0;0;0;55,135555;15,141388
1648;"Svaneke";"no";0;0;0;55,135555;15,141388
1649;"Svaneke";"no";0;0;0;55,135555;15,141388
1650;"Svaneke";"no";0;0;0;55,135555;15,141388
1651;"Svaneke";"no";0;0;0;55,135555;15,141388
1652;"Svaneke";"no";0;0;0;55,135555;15,141388
1653;"Svaneke";"no";0;0;0;55,135555;15,141388
1654;"Svaneke";"no";0;0;0;55,135555;15,141388
1655;"Svaneke";"no";0;0;0;55,135555;15,141388
1656;"Svaneke";"no";0;0;0;55,135555;15,141388
1657;"Svaneke";"no";0;0;0;55,135555;15,141388
1658;"Svaneke";"no";0;0;0;55,135555;15,141388
1659;"Svaneke";"no";0;0;0;55,135555;15,141388
1660;"Svaneke";"no";0;0;0;55,135555;15,141388
1661;"Svaneke";"no";0;0;0;55,135555;15,141388
1662;"Svaneke";"no";0;0;0;55,135555;15,141388
1663;"Svaneke";"no";0;0;0;55,135555;15,141388
1664;"Svaneke";"no";0;0;0;55,135555;15,141388
1665;"Svaneke";"no";0;0;0;55,135555;15,141388
1666;"Svaneke";"no";0;0;0;55,135555;15,141388
1667;"Svaneke";"no";0;0;0;55,135555;15,141388
1668;"Svaneke";"no";0;0;0;55,135555;15,141388
1669;"Svaneke";"no";0;0;0;55,135555;15,141388
1670;"Svaneke";"no";1;0;1;55,135555;15,141388
1671;"Svaneke";"no";0;0;0;55,135555;15,141388
1672;"Svaneke";"no";0;0;0;55,135555;15,141388
1673;"Svaneke";"no";0;0;0;55,135555;15,141388
1674;"Svaneke";"no";0;0;0;55,135555;15,141388
1675;"Svaneke";"no";0;0;0;55,135555;15,141388
1676;"Svaneke";"no";0;0;0;55,135555;15,141388
1677;"Svaneke";"no";0;0;0;55,135555;15,141388
1678;"Svaneke";"no";0;0;0;55,135555;15,141388
1679;"Svaneke";"no";0;0;0;55,135555;15,141388
1680;"Svaneke";"no";0;0;0;55,135555;15,141388
1681;"Svaneke";"no";0;0;0;55,135555;15,141388
1682;"Svaneke";"no";0;0;0;55,135555;15,141388
1683;"Svaneke";"no";0;0;0;55,135555;15,141388
1684;"Svaneke";"no";0;0;0;55,135555;15,141388
1685;"Svaneke";"no";0;0;0;55,135555;15,141388
1686;"Svaneke";"no";0;0;0;55,135555;15,141388
1687;"Svaneke";"no";0;0;0;55,135555;15,141388
1688;"Svaneke";"no";0;0;0;55,135555;15,141388
1689;"Svaneke";"no";0;0;0;55,135555;15,141388
1690;"Svaneke";"no";0;0;0;55,135555;15,141388
1691;"Svaneke";"no";0;0;0;55,135555;15,141388
1692;"Svaneke";"no";0;0;0;55,135555;15,141388
1693;"Svaneke";"no";0;0;0;55,135555;15,141388
1694;"Svaneke";"no";0;0;0;55,135555;15,141388
1695;"Svaneke";"no";0;0;0;55,135555;15,141388
1696;"Svaneke";"no";0;0;0;55,135555;15,141388
1697;"Svaneke";"no";0;0;0;55,135555;15,141388
1698;"Svaneke";"no";0;0;0;55,135555;15,141388
1699;"Svaneke";"no";0;0;0;55,135555;15,141388
1700;"Svaneke";"no";0;0;0;55,135555;15,141388
1701;"Svaneke";"no";0;0;0;55,135555;15,141388
1702;"Svaneke";"no";0;0;0;55,135555;15,141388
1703;"Svaneke";"no";0;0;0;55,135555;15,141388
1704;"Svaneke";"no";0;0;0;55,135555;15,141388
1705;"Svaneke";"no";0;0;0;55,135555;15,141388
1706;"Svaneke";"no";0;0;0;55,135555;15,141388
1707;"Svaneke";"no";0;0;0;55,135555;15,141388
1708;"Svaneke";"no";0;0;0;55,135555;15,141388
1709;"Svaneke";"no";0;0;0;55,135555;15,141388
1710;"Svaneke";"no";0;0;0;55,135555;15,141388
1711;"Svaneke";"no";0;0;0;55,135555;15,141388
1712;"Svaneke";"no";0;0;0;55,135555;15,141388
1713;"Svaneke";"no";0;0;0;55,135555;15,141388
1714;"Svaneke";"no";0;0;0;55,135555;15,141388
1715;"Svaneke";"no";0;0;0;55,135555;15,141388
1716;"Svaneke";"no";0;0;0;55,135555;15,141388
1717;"Svaneke";"no";0;0;0;55,135555;15,141388
1718;"Svaneke";"no";0;0;0;55,135555;15,141388
1719;"Svaneke";"no";0;0;0;55,135555;15,141388
1720;"Svaneke";"no";0;0;0;55,135555;15,141388
1721;"Svaneke";"no";0;0;0;55,135555;15,141388
1722;"Svaneke";"no";0;0;0;55,135555;15,141388
1723;"Svaneke";"no";0;0;0;55,135555;15,141388
1724;"Svaneke";"no";0;0;0;55,135555;15,141388
1725;"Svaneke";"no";0;0;0;55,135555;15,141388
1726;"Svaneke";"no";0;0;0;55,135555;15,141388
1727;"Svaneke";"no";0;0;0;55,135555;15,141388
1728;"Svaneke";"no";0;0;0;55,135555;15,141388
1729;"Svaneke";"no";0;0;0;55,135555;15,141388
1730;"Svaneke";"no";0;0;0;55,135555;15,141388
1731;"Svaneke";"no";0;0;0;55,135555;15,141388
1732;"Svaneke";"no";0;0;0;55,135555;15,141388
1733;"Svaneke";"no";0;0;0;55,135555;15,141388
1734;"Svaneke";"no";0;0;0;55,135555;15,141388
1735;"Svaneke";"no";0;0;0;55,135555;15,141388
1736;"Svaneke";"no";0;0;0;55,135555;15,141388
1737;"Svaneke";"no";0;0;0;55,135555;15,141388
1738;"Svaneke";"no";0;0;0;55,135555;15,141388
1739;"Svaneke";"no";0;0;0;55,135555;15,141388
1740;"Svaneke";"no";0;0;0;55,135555;15,141388
1741;"Svaneke";"no";0;0;0;55,135555;15,141388
1742;"Svaneke";"no";0;0;0;55,135555;15,141388
1743;"Svaneke";"no";0;0;0;55,135555;15,141388
1744;"Svaneke";"no";0;0;0;55,135555;15,141388
1745;"Svaneke";"no";0;0;0;55,135555;15,141388
1746;"Svaneke";"no";0;0;0;55,135555;15,141388
1747;"Svaneke";"no";0;0;0;55,135555;15,141388
1748;"Svaneke";"no";0;0;0;55,135555;15,141388
1749;"Svaneke";"no";0;0;0;55,135555;15,141388
1750;"Svaneke";"no";0;0;0;55,135555;15,141388
1751;"Svaneke";"no";0;0;0;55,135555;15,141388
1752;"Svaneke";"no";0;0;0;55,135555;15,141388
1753;"Svaneke";"no";0;0;0;55,135555;15,141388
1754;"Svaneke";"no";0;0;0;55,135555;15,141388
1755;"Svaneke";"no";0;0;0;55,135555;15,141388
1756;"Svaneke";"no";0;0;0;55,135555;15,141388
1757;"Svaneke";"no";0;0;0;55,135555;15,141388
1758;"Svaneke";"no";0;0;0;55,135555;15,141388
1759;"Svaneke";"no";0;0;0;55,135555;15,141388
1760;"Svaneke";"no";0;0;0;55,135555;15,141388
1761;"Svaneke";"no";0;0;0;55,135555;15,141388
1762;"Svaneke";"no";0;0;0;55,135555;15,141388
1763;"Svaneke";"no";0;0;0;55,135555;15,141388
1764;"Svaneke";"no";0;0;0;55,135555;15,141388
1765;"Svaneke";"no";0;0;0;55,135555;15,141388
1766;"Svaneke";"no";0;0;0;55,135555;15,141388
1767;"Svaneke";"no";0;0;0;55,135555;15,141388
1768;"Svaneke";"no";0;0;0;55,135555;15,141388
1769;"Svaneke";"no";0;0;0;55,135555;15,141388
1770;"Svaneke";"no";0;0;0;55,135555;15,141388
1771;"Svaneke";"no";0;0;0;55,135555;15,141388
1772;"Svaneke";"no";0;0;0;55,135555;15,141388
1773;"Svaneke";"no";0;0;0;55,135555;15,141388
1774;"Svaneke";"no";0;0;0;55,135555;15,141388
1775;"Svaneke";"no";0;0;0;55,135555;15,141388
1776;"Svaneke";"no";0;0;0;55,135555;15,141388
1777;"Svaneke";"no";0;0;0;55,135555;15,141388
1778;"Svaneke";"no";0;0;0;55,135555;15,141388
1779;"Svaneke";"no";0;0;0;55,135555;15,141388
1780;"Svaneke";"no";0;0;0;55,135555;15,141388
1781;"Svaneke";"no";0;0;0;55,135555;15,141388
1782;"Svaneke";"no";0;0;0;55,135555;15,141388
1783;"Svaneke";"no";0;0;0;55,135555;15,141388
1784;"Svaneke";"no";0;0;0;55,135555;15,141388
1785;"Svaneke";"no";0;0;0;55,135555;15,141388
1786;"Svaneke";"no";0;0;0;55,135555;15,141388
1787;"Svaneke";"no";0;0;0;55,135555;15,141388
1788;"Svaneke";"no";0;0;0;55,135555;15,141388
1789;"Svaneke";"no";0;0;0;55,135555;15,141388
1790;"Svaneke";"no";0;0;0;55,135555;15,141388
1791;"Svaneke";"no";0;0;0;55,135555;15,141388
1792;"Svaneke";"no";0;0;0;55,135555;15,141388
1793;"Svaneke";"no";0;0;0;55,135555;15,141388
1794;"Svaneke";"no";0;0;0;55,135555;15,141388
1795;"Svaneke";"no";0;0;0;55,135555;15,141388
1796;"Svaneke";"no";0;0;0;55,135555;15,141388
1797;"Svaneke";"no";0;0;0;55,135555;15,141388
1798;"Svaneke";"no";0;0;0;55,135555;15,141388
1799;"Svaneke";"no";0;0;0;55,135555;15,141388
1800;"Svaneke";"no";0;0;0;55,135555;15,141388
1801;"Svaneke";"no";0;0;0;55,135555;15,141388
1802;"Svaneke";"no";0;0;0;55,135555;15,141388
1803;"Svaneke";"no";0;1;1;55,135555;15,141388
1804;"Svaneke";"no";0;0;0;55,135555;15,141388
1805;"Svaneke";"no";0;0;0;55,135555;15,141388
1806;"Svaneke";"no";0;0;0;55,135555;15,141388
1807;"Svaneke";"no";0;0;0;55,135555;15,141388
1808;"Svaneke";"no";0;0;0;55,135555;15,141388
1809;"Svaneke";"no";0;0;0;55,135555;15,141388
1810;"Svaneke";"no";0;0;0;55,135555;15,141388
1811;"Svaneke";"no";0;0;0;55,135555;15,141388
1812;"Svaneke";"no";0;0;0;55,135555;15,141388
1813;"Svaneke";"no";0;0;0;55,135555;15,141388
1814;"Svaneke";"no";0;0;0;55,135555;15,141388
1815;"Svaneke";"no";0;0;0;55,135555;15,141388
1816;"Svaneke";"no";0;0;0;55,135555;15,141388
1817;"Svaneke";"no";0;0;0;55,135555;15,141388
1818;"Svaneke";"no";0;0;0;55,135555;15,141388
1819;"Svaneke";"no";0;0;0;55,135555;15,141388
1820;"Svaneke";"no";0;0;0;55,135555;15,141388
1821;"Svaneke";"no";0;0;0;55,135555;15,141388
1822;"Svaneke";"no";0;0;0;55,135555;15,141388
1823;"Svaneke";"no";0;0;0;55,135555;15,141388
1824;"Svaneke";"no";0;0;0;55,135555;15,141388
1825;"Svaneke";"no";0;0;0;55,135555;15,141388
1826;"Svaneke";"no";0;0;0;55,135555;15,141388
1827;"Svaneke";"no";0;0;0;55,135555;15,141388
1828;"Svaneke";"no";0;1;1;55,135555;15,141388
1829;"Svaneke";"no";0;0;0;55,135555;15,141388
1830;"Svaneke";"no";0;0;0;55,135555;15,141388
1831;"Svaneke";"no";0;0;0;55,135555;15,141388
1832;"Svaneke";"no";0;0;0;55,135555;15,141388
1833;"Svaneke";"no";0;0;0;55,135555;15,141388
1834;"Svaneke";"no";0;0;0;55,135555;15,141388
1835;"Svaneke";"no";0;0;0;55,135555;15,141388
1836;"Svaneke";"no";0;1;1;55,135555;15,141388
1837;"Svaneke";"no";0;0;0;55,135555;15,141388
1838;"Svaneke";"no";0;0;0;55,135555;15,141388
1839;"Svaneke";"no";0;0;0;55,135555;15,141388
1840;"Svaneke";"no";0;0;0;55,135555;15,141388
1841;"Svaneke";"no";0;0;0;55,135555;15,141388
1842;"Svaneke";"no";2;2;4;55,135555;15,141388
1843;"Svaneke";"no";1;0;1;55,135555;15,141388
1844;"Svaneke";"no";1;0;1;55,135555;15,141388
1845;"Svaneke";"no";3;1;4;55,135555;15,141388
1846;"Svaneke";"no";1;0;1;55,135555;15,141388
1847;"Svaneke";"no";0;0;0;55,135555;15,141388
1848;"Svaneke";"no";1;0;1;55,135555;15,141388
1849;"Svaneke";"no";0;0;0;55,135555;15,141388
1850;"Svaneke";"no";0;0;0;55,135555;15,141388
1851;"Svaneke";"no";0;0;0;55,135555;15,141388
1852;"Svaneke";"no";0;0;0;55,135555;15,141388
1853;"Svaneke";"no";0;0;0;55,135555;15,141388
1854;"Svaneke";"no";0;0;0;55,135555;15,141388
1855;"Svaneke";"no";0;0;0;55,135555;15,141388
1856;"Svaneke";"no";0;0;0;55,135555;15,141388
1857;"Svaneke";"no";0;0;0;55,135555;15,141388
1634;"Grønsund";"no";0;0;0;54,883333;12,133333
1635;"Grønsund";"no";0;0;0;54,883333;12,133333
1636;"Grønsund";"no";0;0;0;54,883333;12,133333
1637;"Grønsund";"no";0;0;0;54,883333;12,133333
1638;"Grønsund";"no";0;0;0;54,883333;12,133333
1639;"Grønsund";"no";0;0;0;54,883333;12,133333
1640;"Grønsund";"no";0;0;0;54,883333;12,133333
1641;"Grønsund";"no";0;0;0;54,883333;12,133333
1642;"Grønsund";"no";0;0;0;54,883333;12,133333
1643;"Grønsund";"no";0;0;0;54,883333;12,133333
1644;"Grønsund";"no";0;0;0;54,883333;12,133333
1645;"Grønsund";"no";0;0;0;54,883333;12,133333
1646;"Grønsund";"no";0;0;0;54,883333;12,133333
1647;"Grønsund";"no";0;0;0;54,883333;12,133333
1648;"Grønsund";"no";0;0;0;54,883333;12,133333
1649;"Grønsund";"no";0;0;0;54,883333;12,133333
1650;"Grønsund";"no";0;0;0;54,883333;12,133333
1651;"Grønsund";"no";0;0;0;54,883333;12,133333
1652;"Grønsund";"no";0;0;0;54,883333;12,133333
1653;"Grønsund";"no";0;0;0;54,883333;12,133333
1654;"Grønsund";"no";0;0;0;54,883333;12,133333
1655;"Grønsund";"no";0;0;0;54,883333;12,133333
1656;"Grønsund";"no";0;0;0;54,883333;12,133333
1657;"Grønsund";"no";0;0;0;54,883333;12,133333
1658;"Grønsund";"no";0;0;0;54,883333;12,133333
1659;"Grønsund";"no";0;0;0;54,883333;12,133333
1660;"Grønsund";"no";0;0;0;54,883333;12,133333
1661;"Grønsund";"no";0;0;0;54,883333;12,133333
1662;"Grønsund";"no";0;0;0;54,883333;12,133333
1663;"Grønsund";"no";0;0;0;54,883333;12,133333
1664;"Grønsund";"no";0;0;0;54,883333;12,133333
1665;"Grønsund";"no";0;0;0;54,883333;12,133333
1666;"Grønsund";"no";0;1;1;54,883333;12,133333
1667;"Grønsund";"no";0;2;2;54,883333;12,133333
1668;"Grønsund";"no";0;3;3;54,883333;12,133333
1669;"Grønsund";"no";0;2;2;54,883333;12,133333
1670;"Grønsund";"no";0;1;1;54,883333;12,133333
1671;"Grønsund";"no";0;0;0;54,883333;12,133333
1672;"Grønsund";"no";1;0;1;54,883333;12,133333
1673;"Grønsund";"no";0;1;1;54,883333;12,133333
1674;"Grønsund";"no";0;0;0;54,883333;12,133333
1675;"Grønsund";"no";0;0;0;54,883333;12,133333
1676;"Grønsund";"no";0;0;0;54,883333;12,133333
1677;"Grønsund";"no";0;0;0;54,883333;12,133333
1678;"Grønsund";"no";0;0;0;54,883333;12,133333
1679;"Grønsund";"no";0;0;0;54,883333;12,133333
1680;"Grønsund";"no";0;0;0;54,883333;12,133333
1681;"Grønsund";"no";0;0;0;54,883333;12,133333
1682;"Grønsund";"no";0;0;0;54,883333;12,133333
1683;"Grønsund";"no";0;0;0;54,883333;12,133333
1684;"Grønsund";"no";0;0;0;54,883333;12,133333
1685;"Grønsund";"no";0;0;0;54,883333;12,133333
1686;"Grønsund";"no";0;1;1;54,883333;12,133333
1687;"Grønsund";"no";0;0;0;54,883333;12,133333
1688;"Grønsund";"no";0;0;0;54,883333;12,133333
1689;"Grønsund";"no";0;0;0;54,883333;12,133333
1690;"Grønsund";"no";0;0;0;54,883333;12,133333
1691;"Grønsund";"no";0;0;0;54,883333;12,133333
1692;"Grønsund";"no";0;0;0;54,883333;12,133333
1693;"Grønsund";"no";0;0;0;54,883333;12,133333
1694;"Grønsund";"no";0;0;0;54,883333;12,133333
1695;"Grønsund";"no";0;0;0;54,883333;12,133333
1696;"Grønsund";"no";0;0;0;54,883333;12,133333
1697;"Grønsund";"no";0;0;0;54,883333;12,133333
1698;"Grønsund";"no";0;0;0;54,883333;12,133333
1699;"Grønsund";"no";0;0;0;54,883333;12,133333
1700;"Grønsund";"no";0;0;0;54,883333;12,133333
1701;"Grønsund";"no";0;0;0;54,883333;12,133333
1702;"Grønsund";"no";0;1;1;54,883333;12,133333
1703;"Grønsund";"no";0;0;0;54,883333;12,133333
1704;"Grønsund";"no";0;0;0;54,883333;12,133333
1705;"Grønsund";"no";0;0;0;54,883333;12,133333
1706;"Grønsund";"no";0;0;0;54,883333;12,133333
1707;"Grønsund";"no";0;0;0;54,883333;12,133333
1708;"Grønsund";"no";0;0;0;54,883333;12,133333
1709;"Grønsund";"no";0;0;0;54,883333;12,133333
1710;"Grønsund";"no";0;0;0;54,883333;12,133333
1711;"Grønsund";"no";0;0;0;54,883333;12,133333
1712;"Grønsund";"no";0;0;0;54,883333;12,133333
1713;"Grønsund";"no";0;0;0;54,883333;12,133333
1714;"Grønsund";"no";0;0;0;54,883333;12,133333
1715;"Grønsund";"no";0;0;0;54,883333;12,133333
1716;"Grønsund";"no";0;0;0;54,883333;12,133333
1717;"Grønsund";"no";1;0;1;54,883333;12,133333
1718;"Grønsund";"no";0;0;0;54,883333;12,133333
1719;"Grønsund";"no";0;0;0;54,883333;12,133333
1720;"Grønsund";"no";0;0;0;54,883333;12,133333
1721;"Grønsund";"no";0;0;0;54,883333;12,133333
1722;"Grønsund";"no";0;0;0;54,883333;12,133333
1723;"Grønsund";"no";0;0;0;54,883333;12,133333
1724;"Grønsund";"no";0;0;0;54,883333;12,133333
1725;"Grønsund";"no";0;0;0;54,883333;12,133333
1726;"Grønsund";"no";0;0;0;54,883333;12,133333
1727;"Grønsund";"no";0;0;0;54,883333;12,133333
1728;"Grønsund";"no";0;0;0;54,883333;12,133333
1729;"Grønsund";"no";0;0;0;54,883333;12,133333
1730;"Grønsund";"no";0;0;0;54,883333;12,133333
1731;"Grønsund";"no";0;0;0;54,883333;12,133333
1732;"Grønsund";"no";0;1;1;54,883333;12,133333
1733;"Grønsund";"no";0;0;0;54,883333;12,133333
1734;"Grønsund";"no";0;0;0;54,883333;12,133333
1735;"Grønsund";"no";0;0;0;54,883333;12,133333
1736;"Grønsund";"no";0;0;0;54,883333;12,133333
1737;"Grønsund";"no";0;0;0;54,883333;12,133333
1738;"Grønsund";"no";0;0;0;54,883333;12,133333
1739;"Grønsund";"no";0;0;0;54,883333;12,133333
1740;"Grønsund";"no";0;0;0;54,883333;12,133333
1741;"Grønsund";"no";0;0;0;54,883333;12,133333
1742;"Grønsund";"no";0;0;0;54,883333;12,133333
1743;"Grønsund";"no";0;0;0;54,883333;12,133333
1744;"Grønsund";"no";0;0;0;54,883333;12,133333
1745;"Grønsund";"no";0;0;0;54,883333;12,133333
1746;"Grønsund";"no";0;0;0;54,883333;12,133333
1747;"Grønsund";"no";0;0;0;54,883333;12,133333
1748;"Grønsund";"no";0;0;0;54,883333;12,133333
1749;"Grønsund";"no";0;0;0;54,883333;12,133333
1750;"Grønsund";"no";0;0;0;54,883333;12,133333
1751;"Grønsund";"no";0;0;0;54,883333;12,133333
1752;"Grønsund";"no";0;0;0;54,883333;12,133333
1753;"Grønsund";"no";0;0;0;54,883333;12,133333
1754;"Grønsund";"no";0;0;0;54,883333;12,133333
1755;"Grønsund";"no";0;0;0;54,883333;12,133333
1756;"Grønsund";"no";0;0;0;54,883333;12,133333
1757;"Grønsund";"no";0;0;0;54,883333;12,133333
1758;"Grønsund";"no";0;0;0;54,883333;12,133333
1759;"Grønsund";"no";0;0;0;54,883333;12,133333
1760;"Grønsund";"no";0;0;0;54,883333;12,133333
1761;"Grønsund";"no";0;0;0;54,883333;12,133333
1762;"Grønsund";"no";0;0;0;54,883333;12,133333
1763;"Grønsund";"no";0;0;0;54,883333;12,133333
1764;"Grønsund";"no";0;0;0;54,883333;12,133333
1765;"Grønsund";"no";0;0;0;54,883333;12,133333
1766;"Grønsund";"no";0;0;0;54,883333;12,133333
1767;"Grønsund";"no";0;0;0;54,883333;12,133333
1768;"Grønsund";"no";0;0;0;54,883333;12,133333
1769;"Grønsund";"no";0;0;0;54,883333;12,133333
1770;"Grønsund";"no";0;0;0;54,883333;12,133333
1771;"Grønsund";"no";0;0;0;54,883333;12,133333
1772;"Grønsund";"no";0;0;0;54,883333;12,133333
1773;"Grønsund";"no";0;0;0;54,883333;12,133333
1774;"Grønsund";"no";0;0;0;54,883333;12,133333
1775;"Grønsund";"no";0;0;0;54,883333;12,133333
1776;"Grønsund";"no";0;0;0;54,883333;12,133333
1777;"Grønsund";"no";0;0;0;54,883333;12,133333
1778;"Grønsund";"no";0;0;0;54,883333;12,133333
1779;"Grønsund";"no";0;0;0;54,883333;12,133333
1780;"Grønsund";"no";0;0;0;54,883333;12,133333
1781;"Grønsund";"no";0;0;0;54,883333;12,133333
1782;"Grønsund";"no";0;0;0;54,883333;12,133333
1783;"Grønsund";"no";0;0;0;54,883333;12,133333
1784;"Grønsund";"no";0;0;0;54,883333;12,133333
1785;"Grønsund";"no";0;0;0;54,883333;12,133333
1786;"Grønsund";"no";0;0;0;54,883333;12,133333
1787;"Grønsund";"no";0;0;0;54,883333;12,133333
1788;"Grønsund";"no";0;0;0;54,883333;12,133333
1789;"Grønsund";"no";0;0;0;54,883333;12,133333
1790;"Grønsund";"no";0;0;0;54,883333;12,133333
1791;"Grønsund";"no";0;0;0;54,883333;12,133333
1792;"Grønsund";"no";0;0;0;54,883333;12,133333
1793;"Grønsund";"no";0;0;0;54,883333;12,133333
1794;"Grønsund";"no";0;0;0;54,883333;12,133333
1795;"Grønsund";"no";0;0;0;54,883333;12,133333
1796;"Grønsund";"no";0;0;0;54,883333;12,133333
1797;"Grønsund";"no";0;0;0;54,883333;12,133333
1798;"Grønsund";"no";0;0;0;54,883333;12,133333
1799;"Grønsund";"no";0;0;0;54,883333;12,133333
1800;"Grønsund";"no";0;0;0;54,883333;12,133333
1801;"Grønsund";"no";0;0;0;54,883333;12,133333
1802;"Grønsund";"no";0;0;0;54,883333;12,133333
1803;"Grønsund";"no";0;0;0;54,883333;12,133333
1804;"Grønsund";"no";0;0;0;54,883333;12,133333
1805;"Grønsund";"no";0;0;0;54,883333;12,133333
1806;"Grønsund";"no";0;0;0;54,883333;12,133333
1807;"Grønsund";"no";0;0;0;54,883333;12,133333
1808;"Grønsund";"no";0;0;0;54,883333;12,133333
1809;"Grønsund";"no";0;0;0;54,883333;12,133333
1810;"Grønsund";"no";0;0;0;54,883333;12,133333
1811;"Grønsund";"no";0;0;0;54,883333;12,133333
1812;"Grønsund";"no";0;0;0;54,883333;12,133333
1813;"Grønsund";"no";0;0;0;54,883333;12,133333
1814;"Grønsund";"no";0;0;0;54,883333;12,133333
1815;"Grønsund";"no";0;0;0;54,883333;12,133333
1816;"Grønsund";"no";0;0;0;54,883333;12,133333
1817;"Grønsund";"no";0;0;0;54,883333;12,133333
1818;"Grønsund";"no";0;0;0;54,883333;12,133333
1819;"Grønsund";"no";0;0;0;54,883333;12,133333
1820;"Grønsund";"no";0;0;0;54,883333;12,133333
1821;"Grønsund";"no";0;0;0;54,883333;12,133333
1822;"Grønsund";"no";0;0;0;54,883333;12,133333
1823;"Grønsund";"no";0;0;0;54,883333;12,133333
1824;"Grønsund";"no";0;0;0;54,883333;12,133333
1825;"Grønsund";"no";0;0;0;54,883333;12,133333
1826;"Grønsund";"no";0;0;0;54,883333;12,133333
1827;"Grønsund";"no";0;0;0;54,883333;12,133333
1828;"Grønsund";"no";0;0;0;54,883333;12,133333
1829;"Grønsund";"no";0;0;0;54,883333;12,133333
1830;"Grønsund";"no";0;0;0;54,883333;12,133333
1831;"Grønsund";"no";0;0;0;54,883333;12,133333
1832;"Grønsund";"no";0;0;0;54,883333;12,133333
1833;"Grønsund";"no";0;0;0;54,883333;12,133333
1834;"Grønsund";"no";0;0;0;54,883333;12,133333
1835;"Grønsund";"no";0;0;0;54,883333;12,133333
1836;"Grønsund";"no";0;0;0;54,883333;12,133333
1837;"Grønsund";"no";0;0;0;54,883333;12,133333
1838;"Grønsund";"no";0;0;0;54,883333;12,133333
1839;"Grønsund";"no";0;0;0;54,883333;12,133333
1840;"Grønsund";"no";0;0;0;54,883333;12,133333
1841;"Grønsund";"no";0;0;0;54,883333;12,133333
1842;"Grønsund";"no";0;0;0;54,883333;12,133333
1843;"Grønsund";"no";0;0;0;54,883333;12,133333
1844;"Grønsund";"no";0;0;0;54,883333;12,133333
1845;"Grønsund";"no";0;0;0;54,883333;12,133333
1846;"Grønsund";"no";0;0;0;54,883333;12,133333
1847;"Grønsund";"no";0;0;0;54,883333;12,133333
1848;"Grønsund";"no";0;0;0;54,883333;12,133333
1849;"Grønsund";"no";0;0;0;54,883333;12,133333
1850;"Grønsund";"no";0;0;0;54,883333;12,133333
1851;"Grønsund";"no";0;0;0;54,883333;12,133333
1852;"Grønsund";"no";0;0;0;54,883333;12,133333
1853;"Grønsund";"no";0;0;0;54,883333;12,133333
1854;"Grønsund";"no";0;1;1;54,883333;12,133333
1855;"Grønsund";"no";0;0;0;54,883333;12,133333
1856;"Grønsund";"no";0;0;0;54,883333;12,133333
1857;"Grønsund";"no";0;0;0;54,883333;12,133333
1634;"Ringkøbing";"no";0;0;0;56,09;8,243888
1635;"Ringkøbing";"no";0;0;0;56,09;8,243888
1636;"Ringkøbing";"no";0;0;0;56,09;8,243888
1637;"Ringkøbing";"no";0;0;0;56,09;8,243888
1638;"Ringkøbing";"no";0;0;0;56,09;8,243888
1639;"Ringkøbing";"no";0;0;0;56,09;8,243888
1640;"Ringkøbing";"no";0;0;0;56,09;8,243888
1641;"Ringkøbing";"no";0;0;0;56,09;8,243888
1642;"Ringkøbing";"no";0;0;0;56,09;8,243888
1643;"Ringkøbing";"no";0;0;0;56,09;8,243888
1644;"Ringkøbing";"no";0;0;0;56,09;8,243888
1645;"Ringkøbing";"no";0;0;0;56,09;8,243888
1646;"Ringkøbing";"no";0;0;0;56,09;8,243888
1647;"Ringkøbing";"no";0;0;0;56,09;8,243888
1648;"Ringkøbing";"no";0;0;0;56,09;8,243888
1649;"Ringkøbing";"no";0;0;0;56,09;8,243888
1650;"Ringkøbing";"no";0;0;0;56,09;8,243888
1651;"Ringkøbing";"no";0;0;0;56,09;8,243888
1652;"Ringkøbing";"no";0;0;0;56,09;8,243888
1653;"Ringkøbing";"no";0;0;0;56,09;8,243888
1654;"Ringkøbing";"no";0;0;0;56,09;8,243888
1655;"Ringkøbing";"no";0;0;0;56,09;8,243888
1656;"Ringkøbing";"no";0;0;0;56,09;8,243888
1657;"Ringkøbing";"no";0;0;0;56,09;8,243888
1658;"Ringkøbing";"no";0;0;0;56,09;8,243888
1659;"Ringkøbing";"no";0;0;0;56,09;8,243888
1660;"Ringkøbing";"no";0;0;0;56,09;8,243888
1661;"Ringkøbing";"no";0;0;0;56,09;8,243888
1662;"Ringkøbing";"no";0;0;0;56,09;8,243888
1663;"Ringkøbing";"no";0;0;0;56,09;8,243888
1664;"Ringkøbing";"no";0;0;0;56,09;8,243888
1665;"Ringkøbing";"no";0;0;0;56,09;8,243888
1666;"Ringkøbing";"no";0;0;0;56,09;8,243888
1667;"Ringkøbing";"no";0;0;0;56,09;8,243888
1668;"Ringkøbing";"no";0;0;0;56,09;8,243888
1669;"Ringkøbing";"no";0;0;0;56,09;8,243888
1670;"Ringkøbing";"no";0;0;0;56,09;8,243888
1671;"Ringkøbing";"no";0;0;0;56,09;8,243888
1672;"Ringkøbing";"no";0;0;0;56,09;8,243888
1673;"Ringkøbing";"no";0;0;0;56,09;8,243888
1674;"Ringkøbing";"no";0;0;0;56,09;8,243888
1675;"Ringkøbing";"no";0;0;0;56,09;8,243888
1676;"Ringkøbing";"no";0;0;0;56,09;8,243888
1677;"Ringkøbing";"no";2;0;2;56,09;8,243888
1678;"Ringkøbing";"no";0;0;0;56,09;8,243888
1679;"Ringkøbing";"no";0;0;0;56,09;8,243888
1680;"Ringkøbing";"no";0;0;0;56,09;8,243888
1681;"Ringkøbing";"no";0;0;0;56,09;8,243888
1682;"Ringkøbing";"no";0;0;0;56,09;8,243888
1683;"Ringkøbing";"no";0;0;0;56,09;8,243888
1684;"Ringkøbing";"no";0;0;0;56,09;8,243888
1685;"Ringkøbing";"no";0;0;0;56,09;8,243888
1686;"Ringkøbing";"no";0;0;0;56,09;8,243888
1687;"Ringkøbing";"no";0;0;0;56,09;8,243888
1688;"Ringkøbing";"no";0;0;0;56,09;8,243888
1689;"Ringkøbing";"no";0;0;0;56,09;8,243888
1690;"Ringkøbing";"no";0;0;0;56,09;8,243888
1691;"Ringkøbing";"no";0;0;0;56,09;8,243888
1692;"Ringkøbing";"no";0;0;0;56,09;8,243888
1693;"Ringkøbing";"no";0;0;0;56,09;8,243888
1694;"Ringkøbing";"no";0;0;0;56,09;8,243888
1695;"Ringkøbing";"no";0;0;0;56,09;8,243888
1696;"Ringkøbing";"no";0;0;0;56,09;8,243888
1697;"Ringkøbing";"no";0;0;0;56,09;8,243888
1698;"Ringkøbing";"no";0;0;0;56,09;8,243888
1699;"Ringkøbing";"no";0;0;0;56,09;8,243888
1700;"Ringkøbing";"no";0;0;0;56,09;8,243888
1701;"Ringkøbing";"no";0;0;0;56,09;8,243888
1702;"Ringkøbing";"no";0;0;0;56,09;8,243888
1703;"Ringkøbing";"no";0;0;0;56,09;8,243888
1704;"Ringkøbing";"no";0;0;0;56,09;8,243888
1705;"Ringkøbing";"no";0;0;0;56,09;8,243888
1706;"Ringkøbing";"no";0;0;0;56,09;8,243888
1707;"Ringkøbing";"no";0;0;0;56,09;8,243888
1708;"Ringkøbing";"no";0;0;0;56,09;8,243888
1709;"Ringkøbing";"no";0;0;0;56,09;8,243888
1710;"Ringkøbing";"no";0;0;0;56,09;8,243888
1711;"Ringkøbing";"no";0;0;0;56,09;8,243888
1712;"Ringkøbing";"no";0;0;0;56,09;8,243888
1713;"Ringkøbing";"no";0;0;0;56,09;8,243888
1714;"Ringkøbing";"no";0;0;0;56,09;8,243888
1715;"Ringkøbing";"no";0;0;0;56,09;8,243888
1716;"Ringkøbing";"no";0;0;0;56,09;8,243888
1717;"Ringkøbing";"no";0;0;0;56,09;8,243888
1718;"Ringkøbing";"no";0;0;0;56,09;8,243888
1719;"Ringkøbing";"no";0;0;0;56,09;8,243888
1720;"Ringkøbing";"no";0;0;0;56,09;8,243888
1721;"Ringkøbing";"no";0;0;0;56,09;8,243888
1722;"Ringkøbing";"no";0;0;0;56,09;8,243888
1723;"Ringkøbing";"no";0;0;0;56,09;8,243888
1724;"Ringkøbing";"no";0;0;0;56,09;8,243888
1725;"Ringkøbing";"no";0;0;0;56,09;8,243888
1726;"Ringkøbing";"no";0;0;0;56,09;8,243888
1727;"Ringkøbing";"no";0;0;0;56,09;8,243888
1728;"Ringkøbing";"no";0;0;0;56,09;8,243888
1729;"Ringkøbing";"no";0;0;0;56,09;8,243888
1730;"Ringkøbing";"no";0;0;0;56,09;8,243888
1731;"Ringkøbing";"no";0;0;0;56,09;8,243888
1732;"Ringkøbing";"no";0;0;0;56,09;8,243888
1733;"Ringkøbing";"no";0;0;0;56,09;8,243888
1734;"Ringkøbing";"no";0;0;0;56,09;8,243888
1735;"Ringkøbing";"no";0;0;0;56,09;8,243888
1736;"Ringkøbing";"no";0;0;0;56,09;8,243888
1737;"Ringkøbing";"no";0;0;0;56,09;8,243888
1738;"Ringkøbing";"no";0;0;0;56,09;8,243888
1739;"Ringkøbing";"no";0;0;0;56,09;8,243888
1740;"Ringkøbing";"no";0;0;0;56,09;8,243888
1741;"Ringkøbing";"no";0;0;0;56,09;8,243888
1742;"Ringkøbing";"no";0;0;0;56,09;8,243888
1743;"Ringkøbing";"no";0;0;0;56,09;8,243888
1744;"Ringkøbing";"no";0;0;0;56,09;8,243888
1745;"Ringkøbing";"no";0;0;0;56,09;8,243888
1746;"Ringkøbing";"no";0;0;0;56,09;8,243888
1747;"Ringkøbing";"no";0;0;0;56,09;8,243888
1748;"Ringkøbing";"no";0;0;0;56,09;8,243888
1749;"Ringkøbing";"no";0;0;0;56,09;8,243888
1750;"Ringkøbing";"no";0;0;0;56,09;8,243888
1751;"Ringkøbing";"no";0;0;0;56,09;8,243888
1752;"Ringkøbing";"no";0;0;0;56,09;8,243888
1753;"Ringkøbing";"no";0;0;0;56,09;8,243888
1754;"Ringkøbing";"no";0;0;0;56,09;8,243888
1755;"Ringkøbing";"no";0;0;0;56,09;8,243888
1756;"Ringkøbing";"no";0;0;0;56,09;8,243888
1757;"Ringkøbing";"no";0;0;0;56,09;8,243888
1758;"Ringkøbing";"no";0;0;0;56,09;8,243888
1759;"Ringkøbing";"no";0;0;0;56,09;8,243888
1760;"Ringkøbing";"no";0;0;0;56,09;8,243888
1761;"Ringkøbing";"no";0;0;0;56,09;8,243888
1762;"Ringkøbing";"no";0;0;0;56,09;8,243888
1763;"Ringkøbing";"no";0;0;0;56,09;8,243888
1764;"Ringkøbing";"no";0;0;0;56,09;8,243888
1765;"Ringkøbing";"no";0;0;0;56,09;8,243888
1766;"Ringkøbing";"no";0;0;0;56,09;8,243888
1767;"Ringkøbing";"no";0;1;1;56,09;8,243888
1768;"Ringkøbing";"no";1;1;2;56,09;8,243888
1769;"Ringkøbing";"no";1;1;2;56,09;8,243888
1770;"Ringkøbing";"no";1;1;2;56,09;8,243888
1771;"Ringkøbing";"no";0;0;0;56,09;8,243888
1772;"Ringkøbing";"no";1;1;2;56,09;8,243888
1773;"Ringkøbing";"no";0;0;0;56,09;8,243888
1774;"Ringkøbing";"no";1;1;2;56,09;8,243888
1775;"Ringkøbing";"no";0;1;1;56,09;8,243888
1776;"Ringkøbing";"no";1;2;3;56,09;8,243888
1777;"Ringkøbing";"no";0;2;2;56,09;8,243888
1778;"Ringkøbing";"no";0;1;1;56,09;8,243888
1779;"Ringkøbing";"no";0;1;1;56,09;8,243888
1780;"Ringkøbing";"no";1;2;3;56,09;8,243888
1781;"Ringkøbing";"no";0;1;1;56,09;8,243888
1782;"Ringkøbing";"no";0;2;2;56,09;8,243888
1783;"Ringkøbing";"no";0;1;1;56,09;8,243888
1784;"Ringkøbing";"no";0;2;2;56,09;8,243888
1785;"Ringkøbing";"no";0;2;2;56,09;8,243888
1786;"Ringkøbing";"no";2;2;4;56,09;8,243888
1787;"Ringkøbing";"no";0;1;1;56,09;8,243888
1788;"Ringkøbing";"no";0;0;0;56,09;8,243888
1789;"Ringkøbing";"no";0;2;2;56,09;8,243888
1790;"Ringkøbing";"no";0;2;2;56,09;8,243888
1791;"Ringkøbing";"no";0;2;2;56,09;8,243888
1792;"Ringkøbing";"no";0;0;0;56,09;8,243888
1793;"Ringkøbing";"no";0;1;1;56,09;8,243888
1794;"Ringkøbing";"no";0;1;1;56,09;8,243888
1795;"Ringkøbing";"no";0;1;1;56,09;8,243888
1796;"Ringkøbing";"no";0;0;0;56,09;8,243888
1797;"Ringkøbing";"no";0;1;1;56,09;8,243888
1798;"Ringkøbing";"no";0;1;1;56,09;8,243888
1799;"Ringkøbing";"no";0;1;1;56,09;8,243888
1800;"Ringkøbing";"no";0;1;1;56,09;8,243888
1801;"Ringkøbing";"no";0;2;2;56,09;8,243888
1802;"Ringkøbing";"no";0;1;1;56,09;8,243888
1803;"Ringkøbing";"no";1;2;3;56,09;8,243888
1804;"Ringkøbing";"no";0;0;0;56,09;8,243888
1805;"Ringkøbing";"no";0;2;2;56,09;8,243888
1806;"Ringkøbing";"no";0;2;2;56,09;8,243888
1807;"Ringkøbing";"no";0;0;0;56,09;8,243888
1808;"Ringkøbing";"no";0;0;0;56,09;8,243888
1809;"Ringkøbing";"no";0;0;0;56,09;8,243888
1810;"Ringkøbing";"no";0;0;0;56,09;8,243888
1811;"Ringkøbing";"no";0;0;0;56,09;8,243888
1812;"Ringkøbing";"no";0;0;0;56,09;8,243888
1813;"Ringkøbing";"no";0;0;0;56,09;8,243888
1814;"Ringkøbing";"no";0;0;0;56,09;8,243888
1815;"Ringkøbing";"no";1;1;2;56,09;8,243888
1816;"Ringkøbing";"no";2;2;4;56,09;8,243888
1817;"Ringkøbing";"no";0;1;1;56,09;8,243888
1818;"Ringkøbing";"no";1;2;3;56,09;8,243888
1819;"Ringkøbing";"no";1;3;4;56,09;8,243888
1820;"Ringkøbing";"no";0;3;3;56,09;8,243888
1821;"Ringkøbing";"no";0;1;1;56,09;8,243888
1822;"Ringkøbing";"no";1;2;3;56,09;8,243888
1823;"Ringkøbing";"no";0;1;1;56,09;8,243888
1824;"Ringkøbing";"no";0;0;0;56,09;8,243888
1825;"Ringkøbing";"no";0;1;1;56,09;8,243888
1826;"Ringkøbing";"no";0;0;0;56,09;8,243888
1827;"Ringkøbing";"no";0;1;1;56,09;8,243888
1828;"Ringkøbing";"no";0;0;0;56,09;8,243888
1829;"Ringkøbing";"no";0;0;0;56,09;8,243888
1830;"Ringkøbing";"no";0;0;0;56,09;8,243888
1831;"Ringkøbing";"no";0;0;0;56,09;8,243888
1832;"Ringkøbing";"no";1;0;1;56,09;8,243888
1833;"Ringkøbing";"no";0;0;0;56,09;8,243888
1834;"Ringkøbing";"no";1;1;2;56,09;8,243888
1835;"Ringkøbing";"no";0;0;0;56,09;8,243888
1836;"Ringkøbing";"no";0;1;1;56,09;8,243888
1837;"Ringkøbing";"no";1;3;4;56,09;8,243888
1838;"Ringkøbing";"no";1;2;3;56,09;8,243888
1839;"Ringkøbing";"no";1;1;2;56,09;8,243888
1840;"Ringkøbing";"no";0;2;2;56,09;8,243888
1841;"Ringkøbing";"no";3;3;6;56,09;8,243888
1842;"Ringkøbing";"no";0;0;0;56,09;8,243888
1843;"Ringkøbing";"no";0;0;0;56,09;8,243888
1844;"Ringkøbing";"no";1;0;1;56,09;8,243888
1845;"Ringkøbing";"no";0;0;0;56,09;8,243888
1846;"Ringkøbing";"no";4;0;4;56,09;8,243888
1847;"Ringkøbing";"no";0;0;0;56,09;8,243888
1848;"Ringkøbing";"no";0;0;0;56,09;8,243888
1849;"Ringkøbing";"no";3;0;3;56,09;8,243888
1850;"Ringkøbing";"no";2;1;3;56,09;8,243888
1851;"Ringkøbing";"no";1;1;2;56,09;8,243888
1852;"Ringkøbing";"no";1;0;1;56,09;8,243888
1853;"Ringkøbing";"no";0;0;0;56,09;8,243888
1854;"Ringkøbing";"no";0;0;0;56,09;8,243888
1855;"Ringkøbing";"no";3;0;3;56,09;8,243888
1856;"Ringkøbing";"no";2;0;2;56,09;8,243888
1857;"Ringkøbing";"no";0;0;0;56,09;8,243888
1634;"Bogense";"no";0;0;0;55,566666;10,088611
1635;"Bogense";"no";0;0;0;55,566666;10,088611
1636;"Bogense";"no";0;0;0;55,566666;10,088611
1637;"Bogense";"no";0;0;0;55,566666;10,088611
1638;"Bogense";"no";0;0;0;55,566666;10,088611
1639;"Bogense";"no";0;0;0;55,566666;10,088611
1640;"Bogense";"no";0;0;0;55,566666;10,088611
1641;"Bogense";"no";0;0;0;55,566666;10,088611
1642;"Bogense";"no";0;0;0;55,566666;10,088611
1643;"Bogense";"no";0;0;0;55,566666;10,088611
1644;"Bogense";"no";0;0;0;55,566666;10,088611
1645;"Bogense";"no";0;0;0;55,566666;10,088611
1646;"Bogense";"no";0;0;0;55,566666;10,088611
1647;"Bogense";"no";0;0;0;55,566666;10,088611
1648;"Bogense";"no";0;0;0;55,566666;10,088611
1649;"Bogense";"no";0;0;0;55,566666;10,088611
1650;"Bogense";"no";0;0;0;55,566666;10,088611
1651;"Bogense";"no";0;0;0;55,566666;10,088611
1652;"Bogense";"no";0;0;0;55,566666;10,088611
1653;"Bogense";"no";0;0;0;55,566666;10,088611
1654;"Bogense";"no";0;0;0;55,566666;10,088611
1655;"Bogense";"no";0;0;0;55,566666;10,088611
1656;"Bogense";"no";0;0;0;55,566666;10,088611
1657;"Bogense";"no";0;0;0;55,566666;10,088611
1658;"Bogense";"no";0;0;0;55,566666;10,088611
1659;"Bogense";"no";0;0;0;55,566666;10,088611
1660;"Bogense";"no";0;0;0;55,566666;10,088611
1661;"Bogense";"no";0;0;0;55,566666;10,088611
1662;"Bogense";"no";0;0;0;55,566666;10,088611
1663;"Bogense";"no";0;0;0;55,566666;10,088611
1664;"Bogense";"no";0;0;0;55,566666;10,088611
1665;"Bogense";"no";0;0;0;55,566666;10,088611
1666;"Bogense";"no";0;0;0;55,566666;10,088611
1667;"Bogense";"no";0;0;0;55,566666;10,088611
1668;"Bogense";"no";0;0;0;55,566666;10,088611
1669;"Bogense";"no";0;0;0;55,566666;10,088611
1670;"Bogense";"no";0;0;0;55,566666;10,088611
1671;"Bogense";"no";0;0;0;55,566666;10,088611
1672;"Bogense";"no";0;0;0;55,566666;10,088611
1673;"Bogense";"no";0;0;0;55,566666;10,088611
1674;"Bogense";"no";0;0;0;55,566666;10,088611
1675;"Bogense";"no";0;0;0;55,566666;10,088611
1676;"Bogense";"no";0;0;0;55,566666;10,088611
1677;"Bogense";"no";0;0;0;55,566666;10,088611
1678;"Bogense";"no";0;0;0;55,566666;10,088611
1679;"Bogense";"no";0;0;0;55,566666;10,088611
1680;"Bogense";"no";1;0;1;55,566666;10,088611
1681;"Bogense";"no";0;0;0;55,566666;10,088611
1682;"Bogense";"no";0;0;0;55,566666;10,088611
1683;"Bogense";"no";0;0;0;55,566666;10,088611
1684;"Bogense";"no";0;0;0;55,566666;10,088611
1685;"Bogense";"no";0;0;0;55,566666;10,088611
1686;"Bogense";"no";0;0;0;55,566666;10,088611
1687;"Bogense";"no";0;0;0;55,566666;10,088611
1688;"Bogense";"no";0;0;0;55,566666;10,088611
1689;"Bogense";"no";0;0;0;55,566666;10,088611
1690;"Bogense";"no";0;0;0;55,566666;10,088611
1691;"Bogense";"no";0;0;0;55,566666;10,088611
1692;"Bogense";"no";0;0;0;55,566666;10,088611
1693;"Bogense";"no";0;0;0;55,566666;10,088611
1694;"Bogense";"no";0;0;0;55,566666;10,088611
1695;"Bogense";"no";1;0;1;55,566666;10,088611
1696;"Bogense";"no";0;0;0;55,566666;10,088611
1697;"Bogense";"no";0;0;0;55,566666;10,088611
1698;"Bogense";"no";0;0;0;55,566666;10,088611
1699;"Bogense";"no";0;0;0;55,566666;10,088611
1700;"Bogense";"no";0;0;0;55,566666;10,088611
1701;"Bogense";"no";0;0;0;55,566666;10,088611
1702;"Bogense";"no";0;0;0;55,566666;10,088611
1703;"Bogense";"no";0;0;0;55,566666;10,088611
1704;"Bogense";"no";0;0;0;55,566666;10,088611
1705;"Bogense";"no";0;0;0;55,566666;10,088611
1706;"Bogense";"no";0;0;0;55,566666;10,088611
1707;"Bogense";"no";0;0;0;55,566666;10,088611
1708;"Bogense";"no";0;0;0;55,566666;10,088611
1709;"Bogense";"no";0;0;0;55,566666;10,088611
1710;"Bogense";"no";0;0;0;55,566666;10,088611
1711;"Bogense";"no";0;0;0;55,566666;10,088611
1712;"Bogense";"no";0;0;0;55,566666;10,088611
1713;"Bogense";"no";0;0;0;55,566666;10,088611
1714;"Bogense";"no";0;0;0;55,566666;10,088611
1715;"Bogense";"no";0;0;0;55,566666;10,088611
1716;"Bogense";"no";0;0;0;55,566666;10,088611
1717;"Bogense";"no";0;0;0;55,566666;10,088611
1718;"Bogense";"no";0;0;0;55,566666;10,088611
1719;"Bogense";"no";0;0;0;55,566666;10,088611
1720;"Bogense";"no";0;0;0;55,566666;10,088611
1721;"Bogense";"no";0;0;0;55,566666;10,088611
1722;"Bogense";"no";0;0;0;55,566666;10,088611
1723;"Bogense";"no";0;0;0;55,566666;10,088611
1724;"Bogense";"no";0;0;0;55,566666;10,088611
1725;"Bogense";"no";0;0;0;55,566666;10,088611
1726;"Bogense";"no";0;0;0;55,566666;10,088611
1727;"Bogense";"no";0;0;0;55,566666;10,088611
1728;"Bogense";"no";0;0;0;55,566666;10,088611
1729;"Bogense";"no";0;0;0;55,566666;10,088611
1730;"Bogense";"no";0;0;0;55,566666;10,088611
1731;"Bogense";"no";0;0;0;55,566666;10,088611
1732;"Bogense";"no";0;0;0;55,566666;10,088611
1733;"Bogense";"no";0;0;0;55,566666;10,088611
1734;"Bogense";"no";0;0;0;55,566666;10,088611
1735;"Bogense";"no";0;0;0;55,566666;10,088611
1736;"Bogense";"no";0;0;0;55,566666;10,088611
1737;"Bogense";"no";0;0;0;55,566666;10,088611
1738;"Bogense";"no";0;0;0;55,566666;10,088611
1739;"Bogense";"no";0;0;0;55,566666;10,088611
1740;"Bogense";"no";0;0;0;55,566666;10,088611
1741;"Bogense";"no";0;0;0;55,566666;10,088611
1742;"Bogense";"no";0;0;0;55,566666;10,088611
1743;"Bogense";"no";0;0;0;55,566666;10,088611
1744;"Bogense";"no";0;0;0;55,566666;10,088611
1745;"Bogense";"no";0;0;0;55,566666;10,088611
1746;"Bogense";"no";0;0;0;55,566666;10,088611
1747;"Bogense";"no";0;0;0;55,566666;10,088611
1748;"Bogense";"no";0;0;0;55,566666;10,088611
1749;"Bogense";"no";0;0;0;55,566666;10,088611
1750;"Bogense";"no";0;0;0;55,566666;10,088611
1751;"Bogense";"no";0;0;0;55,566666;10,088611
1752;"Bogense";"no";0;0;0;55,566666;10,088611
1753;"Bogense";"no";0;0;0;55,566666;10,088611
1754;"Bogense";"no";0;0;0;55,566666;10,088611
1755;"Bogense";"no";0;0;0;55,566666;10,088611
1756;"Bogense";"no";0;1;1;55,566666;10,088611
1757;"Bogense";"no";0;0;0;55,566666;10,088611
1758;"Bogense";"no";0;0;0;55,566666;10,088611
1759;"Bogense";"no";0;0;0;55,566666;10,088611
1760;"Bogense";"no";0;0;0;55,566666;10,088611
1761;"Bogense";"no";0;0;0;55,566666;10,088611
1762;"Bogense";"no";0;0;0;55,566666;10,088611
1763;"Bogense";"no";0;0;0;55,566666;10,088611
1764;"Bogense";"no";0;0;0;55,566666;10,088611
1765;"Bogense";"no";0;0;0;55,566666;10,088611
1766;"Bogense";"no";0;0;0;55,566666;10,088611
1767;"Bogense";"no";0;0;0;55,566666;10,088611
1768;"Bogense";"no";0;0;0;55,566666;10,088611
1769;"Bogense";"no";0;0;0;55,566666;10,088611
1770;"Bogense";"no";0;0;0;55,566666;10,088611
1771;"Bogense";"no";0;0;0;55,566666;10,088611
1772;"Bogense";"no";0;0;0;55,566666;10,088611
1773;"Bogense";"no";0;0;0;55,566666;10,088611
1774;"Bogense";"no";0;0;0;55,566666;10,088611
1775;"Bogense";"no";0;0;0;55,566666;10,088611
1776;"Bogense";"no";0;0;0;55,566666;10,088611
1777;"Bogense";"no";0;0;0;55,566666;10,088611
1778;"Bogense";"no";0;0;0;55,566666;10,088611
1779;"Bogense";"no";0;0;0;55,566666;10,088611
1780;"Bogense";"no";0;0;0;55,566666;10,088611
1781;"Bogense";"no";0;0;0;55,566666;10,088611
1782;"Bogense";"no";0;0;0;55,566666;10,088611
1783;"Bogense";"no";0;0;0;55,566666;10,088611
1784;"Bogense";"no";0;0;0;55,566666;10,088611
1785;"Bogense";"no";0;0;0;55,566666;10,088611
1786;"Bogense";"no";0;0;0;55,566666;10,088611
1787;"Bogense";"no";0;0;0;55,566666;10,088611
1788;"Bogense";"no";0;0;0;55,566666;10,088611
1789;"Bogense";"no";0;0;0;55,566666;10,088611
1790;"Bogense";"no";0;0;0;55,566666;10,088611
1791;"Bogense";"no";0;0;0;55,566666;10,088611
1792;"Bogense";"no";0;0;0;55,566666;10,088611
1793;"Bogense";"no";0;0;0;55,566666;10,088611
1794;"Bogense";"no";0;0;0;55,566666;10,088611
1795;"Bogense";"no";0;0;0;55,566666;10,088611
1796;"Bogense";"no";0;0;0;55,566666;10,088611
1797;"Bogense";"no";0;0;0;55,566666;10,088611
1798;"Bogense";"no";0;0;0;55,566666;10,088611
1799;"Bogense";"no";0;0;0;55,566666;10,088611
1800;"Bogense";"no";0;0;0;55,566666;10,088611
1801;"Bogense";"no";0;0;0;55,566666;10,088611
1802;"Bogense";"no";0;0;0;55,566666;10,088611
1803;"Bogense";"no";0;0;0;55,566666;10,088611
1804;"Bogense";"no";0;0;0;55,566666;10,088611
1805;"Bogense";"no";0;0;0;55,566666;10,088611
1806;"Bogense";"no";0;0;0;55,566666;10,088611
1807;"Bogense";"no";0;0;0;55,566666;10,088611
1808;"Bogense";"no";0;0;0;55,566666;10,088611
1809;"Bogense";"no";0;0;0;55,566666;10,088611
1810;"Bogense";"no";0;1;1;55,566666;10,088611
1811;"Bogense";"no";0;1;1;55,566666;10,088611
1812;"Bogense";"no";0;0;0;55,566666;10,088611
1813;"Bogense";"no";0;0;0;55,566666;10,088611
1814;"Bogense";"no";0;0;0;55,566666;10,088611
1815;"Bogense";"no";0;0;0;55,566666;10,088611
1816;"Bogense";"no";1;0;1;55,566666;10,088611
1817;"Bogense";"no";4;0;4;55,566666;10,088611
1818;"Bogense";"no";0;0;0;55,566666;10,088611
1819;"Bogense";"no";1;0;1;55,566666;10,088611
1820;"Bogense";"no";0;0;0;55,566666;10,088611
1821;"Bogense";"no";1;1;2;55,566666;10,088611
1822;"Bogense";"no";0;0;0;55,566666;10,088611
1823;"Bogense";"no";0;0;0;55,566666;10,088611
1824;"Bogense";"no";0;0;0;55,566666;10,088611
1825;"Bogense";"no";0;0;0;55,566666;10,088611
1826;"Bogense";"no";0;1;1;55,566666;10,088611
1827;"Bogense";"no";0;1;1;55,566666;10,088611
1828;"Bogense";"no";1;0;1;55,566666;10,088611
1829;"Bogense";"no";0;0;0;55,566666;10,088611
1830;"Bogense";"no";1;0;1;55,566666;10,088611
1831;"Bogense";"no";0;0;0;55,566666;10,088611
1832;"Bogense";"no";0;0;0;55,566666;10,088611
1833;"Bogense";"no";0;0;0;55,566666;10,088611
1834;"Bogense";"no";2;0;2;55,566666;10,088611
1835;"Bogense";"no";1;0;1;55,566666;10,088611
1836;"Bogense";"no";0;0;0;55,566666;10,088611
1837;"Bogense";"no";0;0;0;55,566666;10,088611
1838;"Bogense";"no";0;0;0;55,566666;10,088611
1839;"Bogense";"no";0;0;0;55,566666;10,088611
1840;"Bogense";"no";1;0;1;55,566666;10,088611
1841;"Bogense";"no";0;0;0;55,566666;10,088611
1842;"Bogense";"no";1;2;3;55,566666;10,088611
1843;"Bogense";"no";0;0;0;55,566666;10,088611
1844;"Bogense";"no";2;3;5;55,566666;10,088611
1845;"Bogense";"no";1;2;3;55,566666;10,088611
1846;"Bogense";"no";2;5;7;55,566666;10,088611
1847;"Bogense";"no";4;2;6;55,566666;10,088611
1848;"Bogense";"no";2;0;2;55,566666;10,088611
1849;"Bogense";"no";5;4;9;55,566666;10,088611
1850;"Bogense";"no";4;4;8;55,566666;10,088611
1851;"Bogense";"no";3;3;6;55,566666;10,088611
1852;"Bogense";"no";2;6;8;55,566666;10,088611
1853;"Bogense";"no";3;4;7;55,566666;10,088611
1854;"Bogense";"no";2;2;4;55,566666;10,088611
1855;"Bogense";"no";3;5;8;55,566666;10,088611
1856;"Bogense";"no";8;5;13;55,566666;10,088611
1857;"Bogense";"no";0;0;0;55,566666;10,088611
1634;"Humlebæk";"no";0;0;0;55,961666;12,533888
1635;"Humlebæk";"no";0;0;0;55,961666;12,533888
1636;"Humlebæk";"no";0;0;0;55,961666;12,533888
1637;"Humlebæk";"no";0;0;0;55,961666;12,533888
1638;"Humlebæk";"no";0;0;0;55,961666;12,533888
1639;"Humlebæk";"no";0;0;0;55,961666;12,533888
1640;"Humlebæk";"no";0;0;0;55,961666;12,533888
1641;"Humlebæk";"no";0;0;0;55,961666;12,533888
1642;"Humlebæk";"no";0;0;0;55,961666;12,533888
1643;"Humlebæk";"no";0;0;0;55,961666;12,533888
1644;"Humlebæk";"no";0;0;0;55,961666;12,533888
1645;"Humlebæk";"no";0;0;0;55,961666;12,533888
1646;"Humlebæk";"no";0;0;0;55,961666;12,533888
1647;"Humlebæk";"no";0;0;0;55,961666;12,533888
1648;"Humlebæk";"no";0;0;0;55,961666;12,533888
1649;"Humlebæk";"no";0;0;0;55,961666;12,533888
1650;"Humlebæk";"no";0;0;0;55,961666;12,533888
1651;"Humlebæk";"no";0;0;0;55,961666;12,533888
1652;"Humlebæk";"no";0;0;0;55,961666;12,533888
1653;"Humlebæk";"no";0;0;0;55,961666;12,533888
1654;"Humlebæk";"no";0;0;0;55,961666;12,533888
1655;"Humlebæk";"no";0;0;0;55,961666;12,533888
1656;"Humlebæk";"no";0;0;0;55,961666;12,533888
1657;"Humlebæk";"no";0;0;0;55,961666;12,533888
1658;"Humlebæk";"no";0;0;0;55,961666;12,533888
1659;"Humlebæk";"no";0;0;0;55,961666;12,533888
1660;"Humlebæk";"no";0;0;0;55,961666;12,533888
1661;"Humlebæk";"no";0;0;0;55,961666;12,533888
1662;"Humlebæk";"no";0;0;0;55,961666;12,533888
1663;"Humlebæk";"no";0;0;0;55,961666;12,533888
1664;"Humlebæk";"no";0;0;0;55,961666;12,533888
1665;"Humlebæk";"no";0;0;0;55,961666;12,533888
1666;"Humlebæk";"no";0;0;0;55,961666;12,533888
1667;"Humlebæk";"no";0;0;0;55,961666;12,533888
1668;"Humlebæk";"no";0;0;0;55,961666;12,533888
1669;"Humlebæk";"no";0;0;0;55,961666;12,533888
1670;"Humlebæk";"no";0;0;0;55,961666;12,533888
1671;"Humlebæk";"no";0;0;0;55,961666;12,533888
1672;"Humlebæk";"no";0;0;0;55,961666;12,533888
1673;"Humlebæk";"no";0;0;0;55,961666;12,533888
1674;"Humlebæk";"no";0;0;0;55,961666;12,533888
1675;"Humlebæk";"no";0;0;0;55,961666;12,533888
1676;"Humlebæk";"no";0;0;0;55,961666;12,533888
1677;"Humlebæk";"no";0;0;0;55,961666;12,533888
1678;"Humlebæk";"no";0;0;0;55,961666;12,533888
1679;"Humlebæk";"no";0;0;0;55,961666;12,533888
1680;"Humlebæk";"no";0;0;0;55,961666;12,533888
1681;"Humlebæk";"no";0;0;0;55,961666;12,533888
1682;"Humlebæk";"no";1;0;1;55,961666;12,533888
1683;"Humlebæk";"no";0;0;0;55,961666;12,533888
1684;"Humlebæk";"no";0;0;0;55,961666;12,533888
1685;"Humlebæk";"no";0;0;0;55,961666;12,533888
1686;"Humlebæk";"no";0;0;0;55,961666;12,533888
1687;"Humlebæk";"no";0;0;0;55,961666;12,533888
1688;"Humlebæk";"no";0;0;0;55,961666;12,533888
1689;"Humlebæk";"no";0;0;0;55,961666;12,533888
1690;"Humlebæk";"no";0;0;0;55,961666;12,533888
1691;"Humlebæk";"no";0;0;0;55,961666;12,533888
1692;"Humlebæk";"no";0;0;0;55,961666;12,533888
1693;"Humlebæk";"no";0;0;0;55,961666;12,533888
1694;"Humlebæk";"no";0;0;0;55,961666;12,533888
1695;"Humlebæk";"no";0;0;0;55,961666;12,533888
1696;"Humlebæk";"no";0;0;0;55,961666;12,533888
1697;"Humlebæk";"no";0;0;0;55,961666;12,533888
1698;"Humlebæk";"no";0;0;0;55,961666;12,533888
1699;"Humlebæk";"no";0;0;0;55,961666;12,533888
1700;"Humlebæk";"no";0;0;0;55,961666;12,533888
1701;"Humlebæk";"no";0;0;0;55,961666;12,533888
1702;"Humlebæk";"no";0;0;0;55,961666;12,533888
1703;"Humlebæk";"no";1;0;1;55,961666;12,533888
1704;"Humlebæk";"no";0;0;0;55,961666;12,533888
1705;"Humlebæk";"no";0;0;0;55,961666;12,533888
1706;"Humlebæk";"no";0;0;0;55,961666;12,533888
1707;"Humlebæk";"no";0;0;0;55,961666;12,533888
1708;"Humlebæk";"no";0;0;0;55,961666;12,533888
1709;"Humlebæk";"no";0;0;0;55,961666;12,533888
1710;"Humlebæk";"no";0;0;0;55,961666;12,533888
1711;"Humlebæk";"no";0;0;0;55,961666;12,533888
1712;"Humlebæk";"no";0;0;0;55,961666;12,533888
1713;"Humlebæk";"no";0;0;0;55,961666;12,533888
1714;"Humlebæk";"no";0;0;0;55,961666;12,533888
1715;"Humlebæk";"no";0;0;0;55,961666;12,533888
1716;"Humlebæk";"no";0;0;0;55,961666;12,533888
1717;"Humlebæk";"no";0;0;0;55,961666;12,533888
1718;"Humlebæk";"no";0;0;0;55,961666;12,533888
1719;"Humlebæk";"no";0;0;0;55,961666;12,533888
1720;"Humlebæk";"no";0;0;0;55,961666;12,533888
1721;"Humlebæk";"no";0;0;0;55,961666;12,533888
1722;"Humlebæk";"no";0;0;0;55,961666;12,533888
1723;"Humlebæk";"no";0;0;0;55,961666;12,533888
1724;"Humlebæk";"no";0;0;0;55,961666;12,533888
1725;"Humlebæk";"no";0;0;0;55,961666;12,533888
1726;"Humlebæk";"no";0;0;0;55,961666;12,533888
1727;"Humlebæk";"no";0;0;0;55,961666;12,533888
1728;"Humlebæk";"no";0;0;0;55,961666;12,533888
1729;"Humlebæk";"no";0;0;0;55,961666;12,533888
1730;"Humlebæk";"no";0;0;0;55,961666;12,533888
1731;"Humlebæk";"no";0;0;0;55,961666;12,533888
1732;"Humlebæk";"no";0;0;0;55,961666;12,533888
1733;"Humlebæk";"no";0;0;0;55,961666;12,533888
1734;"Humlebæk";"no";0;0;0;55,961666;12,533888
1735;"Humlebæk";"no";0;0;0;55,961666;12,533888
1736;"Humlebæk";"no";0;0;0;55,961666;12,533888
1737;"Humlebæk";"no";0;0;0;55,961666;12,533888
1738;"Humlebæk";"no";0;0;0;55,961666;12,533888
1739;"Humlebæk";"no";0;0;0;55,961666;12,533888
1740;"Humlebæk";"no";0;0;0;55,961666;12,533888
1741;"Humlebæk";"no";0;0;0;55,961666;12,533888
1742;"Humlebæk";"no";0;0;0;55,961666;12,533888
1743;"Humlebæk";"no";0;0;0;55,961666;12,533888
1744;"Humlebæk";"no";0;0;0;55,961666;12,533888
1745;"Humlebæk";"no";0;0;0;55,961666;12,533888
1746;"Humlebæk";"no";0;0;0;55,961666;12,533888
1747;"Humlebæk";"no";0;0;0;55,961666;12,533888
1748;"Humlebæk";"no";0;0;0;55,961666;12,533888
1749;"Humlebæk";"no";0;0;0;55,961666;12,533888
1750;"Humlebæk";"no";0;0;0;55,961666;12,533888
1751;"Humlebæk";"no";0;0;0;55,961666;12,533888
1752;"Humlebæk";"no";0;0;0;55,961666;12,533888
1753;"Humlebæk";"no";0;0;0;55,961666;12,533888
1754;"Humlebæk";"no";0;0;0;55,961666;12,533888
1755;"Humlebæk";"no";0;0;0;55,961666;12,533888
1756;"Humlebæk";"no";0;0;0;55,961666;12,533888
1757;"Humlebæk";"no";0;0;0;55,961666;12,533888
1758;"Humlebæk";"no";0;0;0;55,961666;12,533888
1759;"Humlebæk";"no";0;0;0;55,961666;12,533888
1760;"Humlebæk";"no";0;0;0;55,961666;12,533888
1761;"Humlebæk";"no";0;0;0;55,961666;12,533888
1762;"Humlebæk";"no";0;0;0;55,961666;12,533888
1763;"Humlebæk";"no";0;0;0;55,961666;12,533888
1764;"Humlebæk";"no";0;0;0;55,961666;12,533888
1765;"Humlebæk";"no";0;0;0;55,961666;12,533888
1766;"Humlebæk";"no";0;0;0;55,961666;12,533888
1767;"Humlebæk";"no";0;0;0;55,961666;12,533888
1768;"Humlebæk";"no";0;0;0;55,961666;12,533888
1769;"Humlebæk";"no";0;0;0;55,961666;12,533888
1770;"Humlebæk";"no";0;0;0;55,961666;12,533888
1771;"Humlebæk";"no";0;0;0;55,961666;12,533888
1772;"Humlebæk";"no";0;0;0;55,961666;12,533888
1773;"Humlebæk";"no";0;0;0;55,961666;12,533888
1774;"Humlebæk";"no";0;0;0;55,961666;12,533888
1775;"Humlebæk";"no";0;0;0;55,961666;12,533888
1776;"Humlebæk";"no";0;0;0;55,961666;12,533888
1777;"Humlebæk";"no";0;0;0;55,961666;12,533888
1778;"Humlebæk";"no";0;0;0;55,961666;12,533888
1779;"Humlebæk";"no";0;0;0;55,961666;12,533888
1780;"Humlebæk";"no";0;0;0;55,961666;12,533888
1781;"Humlebæk";"no";0;0;0;55,961666;12,533888
1782;"Humlebæk";"no";0;0;0;55,961666;12,533888
1783;"Humlebæk";"no";0;0;0;55,961666;12,533888
1784;"Humlebæk";"no";0;0;0;55,961666;12,533888
1785;"Humlebæk";"no";0;0;0;55,961666;12,533888
1786;"Humlebæk";"no";0;0;0;55,961666;12,533888
1787;"Humlebæk";"no";0;0;0;55,961666;12,533888
1788;"Humlebæk";"no";0;0;0;55,961666;12,533888
1789;"Humlebæk";"no";0;0;0;55,961666;12,533888
1790;"Humlebæk";"no";0;0;0;55,961666;12,533888
1791;"Humlebæk";"no";0;0;0;55,961666;12,533888
1792;"Humlebæk";"no";0;0;0;55,961666;12,533888
1793;"Humlebæk";"no";0;0;0;55,961666;12,533888
1794;"Humlebæk";"no";0;0;0;55,961666;12,533888
1795;"Humlebæk";"no";0;0;0;55,961666;12,533888
1796;"Humlebæk";"no";0;0;0;55,961666;12,533888
1797;"Humlebæk";"no";0;0;0;55,961666;12,533888
1798;"Humlebæk";"no";0;0;0;55,961666;12,533888
1799;"Humlebæk";"no";0;0;0;55,961666;12,533888
1800;"Humlebæk";"no";0;0;0;55,961666;12,533888
1801;"Humlebæk";"no";0;0;0;55,961666;12,533888
1802;"Humlebæk";"no";0;0;0;55,961666;12,533888
1803;"Humlebæk";"no";0;0;0;55,961666;12,533888
1804;"Humlebæk";"no";0;0;0;55,961666;12,533888
1805;"Humlebæk";"no";0;0;0;55,961666;12,533888
1806;"Humlebæk";"no";0;0;0;55,961666;12,533888
1807;"Humlebæk";"no";0;0;0;55,961666;12,533888
1808;"Humlebæk";"no";0;0;0;55,961666;12,533888
1809;"Humlebæk";"no";0;0;0;55,961666;12,533888
1810;"Humlebæk";"no";0;0;0;55,961666;12,533888
1811;"Humlebæk";"no";0;0;0;55,961666;12,533888
1812;"Humlebæk";"no";0;0;0;55,961666;12,533888
1813;"Humlebæk";"no";0;0;0;55,961666;12,533888
1814;"Humlebæk";"no";0;0;0;55,961666;12,533888
1815;"Humlebæk";"no";0;0;0;55,961666;12,533888
1816;"Humlebæk";"no";0;0;0;55,961666;12,533888
1817;"Humlebæk";"no";0;0;0;55,961666;12,533888
1818;"Humlebæk";"no";0;0;0;55,961666;12,533888
1819;"Humlebæk";"no";0;0;0;55,961666;12,533888
1820;"Humlebæk";"no";0;0;0;55,961666;12,533888
1821;"Humlebæk";"no";0;0;0;55,961666;12,533888
1822;"Humlebæk";"no";0;0;0;55,961666;12,533888
1823;"Humlebæk";"no";0;0;0;55,961666;12,533888
1824;"Humlebæk";"no";0;0;0;55,961666;12,533888
1825;"Humlebæk";"no";0;0;0;55,961666;12,533888
1826;"Humlebæk";"no";0;2;2;55,961666;12,533888
1827;"Humlebæk";"no";0;0;0;55,961666;12,533888
1828;"Humlebæk";"no";0;0;0;55,961666;12,533888
1829;"Humlebæk";"no";0;0;0;55,961666;12,533888
1830;"Humlebæk";"no";0;0;0;55,961666;12,533888
1831;"Humlebæk";"no";1;0;1;55,961666;12,533888
1832;"Humlebæk";"no";0;0;0;55,961666;12,533888
1833;"Humlebæk";"no";0;0;0;55,961666;12,533888
1834;"Humlebæk";"no";0;0;0;55,961666;12,533888
1835;"Humlebæk";"no";0;3;3;55,961666;12,533888
1836;"Humlebæk";"no";0;1;1;55,961666;12,533888
1837;"Humlebæk";"no";0;2;2;55,961666;12,533888
1838;"Humlebæk";"no";0;0;0;55,961666;12,533888
1839;"Humlebæk";"no";2;3;5;55,961666;12,533888
1840;"Humlebæk";"no";0;3;3;55,961666;12,533888
1841;"Humlebæk";"no";0;1;1;55,961666;12,533888
1842;"Humlebæk";"no";0;1;1;55,961666;12,533888
1843;"Humlebæk";"no";0;4;4;55,961666;12,533888
1844;"Humlebæk";"no";0;0;0;55,961666;12,533888
1845;"Humlebæk";"no";0;6;6;55,961666;12,533888
1846;"Humlebæk";"no";0;3;3;55,961666;12,533888
1847;"Humlebæk";"no";0;0;0;55,961666;12,533888
1848;"Humlebæk";"no";0;2;2;55,961666;12,533888
1849;"Humlebæk";"no";0;0;0;55,961666;12,533888
1850;"Humlebæk";"no";0;1;1;55,961666;12,533888
1851;"Humlebæk";"no";0;0;0;55,961666;12,533888
1852;"Humlebæk";"no";0;1;1;55,961666;12,533888
1853;"Humlebæk";"no";0;1;1;55,961666;12,533888
1854;"Humlebæk";"no";1;2;3;55,961666;12,533888
1855;"Humlebæk";"no";0;0;0;55,961666;12,533888
1856;"Humlebæk";"no";0;3;3;55,961666;12,533888
1857;"Humlebæk";"no";0;0;0;55,961666;12,533888
1634;"Ærtholmene";"no";0;0;0;55,3206;15,189
1635;"Ærtholmene";"no";0;0;0;55,3206;15,189
1636;"Ærtholmene";"no";0;0;0;55,3206;15,189
1637;"Ærtholmene";"no";0;0;0;55,3206;15,189
1638;"Ærtholmene";"no";0;0;0;55,3206;15,189
1639;"Ærtholmene";"no";0;0;0;55,3206;15,189
1640;"Ærtholmene";"no";0;0;0;55,3206;15,189
1641;"Ærtholmene";"no";0;0;0;55,3206;15,189
1642;"Ærtholmene";"no";0;0;0;55,3206;15,189
1643;"Ærtholmene";"no";0;0;0;55,3206;15,189
1644;"Ærtholmene";"no";0;0;0;55,3206;15,189
1645;"Ærtholmene";"no";0;0;0;55,3206;15,189
1646;"Ærtholmene";"no";0;0;0;55,3206;15,189
1647;"Ærtholmene";"no";0;0;0;55,3206;15,189
1648;"Ærtholmene";"no";0;0;0;55,3206;15,189
1649;"Ærtholmene";"no";0;0;0;55,3206;15,189
1650;"Ærtholmene";"no";0;0;0;55,3206;15,189
1651;"Ærtholmene";"no";0;0;0;55,3206;15,189
1652;"Ærtholmene";"no";0;0;0;55,3206;15,189
1653;"Ærtholmene";"no";0;0;0;55,3206;15,189
1654;"Ærtholmene";"no";0;0;0;55,3206;15,189
1655;"Ærtholmene";"no";0;0;0;55,3206;15,189
1656;"Ærtholmene";"no";0;0;0;55,3206;15,189
1657;"Ærtholmene";"no";0;0;0;55,3206;15,189
1658;"Ærtholmene";"no";0;0;0;55,3206;15,189
1659;"Ærtholmene";"no";0;0;0;55,3206;15,189
1660;"Ærtholmene";"no";0;0;0;55,3206;15,189
1661;"Ærtholmene";"no";0;0;0;55,3206;15,189
1662;"Ærtholmene";"no";0;0;0;55,3206;15,189
1663;"Ærtholmene";"no";0;0;0;55,3206;15,189
1664;"Ærtholmene";"no";0;0;0;55,3206;15,189
1665;"Ærtholmene";"no";0;0;0;55,3206;15,189
1666;"Ærtholmene";"no";0;0;0;55,3206;15,189
1667;"Ærtholmene";"no";0;0;0;55,3206;15,189
1668;"Ærtholmene";"no";0;0;0;55,3206;15,189
1669;"Ærtholmene";"no";0;0;0;55,3206;15,189
1670;"Ærtholmene";"no";0;0;0;55,3206;15,189
1671;"Ærtholmene";"no";0;0;0;55,3206;15,189
1672;"Ærtholmene";"no";0;0;0;55,3206;15,189
1673;"Ærtholmene";"no";0;0;0;55,3206;15,189
1674;"Ærtholmene";"no";0;0;0;55,3206;15,189
1675;"Ærtholmene";"no";0;0;0;55,3206;15,189
1676;"Ærtholmene";"no";0;0;0;55,3206;15,189
1677;"Ærtholmene";"no";0;0;0;55,3206;15,189
1678;"Ærtholmene";"no";0;0;0;55,3206;15,189
1679;"Ærtholmene";"no";0;0;0;55,3206;15,189
1680;"Ærtholmene";"no";0;0;0;55,3206;15,189
1681;"Ærtholmene";"no";0;0;0;55,3206;15,189
1682;"Ærtholmene";"no";0;0;0;55,3206;15,189
1683;"Ærtholmene";"no";0;0;0;55,3206;15,189
1684;"Ærtholmene";"no";4;1;5;55,3206;15,189
1685;"Ærtholmene";"no";0;1;1;55,3206;15,189
1686;"Ærtholmene";"no";1;2;3;55,3206;15,189
1687;"Ærtholmene";"no";0;0;0;55,3206;15,189
1688;"Ærtholmene";"no";0;0;0;55,3206;15,189
1689;"Ærtholmene";"no";0;0;0;55,3206;15,189
1690;"Ærtholmene";"no";0;0;0;55,3206;15,189
1691;"Ærtholmene";"no";0;0;0;55,3206;15,189
1692;"Ærtholmene";"no";0;0;0;55,3206;15,189
1693;"Ærtholmene";"no";0;0;0;55,3206;15,189
1694;"Ærtholmene";"no";0;0;0;55,3206;15,189
1695;"Ærtholmene";"no";0;0;0;55,3206;15,189
1696;"Ærtholmene";"no";0;0;0;55,3206;15,189
1697;"Ærtholmene";"no";0;0;0;55,3206;15,189
1698;"Ærtholmene";"no";0;0;0;55,3206;15,189
1699;"Ærtholmene";"no";0;0;0;55,3206;15,189
1700;"Ærtholmene";"no";0;0;0;55,3206;15,189
1701;"Ærtholmene";"no";0;0;0;55,3206;15,189
1702;"Ærtholmene";"no";0;0;0;55,3206;15,189
1703;"Ærtholmene";"no";0;0;0;55,3206;15,189
1704;"Ærtholmene";"no";0;0;0;55,3206;15,189
1705;"Ærtholmene";"no";0;0;0;55,3206;15,189
1706;"Ærtholmene";"no";0;0;0;55,3206;15,189
1707;"Ærtholmene";"no";0;0;0;55,3206;15,189
1708;"Ærtholmene";"no";0;0;0;55,3206;15,189
1709;"Ærtholmene";"no";0;0;0;55,3206;15,189
1710;"Ærtholmene";"no";0;0;0;55,3206;15,189
1711;"Ærtholmene";"no";0;0;0;55,3206;15,189
1712;"Ærtholmene";"no";0;0;0;55,3206;15,189
1713;"Ærtholmene";"no";0;0;0;55,3206;15,189
1714;"Ærtholmene";"no";0;0;0;55,3206;15,189
1715;"Ærtholmene";"no";0;0;0;55,3206;15,189
1716;"Ærtholmene";"no";0;0;0;55,3206;15,189
1717;"Ærtholmene";"no";0;0;0;55,3206;15,189
1718;"Ærtholmene";"no";0;0;0;55,3206;15,189
1719;"Ærtholmene";"no";0;0;0;55,3206;15,189
1720;"Ærtholmene";"no";0;0;0;55,3206;15,189
1721;"Ærtholmene";"no";0;0;0;55,3206;15,189
1722;"Ærtholmene";"no";0;0;0;55,3206;15,189
1723;"Ærtholmene";"no";0;0;0;55,3206;15,189
1724;"Ærtholmene";"no";0;0;0;55,3206;15,189
1725;"Ærtholmene";"no";0;0;0;55,3206;15,189
1726;"Ærtholmene";"no";0;0;0;55,3206;15,189
1727;"Ærtholmene";"no";0;0;0;55,3206;15,189
1728;"Ærtholmene";"no";0;0;0;55,3206;15,189
1729;"Ærtholmene";"no";0;0;0;55,3206;15,189
1730;"Ærtholmene";"no";0;0;0;55,3206;15,189
1731;"Ærtholmene";"no";0;0;0;55,3206;15,189
1732;"Ærtholmene";"no";0;0;0;55,3206;15,189
1733;"Ærtholmene";"no";0;0;0;55,3206;15,189
1734;"Ærtholmene";"no";0;0;0;55,3206;15,189
1735;"Ærtholmene";"no";0;0;0;55,3206;15,189
1736;"Ærtholmene";"no";0;0;0;55,3206;15,189
1737;"Ærtholmene";"no";0;0;0;55,3206;15,189
1738;"Ærtholmene";"no";0;0;0;55,3206;15,189
1739;"Ærtholmene";"no";0;0;0;55,3206;15,189
1740;"Ærtholmene";"no";0;0;0;55,3206;15,189
1741;"Ærtholmene";"no";0;0;0;55,3206;15,189
1742;"Ærtholmene";"no";0;0;0;55,3206;15,189
1743;"Ærtholmene";"no";0;0;0;55,3206;15,189
1744;"Ærtholmene";"no";0;0;0;55,3206;15,189
1745;"Ærtholmene";"no";0;0;0;55,3206;15,189
1746;"Ærtholmene";"no";0;0;0;55,3206;15,189
1747;"Ærtholmene";"no";0;0;0;55,3206;15,189
1748;"Ærtholmene";"no";0;0;0;55,3206;15,189
1749;"Ærtholmene";"no";0;0;0;55,3206;15,189
1750;"Ærtholmene";"no";0;0;0;55,3206;15,189
1751;"Ærtholmene";"no";0;0;0;55,3206;15,189
1752;"Ærtholmene";"no";0;0;0;55,3206;15,189
1753;"Ærtholmene";"no";0;0;0;55,3206;15,189
1754;"Ærtholmene";"no";0;0;0;55,3206;15,189
1755;"Ærtholmene";"no";0;0;0;55,3206;15,189
1756;"Ærtholmene";"no";0;0;0;55,3206;15,189
1757;"Ærtholmene";"no";0;0;0;55,3206;15,189
1758;"Ærtholmene";"no";0;0;0;55,3206;15,189
1759;"Ærtholmene";"no";0;0;0;55,3206;15,189
1760;"Ærtholmene";"no";0;0;0;55,3206;15,189
1761;"Ærtholmene";"no";0;0;0;55,3206;15,189
1762;"Ærtholmene";"no";0;0;0;55,3206;15,189
1763;"Ærtholmene";"no";0;0;0;55,3206;15,189
1764;"Ærtholmene";"no";0;0;0;55,3206;15,189
1765;"Ærtholmene";"no";0;0;0;55,3206;15,189
1766;"Ærtholmene";"no";0;0;0;55,3206;15,189
1767;"Ærtholmene";"no";0;0;0;55,3206;15,189
1768;"Ærtholmene";"no";0;0;0;55,3206;15,189
1769;"Ærtholmene";"no";0;0;0;55,3206;15,189
1770;"Ærtholmene";"no";0;0;0;55,3206;15,189
1771;"Ærtholmene";"no";0;0;0;55,3206;15,189
1772;"Ærtholmene";"no";0;0;0;55,3206;15,189
1773;"Ærtholmene";"no";0;0;0;55,3206;15,189
1774;"Ærtholmene";"no";0;0;0;55,3206;15,189
1775;"Ærtholmene";"no";0;0;0;55,3206;15,189
1776;"Ærtholmene";"no";0;0;0;55,3206;15,189
1777;"Ærtholmene";"no";0;0;0;55,3206;15,189
1778;"Ærtholmene";"no";0;0;0;55,3206;15,189
1779;"Ærtholmene";"no";0;0;0;55,3206;15,189
1780;"Ærtholmene";"no";0;0;0;55,3206;15,189
1781;"Ærtholmene";"no";0;0;0;55,3206;15,189
1782;"Ærtholmene";"no";0;0;0;55,3206;15,189
1783;"Ærtholmene";"no";0;0;0;55,3206;15,189
1784;"Ærtholmene";"no";0;0;0;55,3206;15,189
1785;"Ærtholmene";"no";0;0;0;55,3206;15,189
1786;"Ærtholmene";"no";0;0;0;55,3206;15,189
1787;"Ærtholmene";"no";0;0;0;55,3206;15,189
1788;"Ærtholmene";"no";0;0;0;55,3206;15,189
1789;"Ærtholmene";"no";0;0;0;55,3206;15,189
1790;"Ærtholmene";"no";0;0;0;55,3206;15,189
1791;"Ærtholmene";"no";0;0;0;55,3206;15,189
1792;"Ærtholmene";"no";0;0;0;55,3206;15,189
1793;"Ærtholmene";"no";0;0;0;55,3206;15,189
1794;"Ærtholmene";"no";0;0;0;55,3206;15,189
1795;"Ærtholmene";"no";0;0;0;55,3206;15,189
1796;"Ærtholmene";"no";0;0;0;55,3206;15,189
1797;"Ærtholmene";"no";0;0;0;55,3206;15,189
1798;"Ærtholmene";"no";0;0;0;55,3206;15,189
1799;"Ærtholmene";"no";0;0;0;55,3206;15,189
1800;"Ærtholmene";"no";0;0;0;55,3206;15,189
1801;"Ærtholmene";"no";0;0;0;55,3206;15,189
1802;"Ærtholmene";"no";0;0;0;55,3206;15,189
1803;"Ærtholmene";"no";0;0;0;55,3206;15,189
1804;"Ærtholmene";"no";0;0;0;55,3206;15,189
1805;"Ærtholmene";"no";0;0;0;55,3206;15,189
1806;"Ærtholmene";"no";0;0;0;55,3206;15,189
1807;"Ærtholmene";"no";0;0;0;55,3206;15,189
1808;"Ærtholmene";"no";0;0;0;55,3206;15,189
1809;"Ærtholmene";"no";0;0;0;55,3206;15,189
1810;"Ærtholmene";"no";0;0;0;55,3206;15,189
1811;"Ærtholmene";"no";0;0;0;55,3206;15,189
1812;"Ærtholmene";"no";0;0;0;55,3206;15,189
1813;"Ærtholmene";"no";0;0;0;55,3206;15,189
1814;"Ærtholmene";"no";0;0;0;55,3206;15,189
1815;"Ærtholmene";"no";0;0;0;55,3206;15,189
1816;"Ærtholmene";"no";0;0;0;55,3206;15,189
1817;"Ærtholmene";"no";0;0;0;55,3206;15,189
1818;"Ærtholmene";"no";0;0;0;55,3206;15,189
1819;"Ærtholmene";"no";0;0;0;55,3206;15,189
1820;"Ærtholmene";"no";0;0;0;55,3206;15,189
1821;"Ærtholmene";"no";0;0;0;55,3206;15,189
1822;"Ærtholmene";"no";0;0;0;55,3206;15,189
1823;"Ærtholmene";"no";0;0;0;55,3206;15,189
1824;"Ærtholmene";"no";0;0;0;55,3206;15,189
1825;"Ærtholmene";"no";0;0;0;55,3206;15,189
1826;"Ærtholmene";"no";0;0;0;55,3206;15,189
1827;"Ærtholmene";"no";0;0;0;55,3206;15,189
1828;"Ærtholmene";"no";0;0;0;55,3206;15,189
1829;"Ærtholmene";"no";0;0;0;55,3206;15,189
1830;"Ærtholmene";"no";0;0;0;55,3206;15,189
1831;"Ærtholmene";"no";0;0;0;55,3206;15,189
1832;"Ærtholmene";"no";0;0;0;55,3206;15,189
1833;"Ærtholmene";"no";0;0;0;55,3206;15,189
1834;"Ærtholmene";"no";0;0;0;55,3206;15,189
1835;"Ærtholmene";"no";0;0;0;55,3206;15,189
1836;"Ærtholmene";"no";0;0;0;55,3206;15,189
1837;"Ærtholmene";"no";0;0;0;55,3206;15,189
1838;"Ærtholmene";"no";0;0;0;55,3206;15,189
1839;"Ærtholmene";"no";0;0;0;55,3206;15,189
1840;"Ærtholmene";"no";0;0;0;55,3206;15,189
1841;"Ærtholmene";"no";0;0;0;55,3206;15,189
1842;"Ærtholmene";"no";0;0;0;55,3206;15,189
1843;"Ærtholmene";"no";0;0;0;55,3206;15,189
1844;"Ærtholmene";"no";0;0;0;55,3206;15,189
1845;"Ærtholmene";"no";0;0;0;55,3206;15,189
1846;"Ærtholmene";"no";0;0;0;55,3206;15,189
1847;"Ærtholmene";"no";0;0;0;55,3206;15,189
1848;"Ærtholmene";"no";0;0;0;55,3206;15,189
1849;"Ærtholmene";"no";0;0;0;55,3206;15,189
1850;"Ærtholmene";"no";0;0;0;55,3206;15,189
1851;"Ærtholmene";"no";0;0;0;55,3206;15,189
1852;"Ærtholmene";"no";0;0;0;55,3206;15,189
1853;"Ærtholmene";"no";0;0;0;55,3206;15,189
1854;"Ærtholmene";"no";0;0;0;55,3206;15,189
1855;"Ærtholmene";"no";0;0;0;55,3206;15,189
1856;"Ærtholmene";"no";0;0;0;55,3206;15,189
1857;"Ærtholmene";"no";0;0;0;55,3206;15,189
1634;"Aabenraa";"no";0;0;0;55,044166;9,417222
1635;"Aabenraa";"no";0;0;0;55,044166;9,417222
1636;"Aabenraa";"no";0;0;0;55,044166;9,417222
1637;"Aabenraa";"no";0;0;0;55,044166;9,417222
1638;"Aabenraa";"no";0;0;0;55,044166;9,417222
1639;"Aabenraa";"no";0;0;0;55,044166;9,417222
1640;"Aabenraa";"no";0;0;0;55,044166;9,417222
1641;"Aabenraa";"no";0;0;0;55,044166;9,417222
1642;"Aabenraa";"no";0;0;0;55,044166;9,417222
1643;"Aabenraa";"no";0;0;0;55,044166;9,417222
1644;"Aabenraa";"no";0;0;0;55,044166;9,417222
1645;"Aabenraa";"no";0;0;0;55,044166;9,417222
1646;"Aabenraa";"no";0;0;0;55,044166;9,417222
1647;"Aabenraa";"no";0;0;0;55,044166;9,417222
1648;"Aabenraa";"no";0;0;0;55,044166;9,417222
1649;"Aabenraa";"no";0;0;0;55,044166;9,417222
1650;"Aabenraa";"no";0;0;0;55,044166;9,417222
1651;"Aabenraa";"no";0;0;0;55,044166;9,417222
1652;"Aabenraa";"no";0;0;0;55,044166;9,417222
1653;"Aabenraa";"no";0;0;0;55,044166;9,417222
1654;"Aabenraa";"no";0;0;0;55,044166;9,417222
1655;"Aabenraa";"no";0;0;0;55,044166;9,417222
1656;"Aabenraa";"no";0;0;0;55,044166;9,417222
1657;"Aabenraa";"no";0;0;0;55,044166;9,417222
1658;"Aabenraa";"no";0;0;0;55,044166;9,417222
1659;"Aabenraa";"no";0;0;0;55,044166;9,417222
1660;"Aabenraa";"no";0;0;0;55,044166;9,417222
1661;"Aabenraa";"no";0;0;0;55,044166;9,417222
1662;"Aabenraa";"no";0;0;0;55,044166;9,417222
1663;"Aabenraa";"no";0;0;0;55,044166;9,417222
1664;"Aabenraa";"no";0;0;0;55,044166;9,417222
1665;"Aabenraa";"no";0;0;0;55,044166;9,417222
1666;"Aabenraa";"no";0;0;0;55,044166;9,417222
1667;"Aabenraa";"no";0;0;0;55,044166;9,417222
1668;"Aabenraa";"no";0;0;0;55,044166;9,417222
1669;"Aabenraa";"no";0;0;0;55,044166;9,417222
1670;"Aabenraa";"no";0;0;0;55,044166;9,417222
1671;"Aabenraa";"no";0;0;0;55,044166;9,417222
1672;"Aabenraa";"no";0;0;0;55,044166;9,417222
1673;"Aabenraa";"no";0;0;0;55,044166;9,417222
1674;"Aabenraa";"no";0;0;0;55,044166;9,417222
1675;"Aabenraa";"no";0;0;0;55,044166;9,417222
1676;"Aabenraa";"no";0;0;0;55,044166;9,417222
1677;"Aabenraa";"no";0;0;0;55,044166;9,417222
1678;"Aabenraa";"no";0;0;0;55,044166;9,417222
1679;"Aabenraa";"no";0;0;0;55,044166;9,417222
1680;"Aabenraa";"no";0;0;0;55,044166;9,417222
1681;"Aabenraa";"no";0;0;0;55,044166;9,417222
1682;"Aabenraa";"no";0;0;0;55,044166;9,417222
1683;"Aabenraa";"no";0;0;0;55,044166;9,417222
1684;"Aabenraa";"no";0;0;0;55,044166;9,417222
1685;"Aabenraa";"no";1;0;1;55,044166;9,417222
1686;"Aabenraa";"no";0;0;0;55,044166;9,417222
1687;"Aabenraa";"no";0;0;0;55,044166;9,417222
1688;"Aabenraa";"no";0;0;0;55,044166;9,417222
1689;"Aabenraa";"no";0;0;0;55,044166;9,417222
1690;"Aabenraa";"no";0;0;0;55,044166;9,417222
1691;"Aabenraa";"no";0;0;0;55,044166;9,417222
1692;"Aabenraa";"no";0;0;0;55,044166;9,417222
1693;"Aabenraa";"no";0;0;0;55,044166;9,417222
1694;"Aabenraa";"no";0;0;0;55,044166;9,417222
1695;"Aabenraa";"no";0;0;0;55,044166;9,417222
1696;"Aabenraa";"no";0;0;0;55,044166;9,417222
1697;"Aabenraa";"no";0;0;0;55,044166;9,417222
1698;"Aabenraa";"no";0;0;0;55,044166;9,417222
1699;"Aabenraa";"no";0;1;1;55,044166;9,417222
1700;"Aabenraa";"no";0;0;0;55,044166;9,417222
1701;"Aabenraa";"no";0;0;0;55,044166;9,417222
1702;"Aabenraa";"no";0;0;0;55,044166;9,417222
1703;"Aabenraa";"no";0;0;0;55,044166;9,417222
1704;"Aabenraa";"no";0;0;0;55,044166;9,417222
1705;"Aabenraa";"no";1;0;1;55,044166;9,417222
1706;"Aabenraa";"no";0;0;0;55,044166;9,417222
1707;"Aabenraa";"no";0;0;0;55,044166;9,417222
1708;"Aabenraa";"no";0;1;1;55,044166;9,417222
1709;"Aabenraa";"no";0;0;0;55,044166;9,417222
1710;"Aabenraa";"no";1;0;1;55,044166;9,417222
1711;"Aabenraa";"no";1;0;1;55,044166;9,417222
1712;"Aabenraa";"no";0;0;0;55,044166;9,417222
1713;"Aabenraa";"no";1;0;1;55,044166;9,417222
1714;"Aabenraa";"no";0;0;0;55,044166;9,417222
1715;"Aabenraa";"no";0;0;0;55,044166;9,417222
1716;"Aabenraa";"no";0;0;0;55,044166;9,417222
1717;"Aabenraa";"no";0;0;0;55,044166;9,417222
1718;"Aabenraa";"no";0;0;0;55,044166;9,417222
1719;"Aabenraa";"no";0;0;0;55,044166;9,417222
1720;"Aabenraa";"no";0;0;0;55,044166;9,417222
1721;"Aabenraa";"no";0;2;2;55,044166;9,417222
1722;"Aabenraa";"no";0;0;0;55,044166;9,417222
1723;"Aabenraa";"no";0;0;0;55,044166;9,417222
1724;"Aabenraa";"no";0;0;0;55,044166;9,417222
1725;"Aabenraa";"no";0;1;1;55,044166;9,417222
1726;"Aabenraa";"no";0;0;0;55,044166;9,417222
1727;"Aabenraa";"no";0;0;0;55,044166;9,417222
1728;"Aabenraa";"no";0;1;1;55,044166;9,417222
1729;"Aabenraa";"no";0;0;0;55,044166;9,417222
1730;"Aabenraa";"no";0;1;1;55,044166;9,417222
1731;"Aabenraa";"no";0;0;0;55,044166;9,417222
1732;"Aabenraa";"no";0;0;0;55,044166;9,417222
1733;"Aabenraa";"no";2;0;2;55,044166;9,417222
1734;"Aabenraa";"no";2;0;2;55,044166;9,417222
1735;"Aabenraa";"no";0;0;0;55,044166;9,417222
1736;"Aabenraa";"no";0;1;1;55,044166;9,417222
1737;"Aabenraa";"no";0;0;0;55,044166;9,417222
1738;"Aabenraa";"no";1;0;1;55,044166;9,417222
1739;"Aabenraa";"no";1;0;1;55,044166;9,417222
1740;"Aabenraa";"no";2;1;3;55,044166;9,417222
1741;"Aabenraa";"no";1;3;4;55,044166;9,417222
1742;"Aabenraa";"no";0;0;0;55,044166;9,417222
1743;"Aabenraa";"no";0;1;1;55,044166;9,417222
1744;"Aabenraa";"no";0;0;0;55,044166;9,417222
1745;"Aabenraa";"no";2;1;3;55,044166;9,417222
1746;"Aabenraa";"no";1;3;4;55,044166;9,417222
1747;"Aabenraa";"no";1;4;5;55,044166;9,417222
1748;"Aabenraa";"no";0;7;7;55,044166;9,417222
1749;"Aabenraa";"no";1;4;5;55,044166;9,417222
1750;"Aabenraa";"no";0;15;15;55,044166;9,417222
1751;"Aabenraa";"no";0;6;6;55,044166;9,417222
1752;"Aabenraa";"no";1;10;11;55,044166;9,417222
1753;"Aabenraa";"no";2;3;5;55,044166;9,417222
1754;"Aabenraa";"no";0;3;3;55,044166;9,417222
1755;"Aabenraa";"no";1;3;4;55,044166;9,417222
1756;"Aabenraa";"no";0;2;2;55,044166;9,417222
1757;"Aabenraa";"no";0;1;1;55,044166;9,417222
1758;"Aabenraa";"no";0;2;2;55,044166;9,417222
1759;"Aabenraa";"no";3;4;7;55,044166;9,417222
1760;"Aabenraa";"no";0;6;6;55,044166;9,417222
1761;"Aabenraa";"no";1;1;2;55,044166;9,417222
1762;"Aabenraa";"no";1;1;2;55,044166;9,417222
1763;"Aabenraa";"no";4;2;6;55,044166;9,417222
1764;"Aabenraa";"no";1;0;1;55,044166;9,417222
1765;"Aabenraa";"no";1;2;3;55,044166;9,417222
1766;"Aabenraa";"no";0;0;0;55,044166;9,417222
1767;"Aabenraa";"no";0;3;3;55,044166;9,417222
1768;"Aabenraa";"no";2;0;2;55,044166;9,417222
1769;"Aabenraa";"no";2;2;4;55,044166;9,417222
1770;"Aabenraa";"no";0;0;0;55,044166;9,417222
1771;"Aabenraa";"no";1;1;2;55,044166;9,417222
1772;"Aabenraa";"no";0;1;1;55,044166;9,417222
1773;"Aabenraa";"no";1;1;2;55,044166;9,417222
1774;"Aabenraa";"no";0;1;1;55,044166;9,417222
1775;"Aabenraa";"no";0;2;2;55,044166;9,417222
1776;"Aabenraa";"no";0;2;2;55,044166;9,417222
1777;"Aabenraa";"no";0;2;2;55,044166;9,417222
1778;"Aabenraa";"no";0;0;0;55,044166;9,417222
1779;"Aabenraa";"no";0;4;4;55,044166;9,417222
1780;"Aabenraa";"no";0;1;1;55,044166;9,417222
1781;"Aabenraa";"no";0;0;0;55,044166;9,417222
1782;"Aabenraa";"no";0;0;0;55,044166;9,417222
1783;"Aabenraa";"no";0;2;2;55,044166;9,417222
1784;"Aabenraa";"no";0;2;2;55,044166;9,417222
1785;"Aabenraa";"no";1;3;4;55,044166;9,417222
1786;"Aabenraa";"no";0;2;2;55,044166;9,417222
1787;"Aabenraa";"no";2;1;3;55,044166;9,417222
1788;"Aabenraa";"no";0;0;0;55,044166;9,417222
1789;"Aabenraa";"no";0;0;0;55,044166;9,417222
1790;"Aabenraa";"no";0;0;0;55,044166;9,417222
1791;"Aabenraa";"no";1;2;3;55,044166;9,417222
1792;"Aabenraa";"no";0;0;0;55,044166;9,417222
1793;"Aabenraa";"no";0;0;0;55,044166;9,417222
1794;"Aabenraa";"no";0;0;0;55,044166;9,417222
1795;"Aabenraa";"no";1;4;5;55,044166;9,417222
1796;"Aabenraa";"no";3;0;3;55,044166;9,417222
1797;"Aabenraa";"no";2;0;2;55,044166;9,417222
1798;"Aabenraa";"no";0;0;0;55,044166;9,417222
1799;"Aabenraa";"no";0;0;0;55,044166;9,417222
1800;"Aabenraa";"no";0;2;2;55,044166;9,417222
1801;"Aabenraa";"no";1;0;1;55,044166;9,417222
1802;"Aabenraa";"no";0;3;3;55,044166;9,417222
1803;"Aabenraa";"no";2;3;5;55,044166;9,417222
1804;"Aabenraa";"no";0;1;1;55,044166;9,417222
1805;"Aabenraa";"no";0;1;1;55,044166;9,417222
1806;"Aabenraa";"no";1;0;1;55,044166;9,417222
1807;"Aabenraa";"no";1;0;1;55,044166;9,417222
1808;"Aabenraa";"no";0;0;0;55,044166;9,417222
1809;"Aabenraa";"no";0;0;0;55,044166;9,417222
1810;"Aabenraa";"no";0;0;0;55,044166;9,417222
1811;"Aabenraa";"no";0;0;0;55,044166;9,417222
1812;"Aabenraa";"no";0;1;1;55,044166;9,417222
1813;"Aabenraa";"no";0;0;0;55,044166;9,417222
1814;"Aabenraa";"no";0;1;1;55,044166;9,417222
1815;"Aabenraa";"no";0;1;1;55,044166;9,417222
1816;"Aabenraa";"no";0;0;0;55,044166;9,417222
1817;"Aabenraa";"no";0;1;1;55,044166;9,417222
1818;"Aabenraa";"no";0;0;0;55,044166;9,417222
1819;"Aabenraa";"no";0;0;0;55,044166;9,417222
1820;"Aabenraa";"no";0;2;2;55,044166;9,417222
1821;"Aabenraa";"no";0;1;1;55,044166;9,417222
1822;"Aabenraa";"no";0;1;1;55,044166;9,417222
1823;"Aabenraa";"no";0;1;1;55,044166;9,417222
1824;"Aabenraa";"no";1;2;3;55,044166;9,417222
1825;"Aabenraa";"no";0;1;1;55,044166;9,417222
1826;"Aabenraa";"no";0;3;3;55,044166;9,417222
1827;"Aabenraa";"no";0;0;0;55,044166;9,417222
1828;"Aabenraa";"no";0;3;3;55,044166;9,417222
1829;"Aabenraa";"no";0;1;1;55,044166;9,417222
1830;"Aabenraa";"no";0;1;1;55,044166;9,417222
1831;"Aabenraa";"no";1;0;1;55,044166;9,417222
1832;"Aabenraa";"no";0;0;0;55,044166;9,417222
1833;"Aabenraa";"no";2;1;3;55,044166;9,417222
1834;"Aabenraa";"no";1;0;1;55,044166;9,417222
1835;"Aabenraa";"no";3;4;7;55,044166;9,417222
1836;"Aabenraa";"no";0;2;2;55,044166;9,417222
1837;"Aabenraa";"no";1;0;1;55,044166;9,417222
1838;"Aabenraa";"no";3;2;5;55,044166;9,417222
1839;"Aabenraa";"no";4;2;6;55,044166;9,417222
1840;"Aabenraa";"no";1;0;1;55,044166;9,417222
1841;"Aabenraa";"no";5;1;6;55,044166;9,417222
1842;"Aabenraa";"no";2;2;4;55,044166;9,417222
1843;"Aabenraa";"no";5;4;9;55,044166;9,417222
1844;"Aabenraa";"no";1;1;2;55,044166;9,417222
1845;"Aabenraa";"no";2;1;3;55,044166;9,417222
1846;"Aabenraa";"no";1;1;2;55,044166;9,417222
1847;"Aabenraa";"no";0;1;1;55,044166;9,417222
1848;"Aabenraa";"no";3;1;4;55,044166;9,417222
1849;"Aabenraa";"no";3;1;4;55,044166;9,417222
1850;"Aabenraa";"no";3;1;4;55,044166;9,417222
1851;"Aabenraa";"no";3;2;5;55,044166;9,417222
1852;"Aabenraa";"no";2;0;2;55,044166;9,417222
1853;"Aabenraa";"no";3;0;3;55,044166;9,417222
1854;"Aabenraa";"no";3;0;3;55,044166;9,417222
1855;"Aabenraa";"no";0;0;0;55,044166;9,417222
1856;"Aabenraa";"no";2;0;2;55,044166;9,417222
1857;"Aabenraa";"no";0;0;0;55,044166;9,417222
1634;"Bandholm";"no";0;0;0;54,833333;11,483333
1635;"Bandholm";"no";0;0;0;54,833333;11,483333
1636;"Bandholm";"no";0;0;0;54,833333;11,483333
1637;"Bandholm";"no";0;0;0;54,833333;11,483333
1638;"Bandholm";"no";0;0;0;54,833333;11,483333
1639;"Bandholm";"no";0;0;0;54,833333;11,483333
1640;"Bandholm";"no";0;0;0;54,833333;11,483333
1641;"Bandholm";"no";0;0;0;54,833333;11,483333
1642;"Bandholm";"no";0;0;0;54,833333;11,483333
1643;"Bandholm";"no";0;0;0;54,833333;11,483333
1644;"Bandholm";"no";0;0;0;54,833333;11,483333
1645;"Bandholm";"no";0;0;0;54,833333;11,483333
1646;"Bandholm";"no";0;0;0;54,833333;11,483333
1647;"Bandholm";"no";0;0;0;54,833333;11,483333
1648;"Bandholm";"no";0;0;0;54,833333;11,483333
1649;"Bandholm";"no";0;0;0;54,833333;11,483333
1650;"Bandholm";"no";0;0;0;54,833333;11,483333
1651;"Bandholm";"no";0;0;0;54,833333;11,483333
1652;"Bandholm";"no";0;0;0;54,833333;11,483333
1653;"Bandholm";"no";0;0;0;54,833333;11,483333
1654;"Bandholm";"no";0;0;0;54,833333;11,483333
1655;"Bandholm";"no";0;0;0;54,833333;11,483333
1656;"Bandholm";"no";0;0;0;54,833333;11,483333
1657;"Bandholm";"no";0;0;0;54,833333;11,483333
1658;"Bandholm";"no";0;0;0;54,833333;11,483333
1659;"Bandholm";"no";0;0;0;54,833333;11,483333
1660;"Bandholm";"no";0;0;0;54,833333;11,483333
1661;"Bandholm";"no";0;0;0;54,833333;11,483333
1662;"Bandholm";"no";0;0;0;54,833333;11,483333
1663;"Bandholm";"no";0;0;0;54,833333;11,483333
1664;"Bandholm";"no";0;0;0;54,833333;11,483333
1665;"Bandholm";"no";0;0;0;54,833333;11,483333
1666;"Bandholm";"no";0;0;0;54,833333;11,483333
1667;"Bandholm";"no";0;0;0;54,833333;11,483333
1668;"Bandholm";"no";0;0;0;54,833333;11,483333
1669;"Bandholm";"no";0;0;0;54,833333;11,483333
1670;"Bandholm";"no";0;0;0;54,833333;11,483333
1671;"Bandholm";"no";0;0;0;54,833333;11,483333
1672;"Bandholm";"no";0;0;0;54,833333;11,483333
1673;"Bandholm";"no";0;0;0;54,833333;11,483333
1674;"Bandholm";"no";0;0;0;54,833333;11,483333
1675;"Bandholm";"no";0;0;0;54,833333;11,483333
1676;"Bandholm";"no";0;0;0;54,833333;11,483333
1677;"Bandholm";"no";0;0;0;54,833333;11,483333
1678;"Bandholm";"no";0;0;0;54,833333;11,483333
1679;"Bandholm";"no";0;0;0;54,833333;11,483333
1680;"Bandholm";"no";0;0;0;54,833333;11,483333
1681;"Bandholm";"no";0;0;0;54,833333;11,483333
1682;"Bandholm";"no";0;0;0;54,833333;11,483333
1683;"Bandholm";"no";0;0;0;54,833333;11,483333
1684;"Bandholm";"no";0;0;0;54,833333;11,483333
1685;"Bandholm";"no";1;0;1;54,833333;11,483333
1686;"Bandholm";"no";0;0;0;54,833333;11,483333
1687;"Bandholm";"no";0;0;0;54,833333;11,483333
1688;"Bandholm";"no";0;0;0;54,833333;11,483333
1689;"Bandholm";"no";0;0;0;54,833333;11,483333
1690;"Bandholm";"no";0;0;0;54,833333;11,483333
1691;"Bandholm";"no";0;0;0;54,833333;11,483333
1692;"Bandholm";"no";0;0;0;54,833333;11,483333
1693;"Bandholm";"no";0;0;0;54,833333;11,483333
1694;"Bandholm";"no";0;0;0;54,833333;11,483333
1695;"Bandholm";"no";0;0;0;54,833333;11,483333
1696;"Bandholm";"no";1;1;2;54,833333;11,483333
1697;"Bandholm";"no";0;0;0;54,833333;11,483333
1698;"Bandholm";"no";0;0;0;54,833333;11,483333
1699;"Bandholm";"no";0;0;0;54,833333;11,483333
1700;"Bandholm";"no";0;0;0;54,833333;11,483333
1701;"Bandholm";"no";0;0;0;54,833333;11,483333
1702;"Bandholm";"no";0;0;0;54,833333;11,483333
1703;"Bandholm";"no";1;0;1;54,833333;11,483333
1704;"Bandholm";"no";0;0;0;54,833333;11,483333
1705;"Bandholm";"no";0;0;0;54,833333;11,483333
1706;"Bandholm";"no";0;0;0;54,833333;11,483333
1707;"Bandholm";"no";0;0;0;54,833333;11,483333
1708;"Bandholm";"no";0;0;0;54,833333;11,483333
1709;"Bandholm";"no";0;0;0;54,833333;11,483333
1710;"Bandholm";"no";0;0;0;54,833333;11,483333
1711;"Bandholm";"no";0;0;0;54,833333;11,483333
1712;"Bandholm";"no";0;0;0;54,833333;11,483333
1713;"Bandholm";"no";0;0;0;54,833333;11,483333
1714;"Bandholm";"no";0;0;0;54,833333;11,483333
1715;"Bandholm";"no";0;0;0;54,833333;11,483333
1716;"Bandholm";"no";0;0;0;54,833333;11,483333
1717;"Bandholm";"no";0;0;0;54,833333;11,483333
1718;"Bandholm";"no";0;0;0;54,833333;11,483333
1719;"Bandholm";"no";0;0;0;54,833333;11,483333
1720;"Bandholm";"no";0;0;0;54,833333;11,483333
1721;"Bandholm";"no";0;0;0;54,833333;11,483333
1722;"Bandholm";"no";1;0;1;54,833333;11,483333
1723;"Bandholm";"no";0;0;0;54,833333;11,483333
1724;"Bandholm";"no";0;0;0;54,833333;11,483333
1725;"Bandholm";"no";0;0;0;54,833333;11,483333
1726;"Bandholm";"no";0;0;0;54,833333;11,483333
1727;"Bandholm";"no";0;0;0;54,833333;11,483333
1728;"Bandholm";"no";0;0;0;54,833333;11,483333
1729;"Bandholm";"no";0;0;0;54,833333;11,483333
1730;"Bandholm";"no";0;0;0;54,833333;11,483333
1731;"Bandholm";"no";1;0;1;54,833333;11,483333
1732;"Bandholm";"no";0;0;0;54,833333;11,483333
1733;"Bandholm";"no";0;0;0;54,833333;11,483333
1734;"Bandholm";"no";0;0;0;54,833333;11,483333
1735;"Bandholm";"no";0;1;1;54,833333;11,483333
1736;"Bandholm";"no";0;0;0;54,833333;11,483333
1737;"Bandholm";"no";0;1;1;54,833333;11,483333
1738;"Bandholm";"no";0;0;0;54,833333;11,483333
1739;"Bandholm";"no";0;0;0;54,833333;11,483333
1740;"Bandholm";"no";0;0;0;54,833333;11,483333
1741;"Bandholm";"no";0;0;0;54,833333;11,483333
1742;"Bandholm";"no";0;0;0;54,833333;11,483333
1743;"Bandholm";"no";0;0;0;54,833333;11,483333
1744;"Bandholm";"no";0;0;0;54,833333;11,483333
1745;"Bandholm";"no";0;0;0;54,833333;11,483333
1746;"Bandholm";"no";0;0;0;54,833333;11,483333
1747;"Bandholm";"no";0;0;0;54,833333;11,483333
1748;"Bandholm";"no";0;0;0;54,833333;11,483333
1749;"Bandholm";"no";0;0;0;54,833333;11,483333
1750;"Bandholm";"no";0;0;0;54,833333;11,483333
1751;"Bandholm";"no";0;0;0;54,833333;11,483333
1752;"Bandholm";"no";0;0;0;54,833333;11,483333
1753;"Bandholm";"no";0;0;0;54,833333;11,483333
1754;"Bandholm";"no";0;0;0;54,833333;11,483333
1755;"Bandholm";"no";1;0;1;54,833333;11,483333
1756;"Bandholm";"no";0;0;0;54,833333;11,483333
1757;"Bandholm";"no";1;0;1;54,833333;11,483333
1758;"Bandholm";"no";0;0;0;54,833333;11,483333
1759;"Bandholm";"no";0;0;0;54,833333;11,483333
1760;"Bandholm";"no";0;0;0;54,833333;11,483333
1761;"Bandholm";"no";0;0;0;54,833333;11,483333
1762;"Bandholm";"no";0;0;0;54,833333;11,483333
1763;"Bandholm";"no";0;0;0;54,833333;11,483333
1764;"Bandholm";"no";0;0;0;54,833333;11,483333
1765;"Bandholm";"no";1;0;1;54,833333;11,483333
1766;"Bandholm";"no";0;0;0;54,833333;11,483333
1767;"Bandholm";"no";1;0;1;54,833333;11,483333
1768;"Bandholm";"no";0;0;0;54,833333;11,483333
1769;"Bandholm";"no";0;0;0;54,833333;11,483333
1770;"Bandholm";"no";0;0;0;54,833333;11,483333
1771;"Bandholm";"no";0;0;0;54,833333;11,483333
1772;"Bandholm";"no";0;0;0;54,833333;11,483333
1773;"Bandholm";"no";0;0;0;54,833333;11,483333
1774;"Bandholm";"no";0;0;0;54,833333;11,483333
1775;"Bandholm";"no";0;0;0;54,833333;11,483333
1776;"Bandholm";"no";0;0;0;54,833333;11,483333
1777;"Bandholm";"no";2;0;2;54,833333;11,483333
1778;"Bandholm";"no";1;0;1;54,833333;11,483333
1779;"Bandholm";"no";0;0;0;54,833333;11,483333
1780;"Bandholm";"no";0;1;1;54,833333;11,483333
1781;"Bandholm";"no";0;0;0;54,833333;11,483333
1782;"Bandholm";"no";0;0;0;54,833333;11,483333
1783;"Bandholm";"no";0;0;0;54,833333;11,483333
1784;"Bandholm";"no";0;0;0;54,833333;11,483333
1785;"Bandholm";"no";0;0;0;54,833333;11,483333
1786;"Bandholm";"no";0;0;0;54,833333;11,483333
1787;"Bandholm";"no";1;0;1;54,833333;11,483333
1788;"Bandholm";"no";2;0;2;54,833333;11,483333
1789;"Bandholm";"no";1;0;1;54,833333;11,483333
1790;"Bandholm";"no";0;0;0;54,833333;11,483333
1791;"Bandholm";"no";0;1;1;54,833333;11,483333
1792;"Bandholm";"no";0;0;0;54,833333;11,483333
1793;"Bandholm";"no";1;0;1;54,833333;11,483333
1794;"Bandholm";"no";1;0;1;54,833333;11,483333
1795;"Bandholm";"no";0;1;1;54,833333;11,483333
1796;"Bandholm";"no";0;1;1;54,833333;11,483333
1797;"Bandholm";"no";0;0;0;54,833333;11,483333
1798;"Bandholm";"no";0;0;0;54,833333;11,483333
1799;"Bandholm";"no";0;0;0;54,833333;11,483333
1800;"Bandholm";"no";0;0;0;54,833333;11,483333
1801;"Bandholm";"no";0;0;0;54,833333;11,483333
1802;"Bandholm";"no";0;0;0;54,833333;11,483333
1803;"Bandholm";"no";0;0;0;54,833333;11,483333
1804;"Bandholm";"no";0;0;0;54,833333;11,483333
1805;"Bandholm";"no";0;0;0;54,833333;11,483333
1806;"Bandholm";"no";0;0;0;54,833333;11,483333
1807;"Bandholm";"no";0;0;0;54,833333;11,483333
1808;"Bandholm";"no";0;0;0;54,833333;11,483333
1809;"Bandholm";"no";0;0;0;54,833333;11,483333
1810;"Bandholm";"no";1;0;1;54,833333;11,483333
1811;"Bandholm";"no";0;0;0;54,833333;11,483333
1812;"Bandholm";"no";0;0;0;54,833333;11,483333
1813;"Bandholm";"no";0;0;0;54,833333;11,483333
1814;"Bandholm";"no";0;0;0;54,833333;11,483333
1815;"Bandholm";"no";0;0;0;54,833333;11,483333
1816;"Bandholm";"no";0;1;1;54,833333;11,483333
1817;"Bandholm";"no";0;0;0;54,833333;11,483333
1818;"Bandholm";"no";0;0;0;54,833333;11,483333
1819;"Bandholm";"no";0;0;0;54,833333;11,483333
1820;"Bandholm";"no";1;0;1;54,833333;11,483333
1821;"Bandholm";"no";0;0;0;54,833333;11,483333
1822;"Bandholm";"no";1;0;1;54,833333;11,483333
1823;"Bandholm";"no";1;1;2;54,833333;11,483333
1824;"Bandholm";"no";5;0;5;54,833333;11,483333
1825;"Bandholm";"no";4;0;4;54,833333;11,483333
1826;"Bandholm";"no";4;1;5;54,833333;11,483333
1827;"Bandholm";"no";1;0;1;54,833333;11,483333
1828;"Bandholm";"no";2;0;2;54,833333;11,483333
1829;"Bandholm";"no";2;2;4;54,833333;11,483333
1830;"Bandholm";"no";1;1;2;54,833333;11,483333
1831;"Bandholm";"no";0;0;0;54,833333;11,483333
1832;"Bandholm";"no";3;0;3;54,833333;11,483333
1833;"Bandholm";"no";4;1;5;54,833333;11,483333
1834;"Bandholm";"no";2;1;3;54,833333;11,483333
1835;"Bandholm";"no";0;0;0;54,833333;11,483333
1836;"Bandholm";"no";1;1;2;54,833333;11,483333
1837;"Bandholm";"no";1;1;2;54,833333;11,483333
1838;"Bandholm";"no";1;1;2;54,833333;11,483333
1839;"Bandholm";"no";1;0;1;54,833333;11,483333
1840;"Bandholm";"no";0;0;0;54,833333;11,483333
1841;"Bandholm";"no";1;1;2;54,833333;11,483333
1842;"Bandholm";"no";0;0;0;54,833333;11,483333
1843;"Bandholm";"no";0;0;0;54,833333;11,483333
1844;"Bandholm";"no";0;1;1;54,833333;11,483333
1845;"Bandholm";"no";0;0;0;54,833333;11,483333
1846;"Bandholm";"no";0;0;0;54,833333;11,483333
1847;"Bandholm";"no";1;0;1;54,833333;11,483333
1848;"Bandholm";"no";1;2;3;54,833333;11,483333
1849;"Bandholm";"no";2;2;4;54,833333;11,483333
1850;"Bandholm";"no";1;2;3;54,833333;11,483333
1851;"Bandholm";"no";2;1;3;54,833333;11,483333
1852;"Bandholm";"no";3;0;3;54,833333;11,483333
1853;"Bandholm";"no";0;0;0;54,833333;11,483333
1854;"Bandholm";"no";1;2;3;54,833333;11,483333
1855;"Bandholm";"no";1;0;1;54,833333;11,483333
1856;"Bandholm";"no";1;0;1;54,833333;11,483333
1857;"Bandholm";"no";0;0;0;54,833333;11,483333
1634;"Kristiansø";"no";0;0;0;55,320555;15,186944
1635;"Kristiansø";"no";0;0;0;55,320555;15,186944
1636;"Kristiansø";"no";0;0;0;55,320555;15,186944
1637;"Kristiansø";"no";0;0;0;55,320555;15,186944
1638;"Kristiansø";"no";0;0;0;55,320555;15,186944
1639;"Kristiansø";"no";0;0;0;55,320555;15,186944
1640;"Kristiansø";"no";0;0;0;55,320555;15,186944
1641;"Kristiansø";"no";0;0;0;55,320555;15,186944
1642;"Kristiansø";"no";0;0;0;55,320555;15,186944
1643;"Kristiansø";"no";0;0;0;55,320555;15,186944
1644;"Kristiansø";"no";0;0;0;55,320555;15,186944
1645;"Kristiansø";"no";0;0;0;55,320555;15,186944
1646;"Kristiansø";"no";0;0;0;55,320555;15,186944
1647;"Kristiansø";"no";0;0;0;55,320555;15,186944
1648;"Kristiansø";"no";0;0;0;55,320555;15,186944
1649;"Kristiansø";"no";0;0;0;55,320555;15,186944
1650;"Kristiansø";"no";0;0;0;55,320555;15,186944
1651;"Kristiansø";"no";0;0;0;55,320555;15,186944
1652;"Kristiansø";"no";0;0;0;55,320555;15,186944
1653;"Kristiansø";"no";0;0;0;55,320555;15,186944
1654;"Kristiansø";"no";0;0;0;55,320555;15,186944
1655;"Kristiansø";"no";0;0;0;55,320555;15,186944
1656;"Kristiansø";"no";0;0;0;55,320555;15,186944
1657;"Kristiansø";"no";0;0;0;55,320555;15,186944
1658;"Kristiansø";"no";0;0;0;55,320555;15,186944
1659;"Kristiansø";"no";0;0;0;55,320555;15,186944
1660;"Kristiansø";"no";0;0;0;55,320555;15,186944
1661;"Kristiansø";"no";0;0;0;55,320555;15,186944
1662;"Kristiansø";"no";0;0;0;55,320555;15,186944
1663;"Kristiansø";"no";0;0;0;55,320555;15,186944
1664;"Kristiansø";"no";0;0;0;55,320555;15,186944
1665;"Kristiansø";"no";0;0;0;55,320555;15,186944
1666;"Kristiansø";"no";0;0;0;55,320555;15,186944
1667;"Kristiansø";"no";0;0;0;55,320555;15,186944
1668;"Kristiansø";"no";0;0;0;55,320555;15,186944
1669;"Kristiansø";"no";0;0;0;55,320555;15,186944
1670;"Kristiansø";"no";0;0;0;55,320555;15,186944
1671;"Kristiansø";"no";0;0;0;55,320555;15,186944
1672;"Kristiansø";"no";0;0;0;55,320555;15,186944
1673;"Kristiansø";"no";0;0;0;55,320555;15,186944
1674;"Kristiansø";"no";0;0;0;55,320555;15,186944
1675;"Kristiansø";"no";0;0;0;55,320555;15,186944
1676;"Kristiansø";"no";0;0;0;55,320555;15,186944
1677;"Kristiansø";"no";0;0;0;55,320555;15,186944
1678;"Kristiansø";"no";0;0;0;55,320555;15,186944
1679;"Kristiansø";"no";0;0;0;55,320555;15,186944
1680;"Kristiansø";"no";0;0;0;55,320555;15,186944
1681;"Kristiansø";"no";0;0;0;55,320555;15,186944
1682;"Kristiansø";"no";0;0;0;55,320555;15,186944
1683;"Kristiansø";"no";0;0;0;55,320555;15,186944
1684;"Kristiansø";"no";0;0;0;55,320555;15,186944
1685;"Kristiansø";"no";6;1;7;55,320555;15,186944
1686;"Kristiansø";"no";0;0;0;55,320555;15,186944
1687;"Kristiansø";"no";0;0;0;55,320555;15,186944
1688;"Kristiansø";"no";0;0;0;55,320555;15,186944
1689;"Kristiansø";"no";0;0;0;55,320555;15,186944
1690;"Kristiansø";"no";0;0;0;55,320555;15,186944
1691;"Kristiansø";"no";0;0;0;55,320555;15,186944
1692;"Kristiansø";"no";0;0;0;55,320555;15,186944
1693;"Kristiansø";"no";0;0;0;55,320555;15,186944
1694;"Kristiansø";"no";0;0;0;55,320555;15,186944
1695;"Kristiansø";"no";0;0;0;55,320555;15,186944
1696;"Kristiansø";"no";0;0;0;55,320555;15,186944
1697;"Kristiansø";"no";0;0;0;55,320555;15,186944
1698;"Kristiansø";"no";0;0;0;55,320555;15,186944
1699;"Kristiansø";"no";0;0;0;55,320555;15,186944
1700;"Kristiansø";"no";0;0;0;55,320555;15,186944
1701;"Kristiansø";"no";0;0;0;55,320555;15,186944
1702;"Kristiansø";"no";0;0;0;55,320555;15,186944
1703;"Kristiansø";"no";0;0;0;55,320555;15,186944
1704;"Kristiansø";"no";0;0;0;55,320555;15,186944
1705;"Kristiansø";"no";0;0;0;55,320555;15,186944
1706;"Kristiansø";"no";0;0;0;55,320555;15,186944
1707;"Kristiansø";"no";0;0;0;55,320555;15,186944
1708;"Kristiansø";"no";0;0;0;55,320555;15,186944
1709;"Kristiansø";"no";0;0;0;55,320555;15,186944
1710;"Kristiansø";"no";0;0;0;55,320555;15,186944
1711;"Kristiansø";"no";0;0;0;55,320555;15,186944
1712;"Kristiansø";"no";0;0;0;55,320555;15,186944
1713;"Kristiansø";"no";0;0;0;55,320555;15,186944
1714;"Kristiansø";"no";0;0;0;55,320555;15,186944
1715;"Kristiansø";"no";0;0;0;55,320555;15,186944
1716;"Kristiansø";"no";0;0;0;55,320555;15,186944
1717;"Kristiansø";"no";0;0;0;55,320555;15,186944
1718;"Kristiansø";"no";0;0;0;55,320555;15,186944
1719;"Kristiansø";"no";0;0;0;55,320555;15,186944
1720;"Kristiansø";"no";0;0;0;55,320555;15,186944
1721;"Kristiansø";"no";0;0;0;55,320555;15,186944
1722;"Kristiansø";"no";0;0;0;55,320555;15,186944
1723;"Kristiansø";"no";0;0;0;55,320555;15,186944
1724;"Kristiansø";"no";0;0;0;55,320555;15,186944
1725;"Kristiansø";"no";0;0;0;55,320555;15,186944
1726;"Kristiansø";"no";0;0;0;55,320555;15,186944
1727;"Kristiansø";"no";0;0;0;55,320555;15,186944
1728;"Kristiansø";"no";0;0;0;55,320555;15,186944
1729;"Kristiansø";"no";0;0;0;55,320555;15,186944
1730;"Kristiansø";"no";0;0;0;55,320555;15,186944
1731;"Kristiansø";"no";0;0;0;55,320555;15,186944
1732;"Kristiansø";"no";0;0;0;55,320555;15,186944
1733;"Kristiansø";"no";0;0;0;55,320555;15,186944
1734;"Kristiansø";"no";0;0;0;55,320555;15,186944
1735;"Kristiansø";"no";0;0;0;55,320555;15,186944
1736;"Kristiansø";"no";0;0;0;55,320555;15,186944
1737;"Kristiansø";"no";0;0;0;55,320555;15,186944
1738;"Kristiansø";"no";0;0;0;55,320555;15,186944
1739;"Kristiansø";"no";0;0;0;55,320555;15,186944
1740;"Kristiansø";"no";0;0;0;55,320555;15,186944
1741;"Kristiansø";"no";0;0;0;55,320555;15,186944
1742;"Kristiansø";"no";0;0;0;55,320555;15,186944
1743;"Kristiansø";"no";0;0;0;55,320555;15,186944
1744;"Kristiansø";"no";0;0;0;55,320555;15,186944
1745;"Kristiansø";"no";0;0;0;55,320555;15,186944
1746;"Kristiansø";"no";0;0;0;55,320555;15,186944
1747;"Kristiansø";"no";0;0;0;55,320555;15,186944
1748;"Kristiansø";"no";0;0;0;55,320555;15,186944
1749;"Kristiansø";"no";0;0;0;55,320555;15,186944
1750;"Kristiansø";"no";0;0;0;55,320555;15,186944
1751;"Kristiansø";"no";0;0;0;55,320555;15,186944
1752;"Kristiansø";"no";0;0;0;55,320555;15,186944
1753;"Kristiansø";"no";0;0;0;55,320555;15,186944
1754;"Kristiansø";"no";0;0;0;55,320555;15,186944
1755;"Kristiansø";"no";0;0;0;55,320555;15,186944
1756;"Kristiansø";"no";0;0;0;55,320555;15,186944
1757;"Kristiansø";"no";1;0;1;55,320555;15,186944
1758;"Kristiansø";"no";0;0;0;55,320555;15,186944
1759;"Kristiansø";"no";1;0;1;55,320555;15,186944
1760;"Kristiansø";"no";0;0;0;55,320555;15,186944
1761;"Kristiansø";"no";0;0;0;55,320555;15,186944
1762;"Kristiansø";"no";0;0;0;55,320555;15,186944
1763;"Kristiansø";"no";0;0;0;55,320555;15,186944
1764;"Kristiansø";"no";0;0;0;55,320555;15,186944
1765;"Kristiansø";"no";2;0;2;55,320555;15,186944
1766;"Kristiansø";"no";0;0;0;55,320555;15,186944
1767;"Kristiansø";"no";0;0;0;55,320555;15,186944
1768;"Kristiansø";"no";0;0;0;55,320555;15,186944
1769;"Kristiansø";"no";0;0;0;55,320555;15,186944
1770;"Kristiansø";"no";0;0;0;55,320555;15,186944
1771;"Kristiansø";"no";0;0;0;55,320555;15,186944
1772;"Kristiansø";"no";0;0;0;55,320555;15,186944
1773;"Kristiansø";"no";0;0;0;55,320555;15,186944
1774;"Kristiansø";"no";0;0;0;55,320555;15,186944
1775;"Kristiansø";"no";0;0;0;55,320555;15,186944
1776;"Kristiansø";"no";0;0;0;55,320555;15,186944
1777;"Kristiansø";"no";0;0;0;55,320555;15,186944
1778;"Kristiansø";"no";0;0;0;55,320555;15,186944
1779;"Kristiansø";"no";0;0;0;55,320555;15,186944
1780;"Kristiansø";"no";0;0;0;55,320555;15,186944
1781;"Kristiansø";"no";0;0;0;55,320555;15,186944
1782;"Kristiansø";"no";0;0;0;55,320555;15,186944
1783;"Kristiansø";"no";0;0;0;55,320555;15,186944
1784;"Kristiansø";"no";0;0;0;55,320555;15,186944
1785;"Kristiansø";"no";1;0;1;55,320555;15,186944
1786;"Kristiansø";"no";0;0;0;55,320555;15,186944
1787;"Kristiansø";"no";0;0;0;55,320555;15,186944
1788;"Kristiansø";"no";0;0;0;55,320555;15,186944
1789;"Kristiansø";"no";0;0;0;55,320555;15,186944
1790;"Kristiansø";"no";0;0;0;55,320555;15,186944
1791;"Kristiansø";"no";0;0;0;55,320555;15,186944
1792;"Kristiansø";"no";0;0;0;55,320555;15,186944
1793;"Kristiansø";"no";0;0;0;55,320555;15,186944
1794;"Kristiansø";"no";0;0;0;55,320555;15,186944
1795;"Kristiansø";"no";0;0;0;55,320555;15,186944
1796;"Kristiansø";"no";0;0;0;55,320555;15,186944
1797;"Kristiansø";"no";0;0;0;55,320555;15,186944
1798;"Kristiansø";"no";0;0;0;55,320555;15,186944
1799;"Kristiansø";"no";0;0;0;55,320555;15,186944
1800;"Kristiansø";"no";0;0;0;55,320555;15,186944
1801;"Kristiansø";"no";1;0;1;55,320555;15,186944
1802;"Kristiansø";"no";0;0;0;55,320555;15,186944
1803;"Kristiansø";"no";0;0;0;55,320555;15,186944
1804;"Kristiansø";"no";0;0;0;55,320555;15,186944
1805;"Kristiansø";"no";0;0;0;55,320555;15,186944
1806;"Kristiansø";"no";0;0;0;55,320555;15,186944
1807;"Kristiansø";"no";0;0;0;55,320555;15,186944
1808;"Kristiansø";"no";0;0;0;55,320555;15,186944
1809;"Kristiansø";"no";0;0;0;55,320555;15,186944
1810;"Kristiansø";"no";0;0;0;55,320555;15,186944
1811;"Kristiansø";"no";0;0;0;55,320555;15,186944
1812;"Kristiansø";"no";0;0;0;55,320555;15,186944
1813;"Kristiansø";"no";0;1;1;55,320555;15,186944
1814;"Kristiansø";"no";0;0;0;55,320555;15,186944
1815;"Kristiansø";"no";0;0;0;55,320555;15,186944
1816;"Kristiansø";"no";0;0;0;55,320555;15,186944
1817;"Kristiansø";"no";0;0;0;55,320555;15,186944
1818;"Kristiansø";"no";0;0;0;55,320555;15,186944
1819;"Kristiansø";"no";0;0;0;55,320555;15,186944
1820;"Kristiansø";"no";0;0;0;55,320555;15,186944
1821;"Kristiansø";"no";0;0;0;55,320555;15,186944
1822;"Kristiansø";"no";0;0;0;55,320555;15,186944
1823;"Kristiansø";"no";0;0;0;55,320555;15,186944
1824;"Kristiansø";"no";0;0;0;55,320555;15,186944
1825;"Kristiansø";"no";0;0;0;55,320555;15,186944
1826;"Kristiansø";"no";0;0;0;55,320555;15,186944
1827;"Kristiansø";"no";0;0;0;55,320555;15,186944
1828;"Kristiansø";"no";0;0;0;55,320555;15,186944
1829;"Kristiansø";"no";0;0;0;55,320555;15,186944
1830;"Kristiansø";"no";0;0;0;55,320555;15,186944
1831;"Kristiansø";"no";0;0;0;55,320555;15,186944
1832;"Kristiansø";"no";1;0;1;55,320555;15,186944
1833;"Kristiansø";"no";0;0;0;55,320555;15,186944
1834;"Kristiansø";"no";0;0;0;55,320555;15,186944
1835;"Kristiansø";"no";0;0;0;55,320555;15,186944
1836;"Kristiansø";"no";0;0;0;55,320555;15,186944
1837;"Kristiansø";"no";1;0;1;55,320555;15,186944
1838;"Kristiansø";"no";0;0;0;55,320555;15,186944
1839;"Kristiansø";"no";1;0;1;55,320555;15,186944
1840;"Kristiansø";"no";0;0;0;55,320555;15,186944
1841;"Kristiansø";"no";0;0;0;55,320555;15,186944
1842;"Kristiansø";"no";0;0;0;55,320555;15,186944
1843;"Kristiansø";"no";0;0;0;55,320555;15,186944
1844;"Kristiansø";"no";1;0;1;55,320555;15,186944
1845;"Kristiansø";"no";0;0;0;55,320555;15,186944
1846;"Kristiansø";"no";0;0;0;55,320555;15,186944
1847;"Kristiansø";"no";0;0;0;55,320555;15,186944
1848;"Kristiansø";"no";0;0;0;55,320555;15,186944
1849;"Kristiansø";"no";0;0;0;55,320555;15,186944
1850;"Kristiansø";"no";0;0;0;55,320555;15,186944
1851;"Kristiansø";"no";0;0;0;55,320555;15,186944
1852;"Kristiansø";"no";0;0;0;55,320555;15,186944
1853;"Kristiansø";"no";0;0;0;55,320555;15,186944
1854;"Kristiansø";"no";0;0;0;55,320555;15,186944
1855;"Kristiansø";"no";0;0;0;55,320555;15,186944
1856;"Kristiansø";"no";0;0;0;55,320555;15,186944
1857;"Kristiansø";"no";0;0;0;55,320555;15,186944
1634;"Odense";"no";0;0;0;55,395833;10,388055
1635;"Odense";"no";0;0;0;55,395833;10,388055
1636;"Odense";"no";0;0;0;55,395833;10,388055
1637;"Odense";"no";0;0;0;55,395833;10,388055
1638;"Odense";"no";0;0;0;55,395833;10,388055
1639;"Odense";"no";0;0;0;55,395833;10,388055
1640;"Odense";"no";0;0;0;55,395833;10,388055
1641;"Odense";"no";0;0;0;55,395833;10,388055
1642;"Odense";"no";0;0;0;55,395833;10,388055
1643;"Odense";"no";0;0;0;55,395833;10,388055
1644;"Odense";"no";0;0;0;55,395833;10,388055
1645;"Odense";"no";0;0;0;55,395833;10,388055
1646;"Odense";"no";0;0;0;55,395833;10,388055
1647;"Odense";"no";0;0;0;55,395833;10,388055
1648;"Odense";"no";0;0;0;55,395833;10,388055
1649;"Odense";"no";0;0;0;55,395833;10,388055
1650;"Odense";"no";0;0;0;55,395833;10,388055
1651;"Odense";"no";0;0;0;55,395833;10,388055
1652;"Odense";"no";0;0;0;55,395833;10,388055
1653;"Odense";"no";0;0;0;55,395833;10,388055
1654;"Odense";"no";0;0;0;55,395833;10,388055
1655;"Odense";"no";0;0;0;55,395833;10,388055
1656;"Odense";"no";0;0;0;55,395833;10,388055
1657;"Odense";"no";0;0;0;55,395833;10,388055
1658;"Odense";"no";0;0;0;55,395833;10,388055
1659;"Odense";"no";0;0;0;55,395833;10,388055
1660;"Odense";"no";0;0;0;55,395833;10,388055
1661;"Odense";"no";0;0;0;55,395833;10,388055
1662;"Odense";"no";0;0;0;55,395833;10,388055
1663;"Odense";"no";0;0;0;55,395833;10,388055
1664;"Odense";"no";0;0;0;55,395833;10,388055
1665;"Odense";"no";0;0;0;55,395833;10,388055
1666;"Odense";"no";0;0;0;55,395833;10,388055
1667;"Odense";"no";0;0;0;55,395833;10,388055
1668;"Odense";"no";0;0;0;55,395833;10,388055
1669;"Odense";"no";0;0;0;55,395833;10,388055
1670;"Odense";"no";0;0;0;55,395833;10,388055
1671;"Odense";"no";0;0;0;55,395833;10,388055
1672;"Odense";"no";0;0;0;55,395833;10,388055
1673;"Odense";"no";0;0;0;55,395833;10,388055
1674;"Odense";"no";0;0;0;55,395833;10,388055
1675;"Odense";"no";0;0;0;55,395833;10,388055
1676;"Odense";"no";0;0;0;55,395833;10,388055
1677;"Odense";"no";0;0;0;55,395833;10,388055
1678;"Odense";"no";0;0;0;55,395833;10,388055
1679;"Odense";"no";0;0;0;55,395833;10,388055
1680;"Odense";"no";0;1;1;55,395833;10,388055
1681;"Odense";"no";0;0;0;55,395833;10,388055
1682;"Odense";"no";0;0;0;55,395833;10,388055
1683;"Odense";"no";0;0;0;55,395833;10,388055
1684;"Odense";"no";0;0;0;55,395833;10,388055
1685;"Odense";"no";1;1;2;55,395833;10,388055
1686;"Odense";"no";0;0;0;55,395833;10,388055
1687;"Odense";"no";0;0;0;55,395833;10,388055
1688;"Odense";"no";0;0;0;55,395833;10,388055
1689;"Odense";"no";0;0;0;55,395833;10,388055
1690;"Odense";"no";0;0;0;55,395833;10,388055
1691;"Odense";"no";0;0;0;55,395833;10,388055
1692;"Odense";"no";1;1;2;55,395833;10,388055
1693;"Odense";"no";0;0;0;55,395833;10,388055
1694;"Odense";"no";0;0;0;55,395833;10,388055
1695;"Odense";"no";0;0;0;55,395833;10,388055
1696;"Odense";"no";1;0;1;55,395833;10,388055
1697;"Odense";"no";1;0;1;55,395833;10,388055
1698;"Odense";"no";0;0;0;55,395833;10,388055
1699;"Odense";"no";0;0;0;55,395833;10,388055
1700;"Odense";"no";0;0;0;55,395833;10,388055
1701;"Odense";"no";0;0;0;55,395833;10,388055
1702;"Odense";"no";0;0;0;55,395833;10,388055
1703;"Odense";"no";0;0;0;55,395833;10,388055
1704;"Odense";"no";1;0;1;55,395833;10,388055
1705;"Odense";"no";0;0;0;55,395833;10,388055
1706;"Odense";"no";0;0;0;55,395833;10,388055
1707;"Odense";"no";0;0;0;55,395833;10,388055
1708;"Odense";"no";0;0;0;55,395833;10,388055
1709;"Odense";"no";0;0;0;55,395833;10,388055
1710;"Odense";"no";0;0;0;55,395833;10,388055
1711;"Odense";"no";0;0;0;55,395833;10,388055
1712;"Odense";"no";0;0;0;55,395833;10,388055
1713;"Odense";"no";0;0;0;55,395833;10,388055
1714;"Odense";"no";0;0;0;55,395833;10,388055
1715;"Odense";"no";0;0;0;55,395833;10,388055
1716;"Odense";"no";0;0;0;55,395833;10,388055
1717;"Odense";"no";0;0;0;55,395833;10,388055
1718;"Odense";"no";0;0;0;55,395833;10,388055
1719;"Odense";"no";0;0;0;55,395833;10,388055
1720;"Odense";"no";0;0;0;55,395833;10,388055
1721;"Odense";"no";0;1;1;55,395833;10,388055
1722;"Odense";"no";0;0;0;55,395833;10,388055
1723;"Odense";"no";0;1;1;55,395833;10,388055
1724;"Odense";"no";0;0;0;55,395833;10,388055
1725;"Odense";"no";0;0;0;55,395833;10,388055
1726;"Odense";"no";0;0;0;55,395833;10,388055
1727;"Odense";"no";0;0;0;55,395833;10,388055
1728;"Odense";"no";0;0;0;55,395833;10,388055
1729;"Odense";"no";0;0;0;55,395833;10,388055
1730;"Odense";"no";0;0;0;55,395833;10,388055
1731;"Odense";"no";0;0;0;55,395833;10,388055
1732;"Odense";"no";0;0;0;55,395833;10,388055
1733;"Odense";"no";0;0;0;55,395833;10,388055
1734;"Odense";"no";0;0;0;55,395833;10,388055
1735;"Odense";"no";0;0;0;55,395833;10,388055
1736;"Odense";"no";0;0;0;55,395833;10,388055
1737;"Odense";"no";0;0;0;55,395833;10,388055
1738;"Odense";"no";0;0;0;55,395833;10,388055
1739;"Odense";"no";0;0;0;55,395833;10,388055
1740;"Odense";"no";0;0;0;55,395833;10,388055
1741;"Odense";"no";0;0;0;55,395833;10,388055
1742;"Odense";"no";0;0;0;55,395833;10,388055
1743;"Odense";"no";0;0;0;55,395833;10,388055
1744;"Odense";"no";0;1;1;55,395833;10,388055
1745;"Odense";"no";0;0;0;55,395833;10,388055
1746;"Odense";"no";0;0;0;55,395833;10,388055
1747;"Odense";"no";0;0;0;55,395833;10,388055
1748;"Odense";"no";0;1;1;55,395833;10,388055
1749;"Odense";"no";0;0;0;55,395833;10,388055
1750;"Odense";"no";0;0;0;55,395833;10,388055
1751;"Odense";"no";0;0;0;55,395833;10,388055
1752;"Odense";"no";0;0;0;55,395833;10,388055
1753;"Odense";"no";0;0;0;55,395833;10,388055
1754;"Odense";"no";0;0;0;55,395833;10,388055
1755;"Odense";"no";1;0;1;55,395833;10,388055
1756;"Odense";"no";0;0;0;55,395833;10,388055
1757;"Odense";"no";0;0;0;55,395833;10,388055
1758;"Odense";"no";0;0;0;55,395833;10,388055
1759;"Odense";"no";0;0;0;55,395833;10,388055
1760;"Odense";"no";0;1;1;55,395833;10,388055
1761;"Odense";"no";1;3;4;55,395833;10,388055
1762;"Odense";"no";0;1;1;55,395833;10,388055
1763;"Odense";"no";1;1;2;55,395833;10,388055
1764;"Odense";"no";1;0;1;55,395833;10,388055
1765;"Odense";"no";0;1;1;55,395833;10,388055
1766;"Odense";"no";0;1;1;55,395833;10,388055
1767;"Odense";"no";2;0;2;55,395833;10,388055
1768;"Odense";"no";0;1;1;55,395833;10,388055
1769;"Odense";"no";0;0;0;55,395833;10,388055
1770;"Odense";"no";0;0;0;55,395833;10,388055
1771;"Odense";"no";0;0;0;55,395833;10,388055
1772;"Odense";"no";0;0;0;55,395833;10,388055
1773;"Odense";"no";0;2;2;55,395833;10,388055
1774;"Odense";"no";0;0;0;55,395833;10,388055
1775;"Odense";"no";0;1;1;55,395833;10,388055
1776;"Odense";"no";0;1;1;55,395833;10,388055
1777;"Odense";"no";0;0;0;55,395833;10,388055
1778;"Odense";"no";0;0;0;55,395833;10,388055
1779;"Odense";"no";0;0;0;55,395833;10,388055
1780;"Odense";"no";0;0;0;55,395833;10,388055
1781;"Odense";"no";0;0;0;55,395833;10,388055
1782;"Odense";"no";0;0;0;55,395833;10,388055
1783;"Odense";"no";0;0;0;55,395833;10,388055
1784;"Odense";"no";0;0;0;55,395833;10,388055
1785;"Odense";"no";1;0;1;55,395833;10,388055
1786;"Odense";"no";0;0;0;55,395833;10,388055
1787;"Odense";"no";0;0;0;55,395833;10,388055
1788;"Odense";"no";0;0;0;55,395833;10,388055
1789;"Odense";"no";0;1;1;55,395833;10,388055
1790;"Odense";"no";1;0;1;55,395833;10,388055
1791;"Odense";"no";0;0;0;55,395833;10,388055
1792;"Odense";"no";1;1;2;55,395833;10,388055
1793;"Odense";"no";0;0;0;55,395833;10,388055
1794;"Odense";"no";1;1;2;55,395833;10,388055
1795;"Odense";"no";1;1;2;55,395833;10,388055
1796;"Odense";"no";1;0;1;55,395833;10,388055
1797;"Odense";"no";0;0;0;55,395833;10,388055
1798;"Odense";"no";1;1;2;55,395833;10,388055
1799;"Odense";"no";0;0;0;55,395833;10,388055
1800;"Odense";"no";1;0;1;55,395833;10,388055
1801;"Odense";"no";0;0;0;55,395833;10,388055
1802;"Odense";"no";0;1;1;55,395833;10,388055
1803;"Odense";"no";0;0;0;55,395833;10,388055
1804;"Odense";"no";0;0;0;55,395833;10,388055
1805;"Odense";"no";0;0;0;55,395833;10,388055
1806;"Odense";"no";2;0;2;55,395833;10,388055
1807;"Odense";"no";1;0;1;55,395833;10,388055
1808;"Odense";"no";0;0;0;55,395833;10,388055
1809;"Odense";"no";0;0;0;55,395833;10,388055
1810;"Odense";"no";0;1;1;55,395833;10,388055
1811;"Odense";"no";0;1;1;55,395833;10,388055
1812;"Odense";"no";0;0;0;55,395833;10,388055
1813;"Odense";"no";1;0;1;55,395833;10,388055
1814;"Odense";"no";0;1;1;55,395833;10,388055
1815;"Odense";"no";0;1;1;55,395833;10,388055
1816;"Odense";"no";0;0;0;55,395833;10,388055
1817;"Odense";"no";1;2;3;55,395833;10,388055
1818;"Odense";"no";0;2;2;55,395833;10,388055
1819;"Odense";"no";0;0;0;55,395833;10,388055
1820;"Odense";"no";0;1;1;55,395833;10,388055
1821;"Odense";"no";0;0;0;55,395833;10,388055
1822;"Odense";"no";0;0;0;55,395833;10,388055
1823;"Odense";"no";0;1;1;55,395833;10,388055
1824;"Odense";"no";0;0;0;55,395833;10,388055
1825;"Odense";"no";0;0;0;55,395833;10,388055
1826;"Odense";"no";2;3;5;55,395833;10,388055
1827;"Odense";"no";0;0;0;55,395833;10,388055
1828;"Odense";"no";0;0;0;55,395833;10,388055
1829;"Odense";"no";0;0;0;55,395833;10,388055
1830;"Odense";"no";0;1;1;55,395833;10,388055
1831;"Odense";"no";2;0;2;55,395833;10,388055
1832;"Odense";"no";2;0;2;55,395833;10,388055
1833;"Odense";"no";3;1;4;55,395833;10,388055
1834;"Odense";"no";7;2;9;55,395833;10,388055
1835;"Odense";"no";7;0;7;55,395833;10,388055
1836;"Odense";"no";3;0;3;55,395833;10,388055
1837;"Odense";"no";1;1;2;55,395833;10,388055
1838;"Odense";"no";3;1;4;55,395833;10,388055
1839;"Odense";"no";1;1;2;55,395833;10,388055
1840;"Odense";"no";1;1;2;55,395833;10,388055
1841;"Odense";"no";5;2;7;55,395833;10,388055
1842;"Odense";"no";6;0;6;55,395833;10,388055
1843;"Odense";"no";8;4;12;55,395833;10,388055
1844;"Odense";"no";17;4;21;55,395833;10,388055
1845;"Odense";"no";18;3;21;55,395833;10,388055
1846;"Odense";"no";16;4;20;55,395833;10,388055
1847;"Odense";"no";22;7;29;55,395833;10,388055
1848;"Odense";"no";18;10;28;55,395833;10,388055
1849;"Odense";"no";23;15;38;55,395833;10,388055
1850;"Odense";"no";25;5;30;55,395833;10,388055
1851;"Odense";"no";24;8;32;55,395833;10,388055
1852;"Odense";"no";21;6;27;55,395833;10,388055
1853;"Odense";"no";12;2;14;55,395833;10,388055
1854;"Odense";"no";18;4;22;55,395833;10,388055
1855;"Odense";"no";17;8;25;55,395833;10,388055
1856;"Odense";"no";17;7;24;55,395833;10,388055
1857;"Odense";"no";2;0;2;55,395833;10,388055
1634;"Rørvig";"no";0;0;0;55,95;11,766666
1635;"Rørvig";"no";0;0;0;55,95;11,766666
1636;"Rørvig";"no";0;0;0;55,95;11,766666
1637;"Rørvig";"no";0;0;0;55,95;11,766666
1638;"Rørvig";"no";0;0;0;55,95;11,766666
1639;"Rørvig";"no";0;0;0;55,95;11,766666
1640;"Rørvig";"no";0;0;0;55,95;11,766666
1641;"Rørvig";"no";0;0;0;55,95;11,766666
1642;"Rørvig";"no";0;0;0;55,95;11,766666
1643;"Rørvig";"no";0;0;0;55,95;11,766666
1644;"Rørvig";"no";0;0;0;55,95;11,766666
1645;"Rørvig";"no";0;0;0;55,95;11,766666
1646;"Rørvig";"no";0;0;0;55,95;11,766666
1647;"Rørvig";"no";0;0;0;55,95;11,766666
1648;"Rørvig";"no";0;0;0;55,95;11,766666
1649;"Rørvig";"no";0;0;0;55,95;11,766666
1650;"Rørvig";"no";0;0;0;55,95;11,766666
1651;"Rørvig";"no";0;0;0;55,95;11,766666
1652;"Rørvig";"no";0;0;0;55,95;11,766666
1653;"Rørvig";"no";0;0;0;55,95;11,766666
1654;"Rørvig";"no";0;0;0;55,95;11,766666
1655;"Rørvig";"no";0;0;0;55,95;11,766666
1656;"Rørvig";"no";0;0;0;55,95;11,766666
1657;"Rørvig";"no";0;0;0;55,95;11,766666
1658;"Rørvig";"no";0;0;0;55,95;11,766666
1659;"Rørvig";"no";0;0;0;55,95;11,766666
1660;"Rørvig";"no";0;0;0;55,95;11,766666
1661;"Rørvig";"no";0;0;0;55,95;11,766666
1662;"Rørvig";"no";0;0;0;55,95;11,766666
1663;"Rørvig";"no";0;0;0;55,95;11,766666
1664;"Rørvig";"no";0;0;0;55,95;11,766666
1665;"Rørvig";"no";0;0;0;55,95;11,766666
1666;"Rørvig";"no";0;0;0;55,95;11,766666
1667;"Rørvig";"no";0;0;0;55,95;11,766666
1668;"Rørvig";"no";0;0;0;55,95;11,766666
1669;"Rørvig";"no";0;0;0;55,95;11,766666
1670;"Rørvig";"no";0;1;1;55,95;11,766666
1671;"Rørvig";"no";0;0;0;55,95;11,766666
1672;"Rørvig";"no";0;0;0;55,95;11,766666
1673;"Rørvig";"no";0;1;1;55,95;11,766666
1674;"Rørvig";"no";0;0;0;55,95;11,766666
1675;"Rørvig";"no";0;0;0;55,95;11,766666
1676;"Rørvig";"no";0;0;0;55,95;11,766666
1677;"Rørvig";"no";0;0;0;55,95;11,766666
1678;"Rørvig";"no";0;0;0;55,95;11,766666
1679;"Rørvig";"no";0;0;0;55,95;11,766666
1680;"Rørvig";"no";0;0;0;55,95;11,766666
1681;"Rørvig";"no";0;0;0;55,95;11,766666
1682;"Rørvig";"no";0;1;1;55,95;11,766666
1683;"Rørvig";"no";0;0;0;55,95;11,766666
1684;"Rørvig";"no";0;0;0;55,95;11,766666
1685;"Rørvig";"no";0;1;1;55,95;11,766666
1686;"Rørvig";"no";0;0;0;55,95;11,766666
1687;"Rørvig";"no";0;0;0;55,95;11,766666
1688;"Rørvig";"no";0;0;0;55,95;11,766666
1689;"Rørvig";"no";0;0;0;55,95;11,766666
1690;"Rørvig";"no";1;0;1;55,95;11,766666
1691;"Rørvig";"no";0;1;1;55,95;11,766666
1692;"Rørvig";"no";2;3;5;55,95;11,766666
1693;"Rørvig";"no";1;1;2;55,95;11,766666
1694;"Rørvig";"no";1;0;1;55,95;11,766666
1695;"Rørvig";"no";1;3;4;55,95;11,766666
1696;"Rørvig";"no";1;4;5;55,95;11,766666
1697;"Rørvig";"no";2;3;5;55,95;11,766666
1698;"Rørvig";"no";1;2;3;55,95;11,766666
1699;"Rørvig";"no";0;2;2;55,95;11,766666
1700;"Rørvig";"no";0;1;1;55,95;11,766666
1701;"Rørvig";"no";0;4;4;55,95;11,766666
1702;"Rørvig";"no";0;0;0;55,95;11,766666
1703;"Rørvig";"no";1;1;2;55,95;11,766666
1704;"Rørvig";"no";0;5;5;55,95;11,766666
1705;"Rørvig";"no";0;0;0;55,95;11,766666
1706;"Rørvig";"no";0;1;1;55,95;11,766666
1707;"Rørvig";"no";0;1;1;55,95;11,766666
1708;"Rørvig";"no";2;1;3;55,95;11,766666
1709;"Rørvig";"no";1;1;2;55,95;11,766666
1710;"Rørvig";"no";1;0;1;55,95;11,766666
1711;"Rørvig";"no";0;1;1;55,95;11,766666
1712;"Rørvig";"no";1;2;3;55,95;11,766666
1713;"Rørvig";"no";0;1;1;55,95;11,766666
1714;"Rørvig";"no";2;2;4;55,95;11,766666
1715;"Rørvig";"no";0;0;0;55,95;11,766666
1716;"Rørvig";"no";1;2;3;55,95;11,766666
1717;"Rørvig";"no";4;3;7;55,95;11,766666
1718;"Rørvig";"no";0;0;0;55,95;11,766666
1719;"Rørvig";"no";1;0;1;55,95;11,766666
1720;"Rørvig";"no";0;0;0;55,95;11,766666
1721;"Rørvig";"no";3;0;3;55,95;11,766666
1722;"Rørvig";"no";3;3;6;55,95;11,766666
1723;"Rørvig";"no";0;4;4;55,95;11,766666
1724;"Rørvig";"no";0;1;1;55,95;11,766666
1725;"Rørvig";"no";0;2;2;55,95;11,766666
1726;"Rørvig";"no";2;2;4;55,95;11,766666
1727;"Rørvig";"no";1;0;1;55,95;11,766666
1728;"Rørvig";"no";1;2;3;55,95;11,766666
1729;"Rørvig";"no";0;3;3;55,95;11,766666
1730;"Rørvig";"no";0;0;0;55,95;11,766666
1731;"Rørvig";"no";2;1;3;55,95;11,766666
1732;"Rørvig";"no";1;4;5;55,95;11,766666
1733;"Rørvig";"no";0;2;2;55,95;11,766666
1734;"Rørvig";"no";0;1;1;55,95;11,766666
1735;"Rørvig";"no";2;2;4;55,95;11,766666
1736;"Rørvig";"no";0;2;2;55,95;11,766666
1737;"Rørvig";"no";0;0;0;55,95;11,766666
1738;"Rørvig";"no";0;1;1;55,95;11,766666
1739;"Rørvig";"no";1;2;3;55,95;11,766666
1740;"Rørvig";"no";0;0;0;55,95;11,766666
1741;"Rørvig";"no";2;1;3;55,95;11,766666
1742;"Rørvig";"no";0;1;1;55,95;11,766666
1743;"Rørvig";"no";1;0;1;55,95;11,766666
1744;"Rørvig";"no";1;1;2;55,95;11,766666
1745;"Rørvig";"no";0;0;0;55,95;11,766666
1746;"Rørvig";"no";0;1;1;55,95;11,766666
1747;"Rørvig";"no";1;0;1;55,95;11,766666
1748;"Rørvig";"no";0;1;1;55,95;11,766666
1749;"Rørvig";"no";1;0;1;55,95;11,766666
1750;"Rørvig";"no";0;0;0;55,95;11,766666
1751;"Rørvig";"no";0;2;2;55,95;11,766666
1752;"Rørvig";"no";0;2;2;55,95;11,766666
1753;"Rørvig";"no";0;1;1;55,95;11,766666
1754;"Rørvig";"no";0;3;3;55,95;11,766666
1755;"Rørvig";"no";0;2;2;55,95;11,766666
1756;"Rørvig";"no";0;1;1;55,95;11,766666
1757;"Rørvig";"no";0;2;2;55,95;11,766666
1758;"Rørvig";"no";0;1;1;55,95;11,766666
1759;"Rørvig";"no";0;1;1;55,95;11,766666
1760;"Rørvig";"no";0;0;0;55,95;11,766666
1761;"Rørvig";"no";3;1;4;55,95;11,766666
1762;"Rørvig";"no";1;2;3;55,95;11,766666
1763;"Rørvig";"no";1;0;1;55,95;11,766666
1764;"Rørvig";"no";0;0;0;55,95;11,766666
1765;"Rørvig";"no";3;3;6;55,95;11,766666
1766;"Rørvig";"no";1;1;2;55,95;11,766666
1767;"Rørvig";"no";0;1;1;55,95;11,766666
1768;"Rørvig";"no";1;0;1;55,95;11,766666
1769;"Rørvig";"no";1;2;3;55,95;11,766666
1770;"Rørvig";"no";6;1;7;55,95;11,766666
1771;"Rørvig";"no";1;0;1;55,95;11,766666
1772;"Rørvig";"no";1;0;1;55,95;11,766666
1773;"Rørvig";"no";2;1;3;55,95;11,766666
1774;"Rørvig";"no";1;3;4;55,95;11,766666
1775;"Rørvig";"no";2;4;6;55,95;11,766666
1776;"Rørvig";"no";2;1;3;55,95;11,766666
1777;"Rørvig";"no";0;1;1;55,95;11,766666
1778;"Rørvig";"no";3;4;7;55,95;11,766666
1779;"Rørvig";"no";2;1;3;55,95;11,766666
1780;"Rørvig";"no";3;1;4;55,95;11,766666
1781;"Rørvig";"no";1;0;1;55,95;11,766666
1782;"Rørvig";"no";3;1;4;55,95;11,766666
1783;"Rørvig";"no";4;1;5;55,95;11,766666
1784;"Rørvig";"no";4;0;4;55,95;11,766666
1785;"Rørvig";"no";4;0;4;55,95;11,766666
1786;"Rørvig";"no";6;0;6;55,95;11,766666
1787;"Rørvig";"no";3;1;4;55,95;11,766666
1788;"Rørvig";"no";2;0;2;55,95;11,766666
1789;"Rørvig";"no";3;0;3;55,95;11,766666
1790;"Rørvig";"no";6;0;6;55,95;11,766666
1791;"Rørvig";"no";3;1;4;55,95;11,766666
1792;"Rørvig";"no";3;2;5;55,95;11,766666
1793;"Rørvig";"no";0;1;1;55,95;11,766666
1794;"Rørvig";"no";3;1;4;55,95;11,766666
1795;"Rørvig";"no";6;1;7;55,95;11,766666
1796;"Rørvig";"no";1;0;1;55,95;11,766666
1797;"Rørvig";"no";6;1;7;55,95;11,766666
1798;"Rørvig";"no";6;1;7;55,95;11,766666
1799;"Rørvig";"no";7;0;7;55,95;11,766666
1800;"Rørvig";"no";6;0;6;55,95;11,766666
1801;"Rørvig";"no";4;0;4;55,95;11,766666
1802;"Rørvig";"no";13;0;13;55,95;11,766666
1803;"Rørvig";"no";5;0;5;55,95;11,766666
1804;"Rørvig";"no";4;1;5;55,95;11,766666
1805;"Rørvig";"no";9;1;10;55,95;11,766666
1806;"Rørvig";"no";10;0;10;55,95;11,766666
1807;"Rørvig";"no";12;3;15;55,95;11,766666
1808;"Rørvig";"no";0;0;0;55,95;11,766666
1809;"Rørvig";"no";1;0;1;55,95;11,766666
1810;"Rørvig";"no";1;1;2;55,95;11,766666
1811;"Rørvig";"no";1;1;2;55,95;11,766666
1812;"Rørvig";"no";3;0;3;55,95;11,766666
1813;"Rørvig";"no";0;1;1;55,95;11,766666
1814;"Rørvig";"no";2;1;3;55,95;11,766666
1815;"Rørvig";"no";1;0;1;55,95;11,766666
1816;"Rørvig";"no";3;3;6;55,95;11,766666
1817;"Rørvig";"no";5;3;8;55,95;11,766666
1818;"Rørvig";"no";4;1;5;55,95;11,766666
1819;"Rørvig";"no";5;1;6;55,95;11,766666
1820;"Rørvig";"no";1;2;3;55,95;11,766666
1821;"Rørvig";"no";2;4;6;55,95;11,766666
1822;"Rørvig";"no";3;1;4;55,95;11,766666
1823;"Rørvig";"no";2;1;3;55,95;11,766666
1824;"Rørvig";"no";1;8;9;55,95;11,766666
1825;"Rørvig";"no";4;2;6;55,95;11,766666
1826;"Rørvig";"no";11;2;13;55,95;11,766666
1827;"Rørvig";"no";5;10;15;55,95;11,766666
1828;"Rørvig";"no";13;8;21;55,95;11,766666
1829;"Rørvig";"no";4;6;10;55,95;11,766666
1830;"Rørvig";"no";15;4;19;55,95;11,766666
1831;"Rørvig";"no";7;6;13;55,95;11,766666
1832;"Rørvig";"no";7;2;9;55,95;11,766666
1833;"Rørvig";"no";7;2;9;55,95;11,766666
1834;"Rørvig";"no";18;9;27;55,95;11,766666
1835;"Rørvig";"no";21;1;22;55,95;11,766666
1836;"Rørvig";"no";4;1;5;55,95;11,766666
1837;"Rørvig";"no";4;1;5;55,95;11,766666
1838;"Rørvig";"no";2;0;2;55,95;11,766666
1839;"Rørvig";"no";11;1;12;55,95;11,766666
1840;"Rørvig";"no";8;0;8;55,95;11,766666
1841;"Rørvig";"no";13;0;13;55,95;11,766666
1842;"Rørvig";"no";8;2;10;55,95;11,766666
1843;"Rørvig";"no";9;1;10;55,95;11,766666
1844;"Rørvig";"no";4;2;6;55,95;11,766666
1845;"Rørvig";"no";4;1;5;55,95;11,766666
1846;"Rørvig";"no";0;0;0;55,95;11,766666
1847;"Rørvig";"no";1;0;1;55,95;11,766666
1848;"Rørvig";"no";0;2;2;55,95;11,766666
1849;"Rørvig";"no";0;0;0;55,95;11,766666
1850;"Rørvig";"no";2;0;2;55,95;11,766666
1851;"Rørvig";"no";0;0;0;55,95;11,766666
1852;"Rørvig";"no";0;1;1;55,95;11,766666
1853;"Rørvig";"no";0;0;0;55,95;11,766666
1854;"Rørvig";"no";4;0;4;55,95;11,766666
1855;"Rørvig";"no";1;0;1;55,95;11,766666
1856;"Rørvig";"no";0;4;4;55,95;11,766666
1857;"Rørvig";"no";0;0;0;55,95;11,766666
1634;"Skive";"west";0;0;0;56,566666;9,033333
1635;"Skive";"west";0;0;0;56,566666;9,033333
1636;"Skive";"west";0;0;0;56,566666;9,033333
1637;"Skive";"west";0;0;0;56,566666;9,033333
1638;"Skive";"west";0;0;0;56,566666;9,033333
1639;"Skive";"west";0;0;0;56,566666;9,033333
1640;"Skive";"west";0;0;0;56,566666;9,033333
1641;"Skive";"west";0;0;0;56,566666;9,033333
1642;"Skive";"west";0;0;0;56,566666;9,033333
1643;"Skive";"west";0;0;0;56,566666;9,033333
1644;"Skive";"west";0;0;0;56,566666;9,033333
1645;"Skive";"west";0;0;0;56,566666;9,033333
1646;"Skive";"west";0;0;0;56,566666;9,033333
1647;"Skive";"west";0;0;0;56,566666;9,033333
1648;"Skive";"west";0;0;0;56,566666;9,033333
1649;"Skive";"west";0;0;0;56,566666;9,033333
1650;"Skive";"west";0;0;0;56,566666;9,033333
1651;"Skive";"west";0;0;0;56,566666;9,033333
1652;"Skive";"west";0;0;0;56,566666;9,033333
1653;"Skive";"west";0;0;0;56,566666;9,033333
1654;"Skive";"west";0;0;0;56,566666;9,033333
1655;"Skive";"west";0;0;0;56,566666;9,033333
1656;"Skive";"west";0;0;0;56,566666;9,033333
1657;"Skive";"west";0;0;0;56,566666;9,033333
1658;"Skive";"west";0;0;0;56,566666;9,033333
1659;"Skive";"west";0;0;0;56,566666;9,033333
1660;"Skive";"west";0;0;0;56,566666;9,033333
1661;"Skive";"west";0;0;0;56,566666;9,033333
1662;"Skive";"west";0;0;0;56,566666;9,033333
1663;"Skive";"west";0;0;0;56,566666;9,033333
1664;"Skive";"west";0;0;0;56,566666;9,033333
1665;"Skive";"west";0;0;0;56,566666;9,033333
1666;"Skive";"west";0;0;0;56,566666;9,033333
1667;"Skive";"west";0;0;0;56,566666;9,033333
1668;"Skive";"west";0;0;0;56,566666;9,033333
1669;"Skive";"west";0;0;0;56,566666;9,033333
1670;"Skive";"west";0;0;0;56,566666;9,033333
1671;"Skive";"west";0;0;0;56,566666;9,033333
1672;"Skive";"west";0;0;0;56,566666;9,033333
1673;"Skive";"west";0;0;0;56,566666;9,033333
1674;"Skive";"west";0;0;0;56,566666;9,033333
1675;"Skive";"west";0;0;0;56,566666;9,033333
1676;"Skive";"west";0;0;0;56,566666;9,033333
1677;"Skive";"west";0;0;0;56,566666;9,033333
1678;"Skive";"west";0;0;0;56,566666;9,033333
1679;"Skive";"west";0;0;0;56,566666;9,033333
1680;"Skive";"west";0;0;0;56,566666;9,033333
1681;"Skive";"west";0;0;0;56,566666;9,033333
1682;"Skive";"west";0;0;0;56,566666;9,033333
1683;"Skive";"west";0;0;0;56,566666;9,033333
1684;"Skive";"west";0;0;0;56,566666;9,033333
1685;"Skive";"west";0;0;0;56,566666;9,033333
1686;"Skive";"west";0;0;0;56,566666;9,033333
1687;"Skive";"west";0;0;0;56,566666;9,033333
1688;"Skive";"west";0;0;0;56,566666;9,033333
1689;"Skive";"west";0;0;0;56,566666;9,033333
1690;"Skive";"west";1;0;1;56,566666;9,033333
1691;"Skive";"west";0;0;0;56,566666;9,033333
1692;"Skive";"west";0;0;0;56,566666;9,033333
1693;"Skive";"west";0;0;0;56,566666;9,033333
1694;"Skive";"west";0;0;0;56,566666;9,033333
1695;"Skive";"west";0;0;0;56,566666;9,033333
1696;"Skive";"west";0;0;0;56,566666;9,033333
1697;"Skive";"west";0;0;0;56,566666;9,033333
1698;"Skive";"west";0;0;0;56,566666;9,033333
1699;"Skive";"west";0;0;0;56,566666;9,033333
1700;"Skive";"west";0;0;0;56,566666;9,033333
1701;"Skive";"west";0;0;0;56,566666;9,033333
1702;"Skive";"west";0;0;0;56,566666;9,033333
1703;"Skive";"west";0;0;0;56,566666;9,033333
1704;"Skive";"west";0;0;0;56,566666;9,033333
1705;"Skive";"west";0;0;0;56,566666;9,033333
1706;"Skive";"west";0;0;0;56,566666;9,033333
1707;"Skive";"west";0;0;0;56,566666;9,033333
1708;"Skive";"west";0;0;0;56,566666;9,033333
1709;"Skive";"west";0;0;0;56,566666;9,033333
1710;"Skive";"west";0;0;0;56,566666;9,033333
1711;"Skive";"west";0;0;0;56,566666;9,033333
1712;"Skive";"west";0;0;0;56,566666;9,033333
1713;"Skive";"west";0;0;0;56,566666;9,033333
1714;"Skive";"west";0;0;0;56,566666;9,033333
1715;"Skive";"west";0;0;0;56,566666;9,033333
1716;"Skive";"west";0;0;0;56,566666;9,033333
1717;"Skive";"west";0;0;0;56,566666;9,033333
1718;"Skive";"west";0;0;0;56,566666;9,033333
1719;"Skive";"west";0;0;0;56,566666;9,033333
1720;"Skive";"west";0;0;0;56,566666;9,033333
1721;"Skive";"west";0;0;0;56,566666;9,033333
1722;"Skive";"west";0;0;0;56,566666;9,033333
1723;"Skive";"west";0;0;0;56,566666;9,033333
1724;"Skive";"west";0;0;0;56,566666;9,033333
1725;"Skive";"west";0;0;0;56,566666;9,033333
1726;"Skive";"west";0;0;0;56,566666;9,033333
1727;"Skive";"west";0;0;0;56,566666;9,033333
1728;"Skive";"west";0;0;0;56,566666;9,033333
1729;"Skive";"west";0;0;0;56,566666;9,033333
1730;"Skive";"west";0;0;0;56,566666;9,033333
1731;"Skive";"west";0;0;0;56,566666;9,033333
1732;"Skive";"west";0;0;0;56,566666;9,033333
1733;"Skive";"west";0;0;0;56,566666;9,033333
1734;"Skive";"west";0;0;0;56,566666;9,033333
1735;"Skive";"west";0;0;0;56,566666;9,033333
1736;"Skive";"west";0;0;0;56,566666;9,033333
1737;"Skive";"west";0;0;0;56,566666;9,033333
1738;"Skive";"west";0;0;0;56,566666;9,033333
1739;"Skive";"west";0;0;0;56,566666;9,033333
1740;"Skive";"west";0;0;0;56,566666;9,033333
1741;"Skive";"west";0;0;0;56,566666;9,033333
1742;"Skive";"west";0;0;0;56,566666;9,033333
1743;"Skive";"west";0;0;0;56,566666;9,033333
1744;"Skive";"west";0;0;0;56,566666;9,033333
1745;"Skive";"west";0;0;0;56,566666;9,033333
1746;"Skive";"west";0;0;0;56,566666;9,033333
1747;"Skive";"west";0;0;0;56,566666;9,033333
1748;"Skive";"west";0;0;0;56,566666;9,033333
1749;"Skive";"west";0;0;0;56,566666;9,033333
1750;"Skive";"west";0;0;0;56,566666;9,033333
1751;"Skive";"west";0;0;0;56,566666;9,033333
1752;"Skive";"west";0;0;0;56,566666;9,033333
1753;"Skive";"west";0;0;0;56,566666;9,033333
1754;"Skive";"west";0;0;0;56,566666;9,033333
1755;"Skive";"west";0;0;0;56,566666;9,033333
1756;"Skive";"west";0;0;0;56,566666;9,033333
1757;"Skive";"west";0;0;0;56,566666;9,033333
1758;"Skive";"west";0;0;0;56,566666;9,033333
1759;"Skive";"west";0;0;0;56,566666;9,033333
1760;"Skive";"west";0;0;0;56,566666;9,033333
1761;"Skive";"west";0;0;0;56,566666;9,033333
1762;"Skive";"west";0;0;0;56,566666;9,033333
1763;"Skive";"west";0;0;0;56,566666;9,033333
1764;"Skive";"west";0;0;0;56,566666;9,033333
1765;"Skive";"west";0;0;0;56,566666;9,033333
1766;"Skive";"west";0;0;0;56,566666;9,033333
1767;"Skive";"west";0;0;0;56,566666;9,033333
1768;"Skive";"west";0;0;0;56,566666;9,033333
1769;"Skive";"west";0;0;0;56,566666;9,033333
1770;"Skive";"west";0;0;0;56,566666;9,033333
1771;"Skive";"west";0;0;0;56,566666;9,033333
1772;"Skive";"west";0;0;0;56,566666;9,033333
1773;"Skive";"west";0;0;0;56,566666;9,033333
1774;"Skive";"west";0;0;0;56,566666;9,033333
1775;"Skive";"west";0;0;0;56,566666;9,033333
1776;"Skive";"west";0;0;0;56,566666;9,033333
1777;"Skive";"west";0;0;0;56,566666;9,033333
1778;"Skive";"west";0;0;0;56,566666;9,033333
1779;"Skive";"west";0;0;0;56,566666;9,033333
1780;"Skive";"west";0;0;0;56,566666;9,033333
1781;"Skive";"west";0;0;0;56,566666;9,033333
1782;"Skive";"west";0;0;0;56,566666;9,033333
1783;"Skive";"west";0;0;0;56,566666;9,033333
1784;"Skive";"west";0;0;0;56,566666;9,033333
1785;"Skive";"west";0;0;0;56,566666;9,033333
1786;"Skive";"west";0;0;0;56,566666;9,033333
1787;"Skive";"west";0;0;0;56,566666;9,033333
1788;"Skive";"west";0;0;0;56,566666;9,033333
1789;"Skive";"west";0;0;0;56,566666;9,033333
1790;"Skive";"west";0;0;0;56,566666;9,033333
1791;"Skive";"west";0;0;0;56,566666;9,033333
1792;"Skive";"west";0;0;0;56,566666;9,033333
1793;"Skive";"west";0;0;0;56,566666;9,033333
1794;"Skive";"west";0;0;0;56,566666;9,033333
1795;"Skive";"west";0;0;0;56,566666;9,033333
1796;"Skive";"west";0;0;0;56,566666;9,033333
1797;"Skive";"west";0;0;0;56,566666;9,033333
1798;"Skive";"west";0;0;0;56,566666;9,033333
1799;"Skive";"west";0;0;0;56,566666;9,033333
1800;"Skive";"west";0;0;0;56,566666;9,033333
1801;"Skive";"west";0;0;0;56,566666;9,033333
1802;"Skive";"west";0;0;0;56,566666;9,033333
1803;"Skive";"west";0;0;0;56,566666;9,033333
1804;"Skive";"west";0;0;0;56,566666;9,033333
1805;"Skive";"west";0;0;0;56,566666;9,033333
1806;"Skive";"west";0;0;0;56,566666;9,033333
1807;"Skive";"west";0;0;0;56,566666;9,033333
1808;"Skive";"west";0;0;0;56,566666;9,033333
1809;"Skive";"west";0;0;0;56,566666;9,033333
1810;"Skive";"west";0;0;0;56,566666;9,033333
1811;"Skive";"west";0;0;0;56,566666;9,033333
1812;"Skive";"west";0;0;0;56,566666;9,033333
1813;"Skive";"west";0;0;0;56,566666;9,033333
1814;"Skive";"west";0;0;0;56,566666;9,033333
1815;"Skive";"west";0;0;0;56,566666;9,033333
1816;"Skive";"west";0;0;0;56,566666;9,033333
1817;"Skive";"west";0;0;0;56,566666;9,033333
1818;"Skive";"west";0;0;0;56,566666;9,033333
1819;"Skive";"west";0;0;0;56,566666;9,033333
1820;"Skive";"west";0;0;0;56,566666;9,033333
1821;"Skive";"west";0;0;0;56,566666;9,033333
1822;"Skive";"west";0;0;0;56,566666;9,033333
1823;"Skive";"west";0;0;0;56,566666;9,033333
1824;"Skive";"west";0;0;0;56,566666;9,033333
1825;"Skive";"west";0;0;0;56,566666;9,033333
1826;"Skive";"west";0;0;0;56,566666;9,033333
1827;"Skive";"west";0;0;0;56,566666;9,033333
1828;"Skive";"west";0;0;0;56,566666;9,033333
1829;"Skive";"west";0;0;0;56,566666;9,033333
1830;"Skive";"west";0;0;0;56,566666;9,033333
1831;"Skive";"west";0;0;0;56,566666;9,033333
1832;"Skive";"west";0;0;0;56,566666;9,033333
1833;"Skive";"west";0;0;0;56,566666;9,033333
1834;"Skive";"west";0;0;0;56,566666;9,033333
1835;"Skive";"west";0;0;0;56,566666;9,033333
1836;"Skive";"west";0;0;0;56,566666;9,033333
1837;"Skive";"west";0;0;0;56,566666;9,033333
1838;"Skive";"west";0;0;0;56,566666;9,033333
1839;"Skive";"west";0;0;0;56,566666;9,033333
1840;"Skive";"west";0;0;0;56,566666;9,033333
1841;"Skive";"west";0;0;0;56,566666;9,033333
1842;"Skive";"west";1;1;2;56,566666;9,033333
1843;"Skive";"west";2;0;2;56,566666;9,033333
1844;"Skive";"west";1;1;2;56,566666;9,033333
1845;"Skive";"west";0;2;2;56,566666;9,033333
1846;"Skive";"west";1;1;2;56,566666;9,033333
1847;"Skive";"west";3;1;4;56,566666;9,033333
1848;"Skive";"west";0;3;3;56,566666;9,033333
1849;"Skive";"west";3;1;4;56,566666;9,033333
1850;"Skive";"west";2;2;4;56,566666;9,033333
1851;"Skive";"west";0;4;4;56,566666;9,033333
1852;"Skive";"west";4;2;6;56,566666;9,033333
1853;"Skive";"west";2;1;3;56,566666;9,033333
1854;"Skive";"west";2;1;3;56,566666;9,033333
1855;"Skive";"west";6;2;8;56,566666;9,033333
1856;"Skive";"west";9;2;11;56,566666;9,033333
1857;"Skive";"west";0;0;0;56,566666;9,033333
1634;"Faaborg";"no";0;0;0;55,095;10,242222
1635;"Faaborg";"no";0;0;0;55,095;10,242222
1636;"Faaborg";"no";0;0;0;55,095;10,242222
1637;"Faaborg";"no";0;0;0;55,095;10,242222
1638;"Faaborg";"no";0;0;0;55,095;10,242222
1639;"Faaborg";"no";0;0;0;55,095;10,242222
1640;"Faaborg";"no";0;0;0;55,095;10,242222
1641;"Faaborg";"no";0;0;0;55,095;10,242222
1642;"Faaborg";"no";0;0;0;55,095;10,242222
1643;"Faaborg";"no";0;0;0;55,095;10,242222
1644;"Faaborg";"no";0;0;0;55,095;10,242222
1645;"Faaborg";"no";0;0;0;55,095;10,242222
1646;"Faaborg";"no";0;0;0;55,095;10,242222
1647;"Faaborg";"no";0;0;0;55,095;10,242222
1648;"Faaborg";"no";0;0;0;55,095;10,242222
1649;"Faaborg";"no";0;0;0;55,095;10,242222
1650;"Faaborg";"no";0;0;0;55,095;10,242222
1651;"Faaborg";"no";0;0;0;55,095;10,242222
1652;"Faaborg";"no";0;0;0;55,095;10,242222
1653;"Faaborg";"no";0;0;0;55,095;10,242222
1654;"Faaborg";"no";0;0;0;55,095;10,242222
1655;"Faaborg";"no";0;0;0;55,095;10,242222
1656;"Faaborg";"no";0;0;0;55,095;10,242222
1657;"Faaborg";"no";0;0;0;55,095;10,242222
1658;"Faaborg";"no";0;0;0;55,095;10,242222
1659;"Faaborg";"no";0;0;0;55,095;10,242222
1660;"Faaborg";"no";0;0;0;55,095;10,242222
1661;"Faaborg";"no";0;0;0;55,095;10,242222
1662;"Faaborg";"no";0;0;0;55,095;10,242222
1663;"Faaborg";"no";0;0;0;55,095;10,242222
1664;"Faaborg";"no";0;0;0;55,095;10,242222
1665;"Faaborg";"no";0;0;0;55,095;10,242222
1666;"Faaborg";"no";0;0;0;55,095;10,242222
1667;"Faaborg";"no";0;0;0;55,095;10,242222
1668;"Faaborg";"no";0;0;0;55,095;10,242222
1669;"Faaborg";"no";0;0;0;55,095;10,242222
1670;"Faaborg";"no";0;0;0;55,095;10,242222
1671;"Faaborg";"no";0;0;0;55,095;10,242222
1672;"Faaborg";"no";0;0;0;55,095;10,242222
1673;"Faaborg";"no";0;0;0;55,095;10,242222
1674;"Faaborg";"no";0;1;1;55,095;10,242222
1675;"Faaborg";"no";0;0;0;55,095;10,242222
1676;"Faaborg";"no";0;0;0;55,095;10,242222
1677;"Faaborg";"no";0;0;0;55,095;10,242222
1678;"Faaborg";"no";0;0;0;55,095;10,242222
1679;"Faaborg";"no";0;0;0;55,095;10,242222
1680;"Faaborg";"no";0;0;0;55,095;10,242222
1681;"Faaborg";"no";0;0;0;55,095;10,242222
1682;"Faaborg";"no";0;0;0;55,095;10,242222
1683;"Faaborg";"no";0;0;0;55,095;10,242222
1684;"Faaborg";"no";0;0;0;55,095;10,242222
1685;"Faaborg";"no";0;0;0;55,095;10,242222
1686;"Faaborg";"no";0;0;0;55,095;10,242222
1687;"Faaborg";"no";0;0;0;55,095;10,242222
1688;"Faaborg";"no";0;0;0;55,095;10,242222
1689;"Faaborg";"no";0;0;0;55,095;10,242222
1690;"Faaborg";"no";0;0;0;55,095;10,242222
1691;"Faaborg";"no";0;0;0;55,095;10,242222
1692;"Faaborg";"no";0;0;0;55,095;10,242222
1693;"Faaborg";"no";1;0;1;55,095;10,242222
1694;"Faaborg";"no";0;0;0;55,095;10,242222
1695;"Faaborg";"no";0;0;0;55,095;10,242222
1696;"Faaborg";"no";0;0;0;55,095;10,242222
1697;"Faaborg";"no";0;1;1;55,095;10,242222
1698;"Faaborg";"no";0;0;0;55,095;10,242222
1699;"Faaborg";"no";0;0;0;55,095;10,242222
1700;"Faaborg";"no";0;0;0;55,095;10,242222
1701;"Faaborg";"no";1;0;1;55,095;10,242222
1702;"Faaborg";"no";0;0;0;55,095;10,242222
1703;"Faaborg";"no";0;0;0;55,095;10,242222
1704;"Faaborg";"no";0;0;0;55,095;10,242222
1705;"Faaborg";"no";0;0;0;55,095;10,242222
1706;"Faaborg";"no";0;0;0;55,095;10,242222
1707;"Faaborg";"no";0;0;0;55,095;10,242222
1708;"Faaborg";"no";0;0;0;55,095;10,242222
1709;"Faaborg";"no";0;0;0;55,095;10,242222
1710;"Faaborg";"no";0;0;0;55,095;10,242222
1711;"Faaborg";"no";1;0;1;55,095;10,242222
1712;"Faaborg";"no";0;0;0;55,095;10,242222
1713;"Faaborg";"no";0;0;0;55,095;10,242222
1714;"Faaborg";"no";0;0;0;55,095;10,242222
1715;"Faaborg";"no";0;0;0;55,095;10,242222
1716;"Faaborg";"no";0;0;0;55,095;10,242222
1717;"Faaborg";"no";0;0;0;55,095;10,242222
1718;"Faaborg";"no";0;0;0;55,095;10,242222
1719;"Faaborg";"no";0;0;0;55,095;10,242222
1720;"Faaborg";"no";0;0;0;55,095;10,242222
1721;"Faaborg";"no";0;0;0;55,095;10,242222
1722;"Faaborg";"no";0;0;0;55,095;10,242222
1723;"Faaborg";"no";0;0;0;55,095;10,242222
1724;"Faaborg";"no";0;0;0;55,095;10,242222
1725;"Faaborg";"no";0;0;0;55,095;10,242222
1726;"Faaborg";"no";0;1;1;55,095;10,242222
1727;"Faaborg";"no";0;0;0;55,095;10,242222
1728;"Faaborg";"no";0;0;0;55,095;10,242222
1729;"Faaborg";"no";0;0;0;55,095;10,242222
1730;"Faaborg";"no";0;0;0;55,095;10,242222
1731;"Faaborg";"no";0;0;0;55,095;10,242222
1732;"Faaborg";"no";0;0;0;55,095;10,242222
1733;"Faaborg";"no";0;0;0;55,095;10,242222
1734;"Faaborg";"no";0;0;0;55,095;10,242222
1735;"Faaborg";"no";0;0;0;55,095;10,242222
1736;"Faaborg";"no";0;0;0;55,095;10,242222
1737;"Faaborg";"no";0;0;0;55,095;10,242222
1738;"Faaborg";"no";0;0;0;55,095;10,242222
1739;"Faaborg";"no";0;0;0;55,095;10,242222
1740;"Faaborg";"no";0;0;0;55,095;10,242222
1741;"Faaborg";"no";0;0;0;55,095;10,242222
1742;"Faaborg";"no";0;0;0;55,095;10,242222
1743;"Faaborg";"no";0;0;0;55,095;10,242222
1744;"Faaborg";"no";0;0;0;55,095;10,242222
1745;"Faaborg";"no";0;0;0;55,095;10,242222
1746;"Faaborg";"no";0;0;0;55,095;10,242222
1747;"Faaborg";"no";0;0;0;55,095;10,242222
1748;"Faaborg";"no";0;0;0;55,095;10,242222
1749;"Faaborg";"no";0;0;0;55,095;10,242222
1750;"Faaborg";"no";0;0;0;55,095;10,242222
1751;"Faaborg";"no";0;0;0;55,095;10,242222
1752;"Faaborg";"no";0;0;0;55,095;10,242222
1753;"Faaborg";"no";1;0;1;55,095;10,242222
1754;"Faaborg";"no";0;1;1;55,095;10,242222
1755;"Faaborg";"no";0;0;0;55,095;10,242222
1756;"Faaborg";"no";0;1;1;55,095;10,242222
1757;"Faaborg";"no";0;0;0;55,095;10,242222
1758;"Faaborg";"no";0;0;0;55,095;10,242222
1759;"Faaborg";"no";0;0;0;55,095;10,242222
1760;"Faaborg";"no";0;1;1;55,095;10,242222
1761;"Faaborg";"no";0;0;0;55,095;10,242222
1762;"Faaborg";"no";0;0;0;55,095;10,242222
1763;"Faaborg";"no";0;0;0;55,095;10,242222
1764;"Faaborg";"no";0;0;0;55,095;10,242222
1765;"Faaborg";"no";0;0;0;55,095;10,242222
1766;"Faaborg";"no";0;0;0;55,095;10,242222
1767;"Faaborg";"no";0;1;1;55,095;10,242222
1768;"Faaborg";"no";0;0;0;55,095;10,242222
1769;"Faaborg";"no";0;0;0;55,095;10,242222
1770;"Faaborg";"no";0;0;0;55,095;10,242222
1771;"Faaborg";"no";0;0;0;55,095;10,242222
1772;"Faaborg";"no";0;0;0;55,095;10,242222
1773;"Faaborg";"no";0;0;0;55,095;10,242222
1774;"Faaborg";"no";0;0;0;55,095;10,242222
1775;"Faaborg";"no";0;0;0;55,095;10,242222
1776;"Faaborg";"no";0;0;0;55,095;10,242222
1777;"Faaborg";"no";0;0;0;55,095;10,242222
1778;"Faaborg";"no";0;0;0;55,095;10,242222
1779;"Faaborg";"no";0;0;0;55,095;10,242222
1780;"Faaborg";"no";0;3;3;55,095;10,242222
1781;"Faaborg";"no";0;1;1;55,095;10,242222
1782;"Faaborg";"no";0;0;0;55,095;10,242222
1783;"Faaborg";"no";0;1;1;55,095;10,242222
1784;"Faaborg";"no";0;0;0;55,095;10,242222
1785;"Faaborg";"no";0;0;0;55,095;10,242222
1786;"Faaborg";"no";0;0;0;55,095;10,242222
1787;"Faaborg";"no";0;0;0;55,095;10,242222
1788;"Faaborg";"no";0;0;0;55,095;10,242222
1789;"Faaborg";"no";0;0;0;55,095;10,242222
1790;"Faaborg";"no";0;0;0;55,095;10,242222
1791;"Faaborg";"no";0;0;0;55,095;10,242222
1792;"Faaborg";"no";0;0;0;55,095;10,242222
1793;"Faaborg";"no";0;2;2;55,095;10,242222
1794;"Faaborg";"no";0;0;0;55,095;10,242222
1795;"Faaborg";"no";0;0;0;55,095;10,242222
1796;"Faaborg";"no";0;0;0;55,095;10,242222
1797;"Faaborg";"no";0;0;0;55,095;10,242222
1798;"Faaborg";"no";0;0;0;55,095;10,242222
1799;"Faaborg";"no";0;0;0;55,095;10,242222
1800;"Faaborg";"no";0;0;0;55,095;10,242222
1801;"Faaborg";"no";0;1;1;55,095;10,242222
1802;"Faaborg";"no";0;0;0;55,095;10,242222
1803;"Faaborg";"no";0;1;1;55,095;10,242222
1804;"Faaborg";"no";0;0;0;55,095;10,242222
1805;"Faaborg";"no";0;0;0;55,095;10,242222
1806;"Faaborg";"no";0;0;0;55,095;10,242222
1807;"Faaborg";"no";0;0;0;55,095;10,242222
1808;"Faaborg";"no";0;0;0;55,095;10,242222
1809;"Faaborg";"no";0;0;0;55,095;10,242222
1810;"Faaborg";"no";0;0;0;55,095;10,242222
1811;"Faaborg";"no";0;0;0;55,095;10,242222
1812;"Faaborg";"no";0;0;0;55,095;10,242222
1813;"Faaborg";"no";0;0;0;55,095;10,242222
1814;"Faaborg";"no";0;0;0;55,095;10,242222
1815;"Faaborg";"no";0;0;0;55,095;10,242222
1816;"Faaborg";"no";0;0;0;55,095;10,242222
1817;"Faaborg";"no";0;1;1;55,095;10,242222
1818;"Faaborg";"no";0;0;0;55,095;10,242222
1819;"Faaborg";"no";0;1;1;55,095;10,242222
1820;"Faaborg";"no";0;0;0;55,095;10,242222
1821;"Faaborg";"no";1;0;1;55,095;10,242222
1822;"Faaborg";"no";0;0;0;55,095;10,242222
1823;"Faaborg";"no";0;0;0;55,095;10,242222
1824;"Faaborg";"no";0;0;0;55,095;10,242222
1825;"Faaborg";"no";0;2;2;55,095;10,242222
1826;"Faaborg";"no";0;1;1;55,095;10,242222
1827;"Faaborg";"no";1;0;1;55,095;10,242222
1828;"Faaborg";"no";0;1;1;55,095;10,242222
1829;"Faaborg";"no";0;0;0;55,095;10,242222
1830;"Faaborg";"no";0;0;0;55,095;10,242222
1831;"Faaborg";"no";1;1;2;55,095;10,242222
1832;"Faaborg";"no";0;0;0;55,095;10,242222
1833;"Faaborg";"no";0;0;0;55,095;10,242222
1834;"Faaborg";"no";0;0;0;55,095;10,242222
1835;"Faaborg";"no";0;0;0;55,095;10,242222
1836;"Faaborg";"no";0;0;0;55,095;10,242222
1837;"Faaborg";"no";0;1;1;55,095;10,242222
1838;"Faaborg";"no";0;0;0;55,095;10,242222
1839;"Faaborg";"no";1;1;2;55,095;10,242222
1840;"Faaborg";"no";1;1;2;55,095;10,242222
1841;"Faaborg";"no";1;0;1;55,095;10,242222
1842;"Faaborg";"no";0;0;0;55,095;10,242222
1843;"Faaborg";"no";0;0;0;55,095;10,242222
1844;"Faaborg";"no";2;0;2;55,095;10,242222
1845;"Faaborg";"no";1;0;1;55,095;10,242222
1846;"Faaborg";"no";3;0;3;55,095;10,242222
1847;"Faaborg";"no";1;0;1;55,095;10,242222
1848;"Faaborg";"no";0;4;4;55,095;10,242222
1849;"Faaborg";"no";2;0;2;55,095;10,242222
1850;"Faaborg";"no";0;1;1;55,095;10,242222
1851;"Faaborg";"no";1;1;2;55,095;10,242222
1852;"Faaborg";"no";0;0;0;55,095;10,242222
1853;"Faaborg";"no";1;0;1;55,095;10,242222
1854;"Faaborg";"no";2;0;2;55,095;10,242222
1855;"Faaborg";"no";0;0;0;55,095;10,242222
1856;"Faaborg";"no";0;0;0;55,095;10,242222
1857;"Faaborg";"no";0;0;0;55,095;10,242222
1634;"Hadsund";"no";0;0;0;56,716666;10,116666
1635;"Hadsund";"no";0;0;0;56,716666;10,116666
1636;"Hadsund";"no";0;0;0;56,716666;10,116666
1637;"Hadsund";"no";0;0;0;56,716666;10,116666
1638;"Hadsund";"no";0;0;0;56,716666;10,116666
1639;"Hadsund";"no";0;0;0;56,716666;10,116666
1640;"Hadsund";"no";0;0;0;56,716666;10,116666
1641;"Hadsund";"no";0;0;0;56,716666;10,116666
1642;"Hadsund";"no";0;0;0;56,716666;10,116666
1643;"Hadsund";"no";0;0;0;56,716666;10,116666
1644;"Hadsund";"no";0;0;0;56,716666;10,116666
1645;"Hadsund";"no";0;0;0;56,716666;10,116666
1646;"Hadsund";"no";0;0;0;56,716666;10,116666
1647;"Hadsund";"no";0;0;0;56,716666;10,116666
1648;"Hadsund";"no";0;0;0;56,716666;10,116666
1649;"Hadsund";"no";0;0;0;56,716666;10,116666
1650;"Hadsund";"no";0;0;0;56,716666;10,116666
1651;"Hadsund";"no";0;0;0;56,716666;10,116666
1652;"Hadsund";"no";0;0;0;56,716666;10,116666
1653;"Hadsund";"no";0;0;0;56,716666;10,116666
1654;"Hadsund";"no";0;0;0;56,716666;10,116666
1655;"Hadsund";"no";0;0;0;56,716666;10,116666
1656;"Hadsund";"no";0;0;0;56,716666;10,116666
1657;"Hadsund";"no";0;0;0;56,716666;10,116666
1658;"Hadsund";"no";0;0;0;56,716666;10,116666
1659;"Hadsund";"no";0;0;0;56,716666;10,116666
1660;"Hadsund";"no";0;0;0;56,716666;10,116666
1661;"Hadsund";"no";0;0;0;56,716666;10,116666
1662;"Hadsund";"no";0;0;0;56,716666;10,116666
1663;"Hadsund";"no";0;0;0;56,716666;10,116666
1664;"Hadsund";"no";0;0;0;56,716666;10,116666
1665;"Hadsund";"no";0;0;0;56,716666;10,116666
1666;"Hadsund";"no";0;0;0;56,716666;10,116666
1667;"Hadsund";"no";0;0;0;56,716666;10,116666
1668;"Hadsund";"no";0;0;0;56,716666;10,116666
1669;"Hadsund";"no";0;0;0;56,716666;10,116666
1670;"Hadsund";"no";0;0;0;56,716666;10,116666
1671;"Hadsund";"no";0;0;0;56,716666;10,116666
1672;"Hadsund";"no";0;0;0;56,716666;10,116666
1673;"Hadsund";"no";0;0;0;56,716666;10,116666
1674;"Hadsund";"no";0;0;0;56,716666;10,116666
1675;"Hadsund";"no";0;0;0;56,716666;10,116666
1676;"Hadsund";"no";0;0;0;56,716666;10,116666
1677;"Hadsund";"no";0;0;0;56,716666;10,116666
1678;"Hadsund";"no";0;0;0;56,716666;10,116666
1679;"Hadsund";"no";0;0;0;56,716666;10,116666
1680;"Hadsund";"no";0;0;0;56,716666;10,116666
1681;"Hadsund";"no";0;0;0;56,716666;10,116666
1682;"Hadsund";"no";0;0;0;56,716666;10,116666
1683;"Hadsund";"no";0;0;0;56,716666;10,116666
1684;"Hadsund";"no";0;0;0;56,716666;10,116666
1685;"Hadsund";"no";0;0;0;56,716666;10,116666
1686;"Hadsund";"no";0;0;0;56,716666;10,116666
1687;"Hadsund";"no";0;0;0;56,716666;10,116666
1688;"Hadsund";"no";0;0;0;56,716666;10,116666
1689;"Hadsund";"no";0;0;0;56,716666;10,116666
1690;"Hadsund";"no";0;0;0;56,716666;10,116666
1691;"Hadsund";"no";0;0;0;56,716666;10,116666
1692;"Hadsund";"no";0;0;0;56,716666;10,116666
1693;"Hadsund";"no";1;0;1;56,716666;10,116666
1694;"Hadsund";"no";0;0;0;56,716666;10,116666
1695;"Hadsund";"no";0;0;0;56,716666;10,116666
1696;"Hadsund";"no";0;0;0;56,716666;10,116666
1697;"Hadsund";"no";0;0;0;56,716666;10,116666
1698;"Hadsund";"no";0;0;0;56,716666;10,116666
1699;"Hadsund";"no";0;0;0;56,716666;10,116666
1700;"Hadsund";"no";0;1;1;56,716666;10,116666
1701;"Hadsund";"no";0;0;0;56,716666;10,116666
1702;"Hadsund";"no";0;1;1;56,716666;10,116666
1703;"Hadsund";"no";0;0;0;56,716666;10,116666
1704;"Hadsund";"no";0;0;0;56,716666;10,116666
1705;"Hadsund";"no";0;0;0;56,716666;10,116666
1706;"Hadsund";"no";0;0;0;56,716666;10,116666
1707;"Hadsund";"no";0;0;0;56,716666;10,116666
1708;"Hadsund";"no";0;0;0;56,716666;10,116666
1709;"Hadsund";"no";0;0;0;56,716666;10,116666
1710;"Hadsund";"no";0;0;0;56,716666;10,116666
1711;"Hadsund";"no";2;0;2;56,716666;10,116666
1712;"Hadsund";"no";3;0;3;56,716666;10,116666
1713;"Hadsund";"no";0;0;0;56,716666;10,116666
1714;"Hadsund";"no";0;0;0;56,716666;10,116666
1715;"Hadsund";"no";0;0;0;56,716666;10,116666
1716;"Hadsund";"no";0;0;0;56,716666;10,116666
1717;"Hadsund";"no";0;0;0;56,716666;10,116666
1718;"Hadsund";"no";0;0;0;56,716666;10,116666
1719;"Hadsund";"no";0;0;0;56,716666;10,116666
1720;"Hadsund";"no";0;0;0;56,716666;10,116666
1721;"Hadsund";"no";0;0;0;56,716666;10,116666
1722;"Hadsund";"no";1;0;1;56,716666;10,116666
1723;"Hadsund";"no";0;0;0;56,716666;10,116666
1724;"Hadsund";"no";0;0;0;56,716666;10,116666
1725;"Hadsund";"no";0;0;0;56,716666;10,116666
1726;"Hadsund";"no";1;0;1;56,716666;10,116666
1727;"Hadsund";"no";0;1;1;56,716666;10,116666
1728;"Hadsund";"no";0;0;0;56,716666;10,116666
1729;"Hadsund";"no";0;0;0;56,716666;10,116666
1730;"Hadsund";"no";0;0;0;56,716666;10,116666
1731;"Hadsund";"no";0;2;2;56,716666;10,116666
1732;"Hadsund";"no";0;0;0;56,716666;10,116666
1733;"Hadsund";"no";0;0;0;56,716666;10,116666
1734;"Hadsund";"no";0;0;0;56,716666;10,116666
1735;"Hadsund";"no";0;0;0;56,716666;10,116666
1736;"Hadsund";"no";0;0;0;56,716666;10,116666
1737;"Hadsund";"no";0;0;0;56,716666;10,116666
1738;"Hadsund";"no";0;0;0;56,716666;10,116666
1739;"Hadsund";"no";0;0;0;56,716666;10,116666
1740;"Hadsund";"no";0;0;0;56,716666;10,116666
1741;"Hadsund";"no";0;0;0;56,716666;10,116666
1742;"Hadsund";"no";0;0;0;56,716666;10,116666
1743;"Hadsund";"no";0;0;0;56,716666;10,116666
1744;"Hadsund";"no";0;0;0;56,716666;10,116666
1745;"Hadsund";"no";0;0;0;56,716666;10,116666
1746;"Hadsund";"no";0;0;0;56,716666;10,116666
1747;"Hadsund";"no";1;0;1;56,716666;10,116666
1748;"Hadsund";"no";0;0;0;56,716666;10,116666
1749;"Hadsund";"no";0;0;0;56,716666;10,116666
1750;"Hadsund";"no";1;0;1;56,716666;10,116666
1751;"Hadsund";"no";0;0;0;56,716666;10,116666
1752;"Hadsund";"no";0;0;0;56,716666;10,116666
1753;"Hadsund";"no";0;0;0;56,716666;10,116666
1754;"Hadsund";"no";0;0;0;56,716666;10,116666
1755;"Hadsund";"no";0;0;0;56,716666;10,116666
1756;"Hadsund";"no";1;0;1;56,716666;10,116666
1757;"Hadsund";"no";0;0;0;56,716666;10,116666
1758;"Hadsund";"no";1;0;1;56,716666;10,116666
1759;"Hadsund";"no";0;0;0;56,716666;10,116666
1760;"Hadsund";"no";0;0;0;56,716666;10,116666
1761;"Hadsund";"no";0;0;0;56,716666;10,116666
1762;"Hadsund";"no";1;0;1;56,716666;10,116666
1763;"Hadsund";"no";0;0;0;56,716666;10,116666
1764;"Hadsund";"no";0;0;0;56,716666;10,116666
1765;"Hadsund";"no";1;0;1;56,716666;10,116666
1766;"Hadsund";"no";0;0;0;56,716666;10,116666
1767;"Hadsund";"no";0;0;0;56,716666;10,116666
1768;"Hadsund";"no";1;0;1;56,716666;10,116666
1769;"Hadsund";"no";0;0;0;56,716666;10,116666
1770;"Hadsund";"no";0;0;0;56,716666;10,116666
1771;"Hadsund";"no";1;0;1;56,716666;10,116666
1772;"Hadsund";"no";0;0;0;56,716666;10,116666
1773;"Hadsund";"no";0;0;0;56,716666;10,116666
1774;"Hadsund";"no";0;0;0;56,716666;10,116666
1775;"Hadsund";"no";0;0;0;56,716666;10,116666
1776;"Hadsund";"no";1;0;1;56,716666;10,116666
1777;"Hadsund";"no";1;1;2;56,716666;10,116666
1778;"Hadsund";"no";0;0;0;56,716666;10,116666
1779;"Hadsund";"no";0;0;0;56,716666;10,116666
1780;"Hadsund";"no";0;0;0;56,716666;10,116666
1781;"Hadsund";"no";0;0;0;56,716666;10,116666
1782;"Hadsund";"no";0;0;0;56,716666;10,116666
1783;"Hadsund";"no";0;0;0;56,716666;10,116666
1784;"Hadsund";"no";0;0;0;56,716666;10,116666
1785;"Hadsund";"no";0;0;0;56,716666;10,116666
1786;"Hadsund";"no";0;0;0;56,716666;10,116666
1787;"Hadsund";"no";0;0;0;56,716666;10,116666
1788;"Hadsund";"no";0;0;0;56,716666;10,116666
1789;"Hadsund";"no";0;0;0;56,716666;10,116666
1790;"Hadsund";"no";0;0;0;56,716666;10,116666
1791;"Hadsund";"no";0;0;0;56,716666;10,116666
1792;"Hadsund";"no";0;0;0;56,716666;10,116666
1793;"Hadsund";"no";0;0;0;56,716666;10,116666
1794;"Hadsund";"no";0;0;0;56,716666;10,116666
1795;"Hadsund";"no";0;0;0;56,716666;10,116666
1796;"Hadsund";"no";0;0;0;56,716666;10,116666
1797;"Hadsund";"no";0;0;0;56,716666;10,116666
1798;"Hadsund";"no";0;0;0;56,716666;10,116666
1799;"Hadsund";"no";0;0;0;56,716666;10,116666
1800;"Hadsund";"no";0;0;0;56,716666;10,116666
1801;"Hadsund";"no";0;0;0;56,716666;10,116666
1802;"Hadsund";"no";0;0;0;56,716666;10,116666
1803;"Hadsund";"no";0;0;0;56,716666;10,116666
1804;"Hadsund";"no";0;0;0;56,716666;10,116666
1805;"Hadsund";"no";0;0;0;56,716666;10,116666
1806;"Hadsund";"no";0;0;0;56,716666;10,116666
1807;"Hadsund";"no";0;0;0;56,716666;10,116666
1808;"Hadsund";"no";0;0;0;56,716666;10,116666
1809;"Hadsund";"no";0;0;0;56,716666;10,116666
1810;"Hadsund";"no";0;0;0;56,716666;10,116666
1811;"Hadsund";"no";0;0;0;56,716666;10,116666
1812;"Hadsund";"no";0;0;0;56,716666;10,116666
1813;"Hadsund";"no";0;0;0;56,716666;10,116666
1814;"Hadsund";"no";0;0;0;56,716666;10,116666
1815;"Hadsund";"no";0;0;0;56,716666;10,116666
1816;"Hadsund";"no";0;0;0;56,716666;10,116666
1817;"Hadsund";"no";0;0;0;56,716666;10,116666
1818;"Hadsund";"no";0;0;0;56,716666;10,116666
1819;"Hadsund";"no";0;0;0;56,716666;10,116666
1820;"Hadsund";"no";0;0;0;56,716666;10,116666
1821;"Hadsund";"no";0;0;0;56,716666;10,116666
1822;"Hadsund";"no";0;0;0;56,716666;10,116666
1823;"Hadsund";"no";0;0;0;56,716666;10,116666
1824;"Hadsund";"no";0;0;0;56,716666;10,116666
1825;"Hadsund";"no";0;0;0;56,716666;10,116666
1826;"Hadsund";"no";0;0;0;56,716666;10,116666
1827;"Hadsund";"no";0;0;0;56,716666;10,116666
1828;"Hadsund";"no";0;0;0;56,716666;10,116666
1829;"Hadsund";"no";0;0;0;56,716666;10,116666
1830;"Hadsund";"no";0;0;0;56,716666;10,116666
1831;"Hadsund";"no";0;0;0;56,716666;10,116666
1832;"Hadsund";"no";0;0;0;56,716666;10,116666
1833;"Hadsund";"no";0;0;0;56,716666;10,116666
1834;"Hadsund";"no";0;0;0;56,716666;10,116666
1835;"Hadsund";"no";0;0;0;56,716666;10,116666
1836;"Hadsund";"no";0;0;0;56,716666;10,116666
1837;"Hadsund";"no";0;0;0;56,716666;10,116666
1838;"Hadsund";"no";0;0;0;56,716666;10,116666
1839;"Hadsund";"no";0;0;0;56,716666;10,116666
1840;"Hadsund";"no";0;0;0;56,716666;10,116666
1841;"Hadsund";"no";0;0;0;56,716666;10,116666
1842;"Hadsund";"no";0;0;0;56,716666;10,116666
1843;"Hadsund";"no";0;0;0;56,716666;10,116666
1844;"Hadsund";"no";0;0;0;56,716666;10,116666
1845;"Hadsund";"no";0;0;0;56,716666;10,116666
1846;"Hadsund";"no";0;0;0;56,716666;10,116666
1847;"Hadsund";"no";1;0;1;56,716666;10,116666
1848;"Hadsund";"no";0;0;0;56,716666;10,116666
1849;"Hadsund";"no";0;0;0;56,716666;10,116666
1850;"Hadsund";"no";0;0;0;56,716666;10,116666
1851;"Hadsund";"no";0;0;0;56,716666;10,116666
1852;"Hadsund";"no";0;0;0;56,716666;10,116666
1853;"Hadsund";"no";0;0;0;56,716666;10,116666
1854;"Hadsund";"no";0;1;1;56,716666;10,116666
1855;"Hadsund";"no";0;0;0;56,716666;10,116666
1856;"Hadsund";"no";0;0;0;56,716666;10,116666
1857;"Hadsund";"no";0;0;0;56,716666;10,116666
1634;"Karrebæksminde";"no";0;0;0;55,183333;11,666666
1635;"Karrebæksminde";"no";0;0;0;55,183333;11,666666
1636;"Karrebæksminde";"no";0;0;0;55,183333;11,666666
1637;"Karrebæksminde";"no";0;0;0;55,183333;11,666666
1638;"Karrebæksminde";"no";0;0;0;55,183333;11,666666
1639;"Karrebæksminde";"no";0;0;0;55,183333;11,666666
1640;"Karrebæksminde";"no";0;0;0;55,183333;11,666666
1641;"Karrebæksminde";"no";0;0;0;55,183333;11,666666
1642;"Karrebæksminde";"no";0;0;0;55,183333;11,666666
1643;"Karrebæksminde";"no";0;0;0;55,183333;11,666666
1644;"Karrebæksminde";"no";0;0;0;55,183333;11,666666
1645;"Karrebæksminde";"no";0;0;0;55,183333;11,666666
1646;"Karrebæksminde";"no";0;0;0;55,183333;11,666666
1647;"Karrebæksminde";"no";0;0;0;55,183333;11,666666
1648;"Karrebæksminde";"no";0;0;0;55,183333;11,666666
1649;"Karrebæksminde";"no";0;0;0;55,183333;11,666666
1650;"Karrebæksminde";"no";0;0;0;55,183333;11,666666
1651;"Karrebæksminde";"no";0;0;0;55,183333;11,666666
1652;"Karrebæksminde";"no";0;0;0;55,183333;11,666666
1653;"Karrebæksminde";"no";0;0;0;55,183333;11,666666
1654;"Karrebæksminde";"no";0;0;0;55,183333;11,666666
1655;"Karrebæksminde";"no";0;0;0;55,183333;11,666666
1656;"Karrebæksminde";"no";0;0;0;55,183333;11,666666
1657;"Karrebæksminde";"no";0;0;0;55,183333;11,666666
1658;"Karrebæksminde";"no";0;0;0;55,183333;11,666666
1659;"Karrebæksminde";"no";0;0;0;55,183333;11,666666
1660;"Karrebæksminde";"no";0;0;0;55,183333;11,666666
1661;"Karrebæksminde";"no";0;0;0;55,183333;11,666666
1662;"Karrebæksminde";"no";0;0;0;55,183333;11,666666
1663;"Karrebæksminde";"no";0;0;0;55,183333;11,666666
1664;"Karrebæksminde";"no";0;0;0;55,183333;11,666666
1665;"Karrebæksminde";"no";0;0;0;55,183333;11,666666
1666;"Karrebæksminde";"no";0;0;0;55,183333;11,666666
1667;"Karrebæksminde";"no";0;0;0;55,183333;11,666666
1668;"Karrebæksminde";"no";0;0;0;55,183333;11,666666
1669;"Karrebæksminde";"no";0;0;0;55,183333;11,666666
1670;"Karrebæksminde";"no";0;0;0;55,183333;11,666666
1671;"Karrebæksminde";"no";0;0;0;55,183333;11,666666
1672;"Karrebæksminde";"no";0;0;0;55,183333;11,666666
1673;"Karrebæksminde";"no";0;0;0;55,183333;11,666666
1674;"Karrebæksminde";"no";0;0;0;55,183333;11,666666
1675;"Karrebæksminde";"no";0;0;0;55,183333;11,666666
1676;"Karrebæksminde";"no";0;0;0;55,183333;11,666666
1677;"Karrebæksminde";"no";0;0;0;55,183333;11,666666
1678;"Karrebæksminde";"no";0;0;0;55,183333;11,666666
1679;"Karrebæksminde";"no";0;0;0;55,183333;11,666666
1680;"Karrebæksminde";"no";0;0;0;55,183333;11,666666
1681;"Karrebæksminde";"no";0;0;0;55,183333;11,666666
1682;"Karrebæksminde";"no";0;0;0;55,183333;11,666666
1683;"Karrebæksminde";"no";0;0;0;55,183333;11,666666
1684;"Karrebæksminde";"no";0;0;0;55,183333;11,666666
1685;"Karrebæksminde";"no";0;0;0;55,183333;11,666666
1686;"Karrebæksminde";"no";0;0;0;55,183333;11,666666
1687;"Karrebæksminde";"no";0;0;0;55,183333;11,666666
1688;"Karrebæksminde";"no";0;0;0;55,183333;11,666666
1689;"Karrebæksminde";"no";0;0;0;55,183333;11,666666
1690;"Karrebæksminde";"no";0;0;0;55,183333;11,666666
1691;"Karrebæksminde";"no";0;0;0;55,183333;11,666666
1692;"Karrebæksminde";"no";0;0;0;55,183333;11,666666
1693;"Karrebæksminde";"no";1;0;1;55,183333;11,666666
1694;"Karrebæksminde";"no";0;0;0;55,183333;11,666666
1695;"Karrebæksminde";"no";0;0;0;55,183333;11,666666
1696;"Karrebæksminde";"no";0;0;0;55,183333;11,666666
1697;"Karrebæksminde";"no";0;0;0;55,183333;11,666666
1698;"Karrebæksminde";"no";0;0;0;55,183333;11,666666
1699;"Karrebæksminde";"no";0;0;0;55,183333;11,666666
1700;"Karrebæksminde";"no";0;0;0;55,183333;11,666666
1701;"Karrebæksminde";"no";0;0;0;55,183333;11,666666
1702;"Karrebæksminde";"no";0;0;0;55,183333;11,666666
1703;"Karrebæksminde";"no";0;0;0;55,183333;11,666666
1704;"Karrebæksminde";"no";0;0;0;55,183333;11,666666
1705;"Karrebæksminde";"no";0;0;0;55,183333;11,666666
1706;"Karrebæksminde";"no";0;0;0;55,183333;11,666666
1707;"Karrebæksminde";"no";0;0;0;55,183333;11,666666
1708;"Karrebæksminde";"no";0;0;0;55,183333;11,666666
1709;"Karrebæksminde";"no";0;0;0;55,183333;11,666666
1710;"Karrebæksminde";"no";3;0;3;55,183333;11,666666
1711;"Karrebæksminde";"no";0;0;0;55,183333;11,666666
1712;"Karrebæksminde";"no";0;0;0;55,183333;11,666666
1713;"Karrebæksminde";"no";1;0;1;55,183333;11,666666
1714;"Karrebæksminde";"no";1;0;1;55,183333;11,666666
1715;"Karrebæksminde";"no";1;0;1;55,183333;11,666666
1716;"Karrebæksminde";"no";0;0;0;55,183333;11,666666
1717;"Karrebæksminde";"no";0;0;0;55,183333;11,666666
1718;"Karrebæksminde";"no";0;0;0;55,183333;11,666666
1719;"Karrebæksminde";"no";0;0;0;55,183333;11,666666
1720;"Karrebæksminde";"no";2;0;2;55,183333;11,666666
1721;"Karrebæksminde";"no";0;0;0;55,183333;11,666666
1722;"Karrebæksminde";"no";0;0;0;55,183333;11,666666
1723;"Karrebæksminde";"no";0;0;0;55,183333;11,666666
1724;"Karrebæksminde";"no";1;0;1;55,183333;11,666666
1725;"Karrebæksminde";"no";1;0;1;55,183333;11,666666
1726;"Karrebæksminde";"no";1;0;1;55,183333;11,666666
1727;"Karrebæksminde";"no";0;0;0;55,183333;11,666666
1728;"Karrebæksminde";"no";0;0;0;55,183333;11,666666
1729;"Karrebæksminde";"no";0;0;0;55,183333;11,666666
1730;"Karrebæksminde";"no";0;0;0;55,183333;11,666666
1731;"Karrebæksminde";"no";0;0;0;55,183333;11,666666
1732;"Karrebæksminde";"no";0;0;0;55,183333;11,666666
1733;"Karrebæksminde";"no";0;0;0;55,183333;11,666666
1734;"Karrebæksminde";"no";0;0;0;55,183333;11,666666
1735;"Karrebæksminde";"no";0;0;0;55,183333;11,666666
1736;"Karrebæksminde";"no";1;0;1;55,183333;11,666666
1737;"Karrebæksminde";"no";0;0;0;55,183333;11,666666
1738;"Karrebæksminde";"no";0;0;0;55,183333;11,666666
1739;"Karrebæksminde";"no";0;0;0;55,183333;11,666666
1740;"Karrebæksminde";"no";0;0;0;55,183333;11,666666
1741;"Karrebæksminde";"no";0;0;0;55,183333;11,666666
1742;"Karrebæksminde";"no";0;0;0;55,183333;11,666666
1743;"Karrebæksminde";"no";0;0;0;55,183333;11,666666
1744;"Karrebæksminde";"no";0;0;0;55,183333;11,666666
1745;"Karrebæksminde";"no";0;0;0;55,183333;11,666666
1746;"Karrebæksminde";"no";0;0;0;55,183333;11,666666
1747;"Karrebæksminde";"no";0;0;0;55,183333;11,666666
1748;"Karrebæksminde";"no";0;0;0;55,183333;11,666666
1749;"Karrebæksminde";"no";1;0;1;55,183333;11,666666
1750;"Karrebæksminde";"no";0;0;0;55,183333;11,666666
1751;"Karrebæksminde";"no";0;0;0;55,183333;11,666666
1752;"Karrebæksminde";"no";0;0;0;55,183333;11,666666
1753;"Karrebæksminde";"no";2;1;3;55,183333;11,666666
1754;"Karrebæksminde";"no";0;0;0;55,183333;11,666666
1755;"Karrebæksminde";"no";0;0;0;55,183333;11,666666
1756;"Karrebæksminde";"no";2;0;2;55,183333;11,666666
1757;"Karrebæksminde";"no";0;0;0;55,183333;11,666666
1758;"Karrebæksminde";"no";1;0;1;55,183333;11,666666
1759;"Karrebæksminde";"no";0;0;0;55,183333;11,666666
1760;"Karrebæksminde";"no";0;0;0;55,183333;11,666666
1761;"Karrebæksminde";"no";0;0;0;55,183333;11,666666
1762;"Karrebæksminde";"no";0;0;0;55,183333;11,666666
1763;"Karrebæksminde";"no";0;0;0;55,183333;11,666666
1764;"Karrebæksminde";"no";0;0;0;55,183333;11,666666
1765;"Karrebæksminde";"no";0;0;0;55,183333;11,666666
1766;"Karrebæksminde";"no";1;0;1;55,183333;11,666666
1767;"Karrebæksminde";"no";0;1;1;55,183333;11,666666
1768;"Karrebæksminde";"no";0;0;0;55,183333;11,666666
1769;"Karrebæksminde";"no";0;0;0;55,183333;11,666666
1770;"Karrebæksminde";"no";0;0;0;55,183333;11,666666
1771;"Karrebæksminde";"no";1;0;1;55,183333;11,666666
1772;"Karrebæksminde";"no";1;0;1;55,183333;11,666666
1773;"Karrebæksminde";"no";1;0;1;55,183333;11,666666
1774;"Karrebæksminde";"no";0;0;0;55,183333;11,666666
1775;"Karrebæksminde";"no";0;0;0;55,183333;11,666666
1776;"Karrebæksminde";"no";1;0;1;55,183333;11,666666
1777;"Karrebæksminde";"no";1;0;1;55,183333;11,666666
1778;"Karrebæksminde";"no";0;0;0;55,183333;11,666666
1779;"Karrebæksminde";"no";0;0;0;55,183333;11,666666
1780;"Karrebæksminde";"no";0;0;0;55,183333;11,666666
1781;"Karrebæksminde";"no";0;0;0;55,183333;11,666666
1782;"Karrebæksminde";"no";0;0;0;55,183333;11,666666
1783;"Karrebæksminde";"no";1;0;1;55,183333;11,666666
1784;"Karrebæksminde";"no";1;1;2;55,183333;11,666666
1785;"Karrebæksminde";"no";0;1;1;55,183333;11,666666
1786;"Karrebæksminde";"no";0;0;0;55,183333;11,666666
1787;"Karrebæksminde";"no";1;2;3;55,183333;11,666666
1788;"Karrebæksminde";"no";3;1;4;55,183333;11,666666
1789;"Karrebæksminde";"no";0;0;0;55,183333;11,666666
1790;"Karrebæksminde";"no";0;0;0;55,183333;11,666666
1791;"Karrebæksminde";"no";0;1;1;55,183333;11,666666
1792;"Karrebæksminde";"no";0;0;0;55,183333;11,666666
1793;"Karrebæksminde";"no";0;0;0;55,183333;11,666666
1794;"Karrebæksminde";"no";0;0;0;55,183333;11,666666
1795;"Karrebæksminde";"no";0;0;0;55,183333;11,666666
1796;"Karrebæksminde";"no";0;0;0;55,183333;11,666666
1797;"Karrebæksminde";"no";0;1;1;55,183333;11,666666
1798;"Karrebæksminde";"no";0;0;0;55,183333;11,666666
1799;"Karrebæksminde";"no";0;0;0;55,183333;11,666666
1800;"Karrebæksminde";"no";0;0;0;55,183333;11,666666
1801;"Karrebæksminde";"no";0;0;0;55,183333;11,666666
1802;"Karrebæksminde";"no";0;0;0;55,183333;11,666666
1803;"Karrebæksminde";"no";0;0;0;55,183333;11,666666
1804;"Karrebæksminde";"no";0;0;0;55,183333;11,666666
1805;"Karrebæksminde";"no";0;0;0;55,183333;11,666666
1806;"Karrebæksminde";"no";0;0;0;55,183333;11,666666
1807;"Karrebæksminde";"no";0;0;0;55,183333;11,666666
1808;"Karrebæksminde";"no";0;0;0;55,183333;11,666666
1809;"Karrebæksminde";"no";0;0;0;55,183333;11,666666
1810;"Karrebæksminde";"no";0;0;0;55,183333;11,666666
1811;"Karrebæksminde";"no";0;0;0;55,183333;11,666666
1812;"Karrebæksminde";"no";0;0;0;55,183333;11,666666
1813;"Karrebæksminde";"no";0;0;0;55,183333;11,666666
1814;"Karrebæksminde";"no";0;0;0;55,183333;11,666666
1815;"Karrebæksminde";"no";0;0;0;55,183333;11,666666
1816;"Karrebæksminde";"no";0;0;0;55,183333;11,666666
1817;"Karrebæksminde";"no";0;0;0;55,183333;11,666666
1818;"Karrebæksminde";"no";0;0;0;55,183333;11,666666
1819;"Karrebæksminde";"no";0;0;0;55,183333;11,666666
1820;"Karrebæksminde";"no";0;0;0;55,183333;11,666666
1821;"Karrebæksminde";"no";0;0;0;55,183333;11,666666
1822;"Karrebæksminde";"no";0;0;0;55,183333;11,666666
1823;"Karrebæksminde";"no";0;0;0;55,183333;11,666666
1824;"Karrebæksminde";"no";0;0;0;55,183333;11,666666
1825;"Karrebæksminde";"no";0;0;0;55,183333;11,666666
1826;"Karrebæksminde";"no";0;0;0;55,183333;11,666666
1827;"Karrebæksminde";"no";0;0;0;55,183333;11,666666
1828;"Karrebæksminde";"no";0;0;0;55,183333;11,666666
1829;"Karrebæksminde";"no";0;1;1;55,183333;11,666666
1830;"Karrebæksminde";"no";0;1;1;55,183333;11,666666
1831;"Karrebæksminde";"no";0;0;0;55,183333;11,666666
1832;"Karrebæksminde";"no";0;0;0;55,183333;11,666666
1833;"Karrebæksminde";"no";0;0;0;55,183333;11,666666
1834;"Karrebæksminde";"no";0;0;0;55,183333;11,666666
1835;"Karrebæksminde";"no";0;0;0;55,183333;11,666666
1836;"Karrebæksminde";"no";0;0;0;55,183333;11,666666
1837;"Karrebæksminde";"no";0;0;0;55,183333;11,666666
1838;"Karrebæksminde";"no";0;0;0;55,183333;11,666666
1839;"Karrebæksminde";"no";0;1;1;55,183333;11,666666
1840;"Karrebæksminde";"no";0;0;0;55,183333;11,666666
1841;"Karrebæksminde";"no";0;1;1;55,183333;11,666666
1842;"Karrebæksminde";"no";0;1;1;55,183333;11,666666
1843;"Karrebæksminde";"no";0;0;0;55,183333;11,666666
1844;"Karrebæksminde";"no";0;0;0;55,183333;11,666666
1845;"Karrebæksminde";"no";0;0;0;55,183333;11,666666
1846;"Karrebæksminde";"no";0;1;1;55,183333;11,666666
1847;"Karrebæksminde";"no";0;3;3;55,183333;11,666666
1848;"Karrebæksminde";"no";0;0;0;55,183333;11,666666
1849;"Karrebæksminde";"no";0;1;1;55,183333;11,666666
1850;"Karrebæksminde";"no";0;2;2;55,183333;11,666666
1851;"Karrebæksminde";"no";0;2;2;55,183333;11,666666
1852;"Karrebæksminde";"no";0;3;3;55,183333;11,666666
1853;"Karrebæksminde";"no";0;2;2;55,183333;11,666666
1854;"Karrebæksminde";"no";0;0;0;55,183333;11,666666
1855;"Karrebæksminde";"no";0;1;1;55,183333;11,666666
1856;"Karrebæksminde";"no";0;6;6;55,183333;11,666666
1857;"Karrebæksminde";"no";0;0;0;55,183333;11,666666
1634;"Emmerleff";"no";0;0;0;54,982222;8,677222
1635;"Emmerleff";"no";0;0;0;54,982222;8,677222
1636;"Emmerleff";"no";0;0;0;54,982222;8,677222
1637;"Emmerleff";"no";0;0;0;54,982222;8,677222
1638;"Emmerleff";"no";0;0;0;54,982222;8,677222
1639;"Emmerleff";"no";0;0;0;54,982222;8,677222
1640;"Emmerleff";"no";0;0;0;54,982222;8,677222
1641;"Emmerleff";"no";0;0;0;54,982222;8,677222
1642;"Emmerleff";"no";0;0;0;54,982222;8,677222
1643;"Emmerleff";"no";0;0;0;54,982222;8,677222
1644;"Emmerleff";"no";0;0;0;54,982222;8,677222
1645;"Emmerleff";"no";0;0;0;54,982222;8,677222
1646;"Emmerleff";"no";0;0;0;54,982222;8,677222
1647;"Emmerleff";"no";0;0;0;54,982222;8,677222
1648;"Emmerleff";"no";0;0;0;54,982222;8,677222
1649;"Emmerleff";"no";0;0;0;54,982222;8,677222
1650;"Emmerleff";"no";0;0;0;54,982222;8,677222
1651;"Emmerleff";"no";0;0;0;54,982222;8,677222
1652;"Emmerleff";"no";0;0;0;54,982222;8,677222
1653;"Emmerleff";"no";0;0;0;54,982222;8,677222
1654;"Emmerleff";"no";0;0;0;54,982222;8,677222
1655;"Emmerleff";"no";0;0;0;54,982222;8,677222
1656;"Emmerleff";"no";0;0;0;54,982222;8,677222
1657;"Emmerleff";"no";0;0;0;54,982222;8,677222
1658;"Emmerleff";"no";0;0;0;54,982222;8,677222
1659;"Emmerleff";"no";0;0;0;54,982222;8,677222
1660;"Emmerleff";"no";0;0;0;54,982222;8,677222
1661;"Emmerleff";"no";0;0;0;54,982222;8,677222
1662;"Emmerleff";"no";0;0;0;54,982222;8,677222
1663;"Emmerleff";"no";0;0;0;54,982222;8,677222
1664;"Emmerleff";"no";0;0;0;54,982222;8,677222
1665;"Emmerleff";"no";0;0;0;54,982222;8,677222
1666;"Emmerleff";"no";0;0;0;54,982222;8,677222
1667;"Emmerleff";"no";0;0;0;54,982222;8,677222
1668;"Emmerleff";"no";0;0;0;54,982222;8,677222
1669;"Emmerleff";"no";0;0;0;54,982222;8,677222
1670;"Emmerleff";"no";0;0;0;54,982222;8,677222
1671;"Emmerleff";"no";0;0;0;54,982222;8,677222
1672;"Emmerleff";"no";0;0;0;54,982222;8,677222
1673;"Emmerleff";"no";0;0;0;54,982222;8,677222
1674;"Emmerleff";"no";0;0;0;54,982222;8,677222
1675;"Emmerleff";"no";0;0;0;54,982222;8,677222
1676;"Emmerleff";"no";0;0;0;54,982222;8,677222
1677;"Emmerleff";"no";0;0;0;54,982222;8,677222
1678;"Emmerleff";"no";0;0;0;54,982222;8,677222
1679;"Emmerleff";"no";0;0;0;54,982222;8,677222
1680;"Emmerleff";"no";0;0;0;54,982222;8,677222
1681;"Emmerleff";"no";0;0;0;54,982222;8,677222
1682;"Emmerleff";"no";0;0;0;54,982222;8,677222
1683;"Emmerleff";"no";0;0;0;54,982222;8,677222
1684;"Emmerleff";"no";0;0;0;54,982222;8,677222
1685;"Emmerleff";"no";0;0;0;54,982222;8,677222
1686;"Emmerleff";"no";0;0;0;54,982222;8,677222
1687;"Emmerleff";"no";0;0;0;54,982222;8,677222
1688;"Emmerleff";"no";0;0;0;54,982222;8,677222
1689;"Emmerleff";"no";0;0;0;54,982222;8,677222
1690;"Emmerleff";"no";0;0;0;54,982222;8,677222
1691;"Emmerleff";"no";0;0;0;54,982222;8,677222
1692;"Emmerleff";"no";0;0;0;54,982222;8,677222
1693;"Emmerleff";"no";0;0;0;54,982222;8,677222
1694;"Emmerleff";"no";1;0;1;54,982222;8,677222
1695;"Emmerleff";"no";0;0;0;54,982222;8,677222
1696;"Emmerleff";"no";0;0;0;54,982222;8,677222
1697;"Emmerleff";"no";0;0;0;54,982222;8,677222
1698;"Emmerleff";"no";0;0;0;54,982222;8,677222
1699;"Emmerleff";"no";0;0;0;54,982222;8,677222
1700;"Emmerleff";"no";0;0;0;54,982222;8,677222
1701;"Emmerleff";"no";0;0;0;54,982222;8,677222
1702;"Emmerleff";"no";0;0;0;54,982222;8,677222
1703;"Emmerleff";"no";0;0;0;54,982222;8,677222
1704;"Emmerleff";"no";0;0;0;54,982222;8,677222
1705;"Emmerleff";"no";0;0;0;54,982222;8,677222
1706;"Emmerleff";"no";0;0;0;54,982222;8,677222
1707;"Emmerleff";"no";0;0;0;54,982222;8,677222
1708;"Emmerleff";"no";0;0;0;54,982222;8,677222
1709;"Emmerleff";"no";0;0;0;54,982222;8,677222
1710;"Emmerleff";"no";0;0;0;54,982222;8,677222
1711;"Emmerleff";"no";0;0;0;54,982222;8,677222
1712;"Emmerleff";"no";0;0;0;54,982222;8,677222
1713;"Emmerleff";"no";0;0;0;54,982222;8,677222
1714;"Emmerleff";"no";0;0;0;54,982222;8,677222
1715;"Emmerleff";"no";0;0;0;54,982222;8,677222
1716;"Emmerleff";"no";0;0;0;54,982222;8,677222
1717;"Emmerleff";"no";0;0;0;54,982222;8,677222
1718;"Emmerleff";"no";0;0;0;54,982222;8,677222
1719;"Emmerleff";"no";0;0;0;54,982222;8,677222
1720;"Emmerleff";"no";0;0;0;54,982222;8,677222
1721;"Emmerleff";"no";0;0;0;54,982222;8,677222
1722;"Emmerleff";"no";0;0;0;54,982222;8,677222
1723;"Emmerleff";"no";0;0;0;54,982222;8,677222
1724;"Emmerleff";"no";0;0;0;54,982222;8,677222
1725;"Emmerleff";"no";0;0;0;54,982222;8,677222
1726;"Emmerleff";"no";0;0;0;54,982222;8,677222
1727;"Emmerleff";"no";0;0;0;54,982222;8,677222
1728;"Emmerleff";"no";0;0;0;54,982222;8,677222
1729;"Emmerleff";"no";0;0;0;54,982222;8,677222
1730;"Emmerleff";"no";0;0;0;54,982222;8,677222
1731;"Emmerleff";"no";0;0;0;54,982222;8,677222
1732;"Emmerleff";"no";0;0;0;54,982222;8,677222
1733;"Emmerleff";"no";0;0;0;54,982222;8,677222
1734;"Emmerleff";"no";0;0;0;54,982222;8,677222
1735;"Emmerleff";"no";0;0;0;54,982222;8,677222
1736;"Emmerleff";"no";0;0;0;54,982222;8,677222
1737;"Emmerleff";"no";0;0;0;54,982222;8,677222
1738;"Emmerleff";"no";0;0;0;54,982222;8,677222
1739;"Emmerleff";"no";0;0;0;54,982222;8,677222
1740;"Emmerleff";"no";0;0;0;54,982222;8,677222
1741;"Emmerleff";"no";0;0;0;54,982222;8,677222
1742;"Emmerleff";"no";0;0;0;54,982222;8,677222
1743;"Emmerleff";"no";0;0;0;54,982222;8,677222
1744;"Emmerleff";"no";0;0;0;54,982222;8,677222
1745;"Emmerleff";"no";0;0;0;54,982222;8,677222
1746;"Emmerleff";"no";0;0;0;54,982222;8,677222
1747;"Emmerleff";"no";0;0;0;54,982222;8,677222
1748;"Emmerleff";"no";0;0;0;54,982222;8,677222
1749;"Emmerleff";"no";0;0;0;54,982222;8,677222
1750;"Emmerleff";"no";0;0;0;54,982222;8,677222
1751;"Emmerleff";"no";0;0;0;54,982222;8,677222
1752;"Emmerleff";"no";0;0;0;54,982222;8,677222
1753;"Emmerleff";"no";0;0;0;54,982222;8,677222
1754;"Emmerleff";"no";0;0;0;54,982222;8,677222
1755;"Emmerleff";"no";0;0;0;54,982222;8,677222
1756;"Emmerleff";"no";0;0;0;54,982222;8,677222
1757;"Emmerleff";"no";0;0;0;54,982222;8,677222
1758;"Emmerleff";"no";0;0;0;54,982222;8,677222
1759;"Emmerleff";"no";1;0;1;54,982222;8,677222
1760;"Emmerleff";"no";0;0;0;54,982222;8,677222
1761;"Emmerleff";"no";0;0;0;54,982222;8,677222
1762;"Emmerleff";"no";0;0;0;54,982222;8,677222
1763;"Emmerleff";"no";0;0;0;54,982222;8,677222
1764;"Emmerleff";"no";0;0;0;54,982222;8,677222
1765;"Emmerleff";"no";0;0;0;54,982222;8,677222
1766;"Emmerleff";"no";0;0;0;54,982222;8,677222
1767;"Emmerleff";"no";0;0;0;54,982222;8,677222
1768;"Emmerleff";"no";0;0;0;54,982222;8,677222
1769;"Emmerleff";"no";0;0;0;54,982222;8,677222
1770;"Emmerleff";"no";0;0;0;54,982222;8,677222
1771;"Emmerleff";"no";0;0;0;54,982222;8,677222
1772;"Emmerleff";"no";0;0;0;54,982222;8,677222
1773;"Emmerleff";"no";0;0;0;54,982222;8,677222
1774;"Emmerleff";"no";0;0;0;54,982222;8,677222
1775;"Emmerleff";"no";0;0;0;54,982222;8,677222
1776;"Emmerleff";"no";0;0;0;54,982222;8,677222
1777;"Emmerleff";"no";0;0;0;54,982222;8,677222
1778;"Emmerleff";"no";0;0;0;54,982222;8,677222
1779;"Emmerleff";"no";0;0;0;54,982222;8,677222
1780;"Emmerleff";"no";0;0;0;54,982222;8,677222
1781;"Emmerleff";"no";0;0;0;54,982222;8,677222
1782;"Emmerleff";"no";0;0;0;54,982222;8,677222
1783;"Emmerleff";"no";0;0;0;54,982222;8,677222
1784;"Emmerleff";"no";0;0;0;54,982222;8,677222
1785;"Emmerleff";"no";0;0;0;54,982222;8,677222
1786;"Emmerleff";"no";0;0;0;54,982222;8,677222
1787;"Emmerleff";"no";0;0;0;54,982222;8,677222
1788;"Emmerleff";"no";0;0;0;54,982222;8,677222
1789;"Emmerleff";"no";0;0;0;54,982222;8,677222
1790;"Emmerleff";"no";0;0;0;54,982222;8,677222
1791;"Emmerleff";"no";0;0;0;54,982222;8,677222
1792;"Emmerleff";"no";0;0;0;54,982222;8,677222
1793;"Emmerleff";"no";0;0;0;54,982222;8,677222
1794;"Emmerleff";"no";0;0;0;54,982222;8,677222
1795;"Emmerleff";"no";0;0;0;54,982222;8,677222
1796;"Emmerleff";"no";0;0;0;54,982222;8,677222
1797;"Emmerleff";"no";0;0;0;54,982222;8,677222
1798;"Emmerleff";"no";0;0;0;54,982222;8,677222
1799;"Emmerleff";"no";0;0;0;54,982222;8,677222
1800;"Emmerleff";"no";0;0;0;54,982222;8,677222
1801;"Emmerleff";"no";0;0;0;54,982222;8,677222
1802;"Emmerleff";"no";0;0;0;54,982222;8,677222
1803;"Emmerleff";"no";0;0;0;54,982222;8,677222
1804;"Emmerleff";"no";0;0;0;54,982222;8,677222
1805;"Emmerleff";"no";0;0;0;54,982222;8,677222
1806;"Emmerleff";"no";0;0;0;54,982222;8,677222
1807;"Emmerleff";"no";0;0;0;54,982222;8,677222
1808;"Emmerleff";"no";0;0;0;54,982222;8,677222
1809;"Emmerleff";"no";0;0;0;54,982222;8,677222
1810;"Emmerleff";"no";0;0;0;54,982222;8,677222
1811;"Emmerleff";"no";0;0;0;54,982222;8,677222
1812;"Emmerleff";"no";0;0;0;54,982222;8,677222
1813;"Emmerleff";"no";0;0;0;54,982222;8,677222
1814;"Emmerleff";"no";0;0;0;54,982222;8,677222
1815;"Emmerleff";"no";0;0;0;54,982222;8,677222
1816;"Emmerleff";"no";0;0;0;54,982222;8,677222
1817;"Emmerleff";"no";0;0;0;54,982222;8,677222
1818;"Emmerleff";"no";0;0;0;54,982222;8,677222
1819;"Emmerleff";"no";0;0;0;54,982222;8,677222
1820;"Emmerleff";"no";0;0;0;54,982222;8,677222
1821;"Emmerleff";"no";0;0;0;54,982222;8,677222
1822;"Emmerleff";"no";0;0;0;54,982222;8,677222
1823;"Emmerleff";"no";0;0;0;54,982222;8,677222
1824;"Emmerleff";"no";0;0;0;54,982222;8,677222
1825;"Emmerleff";"no";0;0;0;54,982222;8,677222
1826;"Emmerleff";"no";0;0;0;54,982222;8,677222
1827;"Emmerleff";"no";0;0;0;54,982222;8,677222
1828;"Emmerleff";"no";0;0;0;54,982222;8,677222
1829;"Emmerleff";"no";0;0;0;54,982222;8,677222
1830;"Emmerleff";"no";0;0;0;54,982222;8,677222
1831;"Emmerleff";"no";0;0;0;54,982222;8,677222
1832;"Emmerleff";"no";0;0;0;54,982222;8,677222
1833;"Emmerleff";"no";0;0;0;54,982222;8,677222
1834;"Emmerleff";"no";0;0;0;54,982222;8,677222
1835;"Emmerleff";"no";0;0;0;54,982222;8,677222
1836;"Emmerleff";"no";0;0;0;54,982222;8,677222
1837;"Emmerleff";"no";0;0;0;54,982222;8,677222
1838;"Emmerleff";"no";0;0;0;54,982222;8,677222
1839;"Emmerleff";"no";0;0;0;54,982222;8,677222
1840;"Emmerleff";"no";0;0;0;54,982222;8,677222
1841;"Emmerleff";"no";0;0;0;54,982222;8,677222
1842;"Emmerleff";"no";0;0;0;54,982222;8,677222
1843;"Emmerleff";"no";0;0;0;54,982222;8,677222
1844;"Emmerleff";"no";0;0;0;54,982222;8,677222
1845;"Emmerleff";"no";0;0;0;54,982222;8,677222
1846;"Emmerleff";"no";0;0;0;54,982222;8,677222
1847;"Emmerleff";"no";0;0;0;54,982222;8,677222
1848;"Emmerleff";"no";0;0;0;54,982222;8,677222
1849;"Emmerleff";"no";0;0;0;54,982222;8,677222
1850;"Emmerleff";"no";0;0;0;54,982222;8,677222
1851;"Emmerleff";"no";0;0;0;54,982222;8,677222
1852;"Emmerleff";"no";0;0;0;54,982222;8,677222
1853;"Emmerleff";"no";0;0;0;54,982222;8,677222
1854;"Emmerleff";"no";0;0;0;54,982222;8,677222
1855;"Emmerleff";"no";0;0;0;54,982222;8,677222
1856;"Emmerleff";"no";0;0;0;54,982222;8,677222
1857;"Emmerleff";"no";0;0;0;54,982222;8,677222
1634;"Haderslev";"no";0;0;0;55,253611;9,489722
1635;"Haderslev";"no";0;0;0;55,253611;9,489722
1636;"Haderslev";"no";0;0;0;55,253611;9,489722
1637;"Haderslev";"no";0;0;0;55,253611;9,489722
1638;"Haderslev";"no";0;0;0;55,253611;9,489722
1639;"Haderslev";"no";0;0;0;55,253611;9,489722
1640;"Haderslev";"no";0;0;0;55,253611;9,489722
1641;"Haderslev";"no";0;0;0;55,253611;9,489722
1642;"Haderslev";"no";0;0;0;55,253611;9,489722
1643;"Haderslev";"no";0;0;0;55,253611;9,489722
1644;"Haderslev";"no";0;0;0;55,253611;9,489722
1645;"Haderslev";"no";0;0;0;55,253611;9,489722
1646;"Haderslev";"no";0;0;0;55,253611;9,489722
1647;"Haderslev";"no";0;0;0;55,253611;9,489722
1648;"Haderslev";"no";0;0;0;55,253611;9,489722
1649;"Haderslev";"no";0;0;0;55,253611;9,489722
1650;"Haderslev";"no";0;0;0;55,253611;9,489722
1651;"Haderslev";"no";0;0;0;55,253611;9,489722
1652;"Haderslev";"no";0;0;0;55,253611;9,489722
1653;"Haderslev";"no";0;0;0;55,253611;9,489722
1654;"Haderslev";"no";0;0;0;55,253611;9,489722
1655;"Haderslev";"no";0;0;0;55,253611;9,489722
1656;"Haderslev";"no";0;0;0;55,253611;9,489722
1657;"Haderslev";"no";0;0;0;55,253611;9,489722
1658;"Haderslev";"no";0;0;0;55,253611;9,489722
1659;"Haderslev";"no";0;0;0;55,253611;9,489722
1660;"Haderslev";"no";0;0;0;55,253611;9,489722
1661;"Haderslev";"no";0;0;0;55,253611;9,489722
1662;"Haderslev";"no";0;0;0;55,253611;9,489722
1663;"Haderslev";"no";0;0;0;55,253611;9,489722
1664;"Haderslev";"no";0;0;0;55,253611;9,489722
1665;"Haderslev";"no";0;0;0;55,253611;9,489722
1666;"Haderslev";"no";0;0;0;55,253611;9,489722
1667;"Haderslev";"no";0;0;0;55,253611;9,489722
1668;"Haderslev";"no";0;0;0;55,253611;9,489722
1669;"Haderslev";"no";0;0;0;55,253611;9,489722
1670;"Haderslev";"no";0;0;0;55,253611;9,489722
1671;"Haderslev";"no";0;0;0;55,253611;9,489722
1672;"Haderslev";"no";0;0;0;55,253611;9,489722
1673;"Haderslev";"no";0;0;0;55,253611;9,489722
1674;"Haderslev";"no";0;0;0;55,253611;9,489722
1675;"Haderslev";"no";0;0;0;55,253611;9,489722
1676;"Haderslev";"no";0;0;0;55,253611;9,489722
1677;"Haderslev";"no";0;0;0;55,253611;9,489722
1678;"Haderslev";"no";0;0;0;55,253611;9,489722
1679;"Haderslev";"no";0;0;0;55,253611;9,489722
1680;"Haderslev";"no";0;0;0;55,253611;9,489722
1681;"Haderslev";"no";0;0;0;55,253611;9,489722
1682;"Haderslev";"no";0;0;0;55,253611;9,489722
1683;"Haderslev";"no";0;0;0;55,253611;9,489722
1684;"Haderslev";"no";0;0;0;55,253611;9,489722
1685;"Haderslev";"no";0;0;0;55,253611;9,489722
1686;"Haderslev";"no";0;0;0;55,253611;9,489722
1687;"Haderslev";"no";0;0;0;55,253611;9,489722
1688;"Haderslev";"no";0;0;0;55,253611;9,489722
1689;"Haderslev";"no";0;0;0;55,253611;9,489722
1690;"Haderslev";"no";0;0;0;55,253611;9,489722
1691;"Haderslev";"no";0;0;0;55,253611;9,489722
1692;"Haderslev";"no";0;0;0;55,253611;9,489722
1693;"Haderslev";"no";0;0;0;55,253611;9,489722
1694;"Haderslev";"no";0;0;0;55,253611;9,489722
1695;"Haderslev";"no";1;0;1;55,253611;9,489722
1696;"Haderslev";"no";0;0;0;55,253611;9,489722
1697;"Haderslev";"no";0;0;0;55,253611;9,489722
1698;"Haderslev";"no";0;0;0;55,253611;9,489722
1699;"Haderslev";"no";0;0;0;55,253611;9,489722
1700;"Haderslev";"no";0;0;0;55,253611;9,489722
1701;"Haderslev";"no";0;0;0;55,253611;9,489722
1702;"Haderslev";"no";0;0;0;55,253611;9,489722
1703;"Haderslev";"no";0;0;0;55,253611;9,489722
1704;"Haderslev";"no";0;0;0;55,253611;9,489722
1705;"Haderslev";"no";0;0;0;55,253611;9,489722
1706;"Haderslev";"no";0;0;0;55,253611;9,489722
1707;"Haderslev";"no";0;0;0;55,253611;9,489722
1708;"Haderslev";"no";0;0;0;55,253611;9,489722
1709;"Haderslev";"no";0;0;0;55,253611;9,489722
1710;"Haderslev";"no";0;0;0;55,253611;9,489722
1711;"Haderslev";"no";0;0;0;55,253611;9,489722
1712;"Haderslev";"no";0;0;0;55,253611;9,489722
1713;"Haderslev";"no";0;0;0;55,253611;9,489722
1714;"Haderslev";"no";0;0;0;55,253611;9,489722
1715;"Haderslev";"no";0;0;0;55,253611;9,489722
1716;"Haderslev";"no";0;0;0;55,253611;9,489722
1717;"Haderslev";"no";0;1;1;55,253611;9,489722
1718;"Haderslev";"no";0;0;0;55,253611;9,489722
1719;"Haderslev";"no";0;0;0;55,253611;9,489722
1720;"Haderslev";"no";0;0;0;55,253611;9,489722
1721;"Haderslev";"no";0;0;0;55,253611;9,489722
1722;"Haderslev";"no";0;1;1;55,253611;9,489722
1723;"Haderslev";"no";0;0;0;55,253611;9,489722
1724;"Haderslev";"no";0;0;0;55,253611;9,489722
1725;"Haderslev";"no";0;0;0;55,253611;9,489722
1726;"Haderslev";"no";0;0;0;55,253611;9,489722
1727;"Haderslev";"no";0;0;0;55,253611;9,489722
1728;"Haderslev";"no";0;0;0;55,253611;9,489722
1729;"Haderslev";"no";0;0;0;55,253611;9,489722
1730;"Haderslev";"no";0;0;0;55,253611;9,489722
1731;"Haderslev";"no";0;0;0;55,253611;9,489722
1732;"Haderslev";"no";0;0;0;55,253611;9,489722
1733;"Haderslev";"no";0;0;0;55,253611;9,489722
1734;"Haderslev";"no";0;0;0;55,253611;9,489722
1735;"Haderslev";"no";0;0;0;55,253611;9,489722
1736;"Haderslev";"no";0;0;0;55,253611;9,489722
1737;"Haderslev";"no";0;0;0;55,253611;9,489722
1738;"Haderslev";"no";0;0;0;55,253611;9,489722
1739;"Haderslev";"no";0;0;0;55,253611;9,489722
1740;"Haderslev";"no";0;0;0;55,253611;9,489722
1741;"Haderslev";"no";0;0;0;55,253611;9,489722
1742;"Haderslev";"no";0;0;0;55,253611;9,489722
1743;"Haderslev";"no";0;0;0;55,253611;9,489722
1744;"Haderslev";"no";0;0;0;55,253611;9,489722
1745;"Haderslev";"no";0;0;0;55,253611;9,489722
1746;"Haderslev";"no";0;0;0;55,253611;9,489722
1747;"Haderslev";"no";0;0;0;55,253611;9,489722
1748;"Haderslev";"no";0;0;0;55,253611;9,489722
1749;"Haderslev";"no";0;0;0;55,253611;9,489722
1750;"Haderslev";"no";0;0;0;55,253611;9,489722
1751;"Haderslev";"no";0;0;0;55,253611;9,489722
1752;"Haderslev";"no";0;0;0;55,253611;9,489722
1753;"Haderslev";"no";0;1;1;55,253611;9,489722
1754;"Haderslev";"no";0;0;0;55,253611;9,489722
1755;"Haderslev";"no";0;0;0;55,253611;9,489722
1756;"Haderslev";"no";0;0;0;55,253611;9,489722
1757;"Haderslev";"no";0;0;0;55,253611;9,489722
1758;"Haderslev";"no";0;0;0;55,253611;9,489722
1759;"Haderslev";"no";0;0;0;55,253611;9,489722
1760;"Haderslev";"no";0;0;0;55,253611;9,489722
1761;"Haderslev";"no";0;0;0;55,253611;9,489722
1762;"Haderslev";"no";0;0;0;55,253611;9,489722
1763;"Haderslev";"no";0;0;0;55,253611;9,489722
1764;"Haderslev";"no";0;0;0;55,253611;9,489722
1765;"Haderslev";"no";0;0;0;55,253611;9,489722
1766;"Haderslev";"no";0;0;0;55,253611;9,489722
1767;"Haderslev";"no";0;0;0;55,253611;9,489722
1768;"Haderslev";"no";0;0;0;55,253611;9,489722
1769;"Haderslev";"no";0;0;0;55,253611;9,489722
1770;"Haderslev";"no";0;0;0;55,253611;9,489722
1771;"Haderslev";"no";0;0;0;55,253611;9,489722
1772;"Haderslev";"no";0;0;0;55,253611;9,489722
1773;"Haderslev";"no";0;0;0;55,253611;9,489722
1774;"Haderslev";"no";0;0;0;55,253611;9,489722
1775;"Haderslev";"no";0;0;0;55,253611;9,489722
1776;"Haderslev";"no";0;0;0;55,253611;9,489722
1777;"Haderslev";"no";0;0;0;55,253611;9,489722
1778;"Haderslev";"no";0;0;0;55,253611;9,489722
1779;"Haderslev";"no";0;0;0;55,253611;9,489722
1780;"Haderslev";"no";0;0;0;55,253611;9,489722
1781;"Haderslev";"no";0;0;0;55,253611;9,489722
1782;"Haderslev";"no";0;1;1;55,253611;9,489722
1783;"Haderslev";"no";0;0;0;55,253611;9,489722
1784;"Haderslev";"no";0;1;1;55,253611;9,489722
1785;"Haderslev";"no";1;0;1;55,253611;9,489722
1786;"Haderslev";"no";0;0;0;55,253611;9,489722
1787;"Haderslev";"no";0;0;0;55,253611;9,489722
1788;"Haderslev";"no";0;0;0;55,253611;9,489722
1789;"Haderslev";"no";0;0;0;55,253611;9,489722
1790;"Haderslev";"no";0;0;0;55,253611;9,489722
1791;"Haderslev";"no";0;0;0;55,253611;9,489722
1792;"Haderslev";"no";0;0;0;55,253611;9,489722
1793;"Haderslev";"no";0;0;0;55,253611;9,489722
1794;"Haderslev";"no";0;0;0;55,253611;9,489722
1795;"Haderslev";"no";0;0;0;55,253611;9,489722
1796;"Haderslev";"no";0;0;0;55,253611;9,489722
1797;"Haderslev";"no";0;0;0;55,253611;9,489722
1798;"Haderslev";"no";0;0;0;55,253611;9,489722
1799;"Haderslev";"no";0;0;0;55,253611;9,489722
1800;"Haderslev";"no";0;0;0;55,253611;9,489722
1801;"Haderslev";"no";0;0;0;55,253611;9,489722
1802;"Haderslev";"no";0;0;0;55,253611;9,489722
1803;"Haderslev";"no";0;0;0;55,253611;9,489722
1804;"Haderslev";"no";0;0;0;55,253611;9,489722
1805;"Haderslev";"no";0;0;0;55,253611;9,489722
1806;"Haderslev";"no";0;0;0;55,253611;9,489722
1807;"Haderslev";"no";0;0;0;55,253611;9,489722
1808;"Haderslev";"no";0;0;0;55,253611;9,489722
1809;"Haderslev";"no";0;0;0;55,253611;9,489722
1810;"Haderslev";"no";0;0;0;55,253611;9,489722
1811;"Haderslev";"no";0;0;0;55,253611;9,489722
1812;"Haderslev";"no";0;0;0;55,253611;9,489722
1813;"Haderslev";"no";0;0;0;55,253611;9,489722
1814;"Haderslev";"no";0;0;0;55,253611;9,489722
1815;"Haderslev";"no";0;0;0;55,253611;9,489722
1816;"Haderslev";"no";0;0;0;55,253611;9,489722
1817;"Haderslev";"no";0;1;1;55,253611;9,489722
1818;"Haderslev";"no";0;0;0;55,253611;9,489722
1819;"Haderslev";"no";0;0;0;55,253611;9,489722
1820;"Haderslev";"no";0;0;0;55,253611;9,489722
1821;"Haderslev";"no";0;0;0;55,253611;9,489722
1822;"Haderslev";"no";0;0;0;55,253611;9,489722
1823;"Haderslev";"no";0;0;0;55,253611;9,489722
1824;"Haderslev";"no";0;0;0;55,253611;9,489722
1825;"Haderslev";"no";0;0;0;55,253611;9,489722
1826;"Haderslev";"no";0;0;0;55,253611;9,489722
1827;"Haderslev";"no";0;0;0;55,253611;9,489722
1828;"Haderslev";"no";0;0;0;55,253611;9,489722
1829;"Haderslev";"no";0;0;0;55,253611;9,489722
1830;"Haderslev";"no";0;1;1;55,253611;9,489722
1831;"Haderslev";"no";0;0;0;55,253611;9,489722
1832;"Haderslev";"no";0;0;0;55,253611;9,489722
1833;"Haderslev";"no";0;0;0;55,253611;9,489722
1834;"Haderslev";"no";0;0;0;55,253611;9,489722
1835;"Haderslev";"no";0;0;0;55,253611;9,489722
1836;"Haderslev";"no";0;0;0;55,253611;9,489722
1837;"Haderslev";"no";0;0;0;55,253611;9,489722
1838;"Haderslev";"no";0;0;0;55,253611;9,489722
1839;"Haderslev";"no";0;0;0;55,253611;9,489722
1840;"Haderslev";"no";0;0;0;55,253611;9,489722
1841;"Haderslev";"no";0;0;0;55,253611;9,489722
1842;"Haderslev";"no";0;0;0;55,253611;9,489722
1843;"Haderslev";"no";0;0;0;55,253611;9,489722
1844;"Haderslev";"no";0;0;0;55,253611;9,489722
1845;"Haderslev";"no";0;0;0;55,253611;9,489722
1846;"Haderslev";"no";0;1;1;55,253611;9,489722
1847;"Haderslev";"no";0;0;0;55,253611;9,489722
1848;"Haderslev";"no";0;0;0;55,253611;9,489722
1849;"Haderslev";"no";0;0;0;55,253611;9,489722
1850;"Haderslev";"no";0;0;0;55,253611;9,489722
1851;"Haderslev";"no";2;0;2;55,253611;9,489722
1852;"Haderslev";"no";1;0;1;55,253611;9,489722
1853;"Haderslev";"no";0;0;0;55,253611;9,489722
1854;"Haderslev";"no";0;0;0;55,253611;9,489722
1855;"Haderslev";"no";0;0;0;55,253611;9,489722
1856;"Haderslev";"no";0;0;0;55,253611;9,489722
1857;"Haderslev";"no";0;0;0;55,253611;9,489722
1634;"Dragsminde";"no";0;0;0;54,678333;11,308611
1635;"Dragsminde";"no";0;0;0;54,678333;11,308611
1636;"Dragsminde";"no";0;0;0;54,678333;11,308611
1637;"Dragsminde";"no";0;0;0;54,678333;11,308611
1638;"Dragsminde";"no";0;0;0;54,678333;11,308611
1639;"Dragsminde";"no";0;0;0;54,678333;11,308611
1640;"Dragsminde";"no";0;0;0;54,678333;11,308611
1641;"Dragsminde";"no";0;0;0;54,678333;11,308611
1642;"Dragsminde";"no";0;0;0;54,678333;11,308611
1643;"Dragsminde";"no";0;0;0;54,678333;11,308611
1644;"Dragsminde";"no";0;0;0;54,678333;11,308611
1645;"Dragsminde";"no";0;0;0;54,678333;11,308611
1646;"Dragsminde";"no";0;0;0;54,678333;11,308611
1647;"Dragsminde";"no";0;0;0;54,678333;11,308611
1648;"Dragsminde";"no";0;0;0;54,678333;11,308611
1649;"Dragsminde";"no";0;0;0;54,678333;11,308611
1650;"Dragsminde";"no";0;0;0;54,678333;11,308611
1651;"Dragsminde";"no";0;0;0;54,678333;11,308611
1652;"Dragsminde";"no";0;0;0;54,678333;11,308611
1653;"Dragsminde";"no";0;0;0;54,678333;11,308611
1654;"Dragsminde";"no";0;0;0;54,678333;11,308611
1655;"Dragsminde";"no";0;0;0;54,678333;11,308611
1656;"Dragsminde";"no";0;0;0;54,678333;11,308611
1657;"Dragsminde";"no";0;0;0;54,678333;11,308611
1658;"Dragsminde";"no";0;0;0;54,678333;11,308611
1659;"Dragsminde";"no";0;0;0;54,678333;11,308611
1660;"Dragsminde";"no";0;0;0;54,678333;11,308611
1661;"Dragsminde";"no";0;0;0;54,678333;11,308611
1662;"Dragsminde";"no";0;0;0;54,678333;11,308611
1663;"Dragsminde";"no";0;0;0;54,678333;11,308611
1664;"Dragsminde";"no";0;0;0;54,678333;11,308611
1665;"Dragsminde";"no";0;0;0;54,678333;11,308611
1666;"Dragsminde";"no";0;0;0;54,678333;11,308611
1667;"Dragsminde";"no";0;0;0;54,678333;11,308611
1668;"Dragsminde";"no";0;0;0;54,678333;11,308611
1669;"Dragsminde";"no";0;0;0;54,678333;11,308611
1670;"Dragsminde";"no";0;0;0;54,678333;11,308611
1671;"Dragsminde";"no";0;0;0;54,678333;11,308611
1672;"Dragsminde";"no";0;0;0;54,678333;11,308611
1673;"Dragsminde";"no";0;0;0;54,678333;11,308611
1674;"Dragsminde";"no";0;0;0;54,678333;11,308611
1675;"Dragsminde";"no";0;0;0;54,678333;11,308611
1676;"Dragsminde";"no";0;0;0;54,678333;11,308611
1677;"Dragsminde";"no";0;0;0;54,678333;11,308611
1678;"Dragsminde";"no";0;0;0;54,678333;11,308611
1679;"Dragsminde";"no";0;0;0;54,678333;11,308611
1680;"Dragsminde";"no";0;0;0;54,678333;11,308611
1681;"Dragsminde";"no";0;0;0;54,678333;11,308611
1682;"Dragsminde";"no";0;0;0;54,678333;11,308611
1683;"Dragsminde";"no";0;0;0;54,678333;11,308611
1684;"Dragsminde";"no";0;0;0;54,678333;11,308611
1685;"Dragsminde";"no";0;0;0;54,678333;11,308611
1686;"Dragsminde";"no";0;0;0;54,678333;11,308611
1687;"Dragsminde";"no";0;0;0;54,678333;11,308611
1688;"Dragsminde";"no";0;0;0;54,678333;11,308611
1689;"Dragsminde";"no";0;0;0;54,678333;11,308611
1690;"Dragsminde";"no";0;0;0;54,678333;11,308611
1691;"Dragsminde";"no";0;0;0;54,678333;11,308611
1692;"Dragsminde";"no";0;0;0;54,678333;11,308611
1693;"Dragsminde";"no";0;0;0;54,678333;11,308611
1694;"Dragsminde";"no";0;0;0;54,678333;11,308611
1695;"Dragsminde";"no";0;0;0;54,678333;11,308611
1696;"Dragsminde";"no";0;0;0;54,678333;11,308611
1697;"Dragsminde";"no";0;0;0;54,678333;11,308611
1698;"Dragsminde";"no";0;0;0;54,678333;11,308611
1699;"Dragsminde";"no";0;0;0;54,678333;11,308611
1700;"Dragsminde";"no";0;0;0;54,678333;11,308611
1701;"Dragsminde";"no";0;0;0;54,678333;11,308611
1702;"Dragsminde";"no";0;0;0;54,678333;11,308611
1703;"Dragsminde";"no";0;0;0;54,678333;11,308611
1704;"Dragsminde";"no";0;0;0;54,678333;11,308611
1705;"Dragsminde";"no";0;0;0;54,678333;11,308611
1706;"Dragsminde";"no";1;0;1;54,678333;11,308611
1707;"Dragsminde";"no";0;0;0;54,678333;11,308611
1708;"Dragsminde";"no";0;0;0;54,678333;11,308611
1709;"Dragsminde";"no";0;0;0;54,678333;11,308611
1710;"Dragsminde";"no";0;0;0;54,678333;11,308611
1711;"Dragsminde";"no";0;0;0;54,678333;11,308611
1712;"Dragsminde";"no";0;0;0;54,678333;11,308611
1713;"Dragsminde";"no";0;0;0;54,678333;11,308611
1714;"Dragsminde";"no";0;0;0;54,678333;11,308611
1715;"Dragsminde";"no";0;0;0;54,678333;11,308611
1716;"Dragsminde";"no";0;0;0;54,678333;11,308611
1717;"Dragsminde";"no";0;0;0;54,678333;11,308611
1718;"Dragsminde";"no";0;0;0;54,678333;11,308611
1719;"Dragsminde";"no";0;0;0;54,678333;11,308611
1720;"Dragsminde";"no";0;0;0;54,678333;11,308611
1721;"Dragsminde";"no";0;0;0;54,678333;11,308611
1722;"Dragsminde";"no";0;0;0;54,678333;11,308611
1723;"Dragsminde";"no";0;0;0;54,678333;11,308611
1724;"Dragsminde";"no";0;0;0;54,678333;11,308611
1725;"Dragsminde";"no";0;0;0;54,678333;11,308611
1726;"Dragsminde";"no";0;0;0;54,678333;11,308611
1727;"Dragsminde";"no";0;0;0;54,678333;11,308611
1728;"Dragsminde";"no";0;0;0;54,678333;11,308611
1729;"Dragsminde";"no";0;0;0;54,678333;11,308611
1730;"Dragsminde";"no";0;0;0;54,678333;11,308611
1731;"Dragsminde";"no";0;0;0;54,678333;11,308611
1732;"Dragsminde";"no";0;0;0;54,678333;11,308611
1733;"Dragsminde";"no";0;0;0;54,678333;11,308611
1734;"Dragsminde";"no";0;0;0;54,678333;11,308611
1735;"Dragsminde";"no";0;0;0;54,678333;11,308611
1736;"Dragsminde";"no";0;0;0;54,678333;11,308611
1737;"Dragsminde";"no";0;0;0;54,678333;11,308611
1738;"Dragsminde";"no";0;0;0;54,678333;11,308611
1739;"Dragsminde";"no";0;0;0;54,678333;11,308611
1740;"Dragsminde";"no";0;0;0;54,678333;11,308611
1741;"Dragsminde";"no";0;0;0;54,678333;11,308611
1742;"Dragsminde";"no";0;0;0;54,678333;11,308611
1743;"Dragsminde";"no";0;0;0;54,678333;11,308611
1744;"Dragsminde";"no";0;0;0;54,678333;11,308611
1745;"Dragsminde";"no";0;0;0;54,678333;11,308611
1746;"Dragsminde";"no";0;0;0;54,678333;11,308611
1747;"Dragsminde";"no";0;0;0;54,678333;11,308611
1748;"Dragsminde";"no";0;0;0;54,678333;11,308611
1749;"Dragsminde";"no";0;0;0;54,678333;11,308611
1750;"Dragsminde";"no";0;0;0;54,678333;11,308611
1751;"Dragsminde";"no";0;0;0;54,678333;11,308611
1752;"Dragsminde";"no";0;0;0;54,678333;11,308611
1753;"Dragsminde";"no";0;0;0;54,678333;11,308611
1754;"Dragsminde";"no";0;0;0;54,678333;11,308611
1755;"Dragsminde";"no";0;1;1;54,678333;11,308611
1756;"Dragsminde";"no";0;0;0;54,678333;11,308611
1757;"Dragsminde";"no";0;0;0;54,678333;11,308611
1758;"Dragsminde";"no";0;0;0;54,678333;11,308611
1759;"Dragsminde";"no";0;0;0;54,678333;11,308611
1760;"Dragsminde";"no";0;0;0;54,678333;11,308611
1761;"Dragsminde";"no";0;0;0;54,678333;11,308611
1762;"Dragsminde";"no";0;0;0;54,678333;11,308611
1763;"Dragsminde";"no";0;0;0;54,678333;11,308611
1764;"Dragsminde";"no";0;0;0;54,678333;11,308611
1765;"Dragsminde";"no";0;0;0;54,678333;11,308611
1766;"Dragsminde";"no";0;0;0;54,678333;11,308611
1767;"Dragsminde";"no";0;0;0;54,678333;11,308611
1768;"Dragsminde";"no";0;0;0;54,678333;11,308611
1769;"Dragsminde";"no";0;0;0;54,678333;11,308611
1770;"Dragsminde";"no";0;0;0;54,678333;11,308611
1771;"Dragsminde";"no";0;0;0;54,678333;11,308611
1772;"Dragsminde";"no";0;0;0;54,678333;11,308611
1773;"Dragsminde";"no";0;0;0;54,678333;11,308611
1774;"Dragsminde";"no";0;0;0;54,678333;11,308611
1775;"Dragsminde";"no";0;0;0;54,678333;11,308611
1776;"Dragsminde";"no";0;0;0;54,678333;11,308611
1777;"Dragsminde";"no";0;0;0;54,678333;11,308611
1778;"Dragsminde";"no";0;0;0;54,678333;11,308611
1779;"Dragsminde";"no";0;0;0;54,678333;11,308611
1780;"Dragsminde";"no";0;0;0;54,678333;11,308611
1781;"Dragsminde";"no";0;0;0;54,678333;11,308611
1782;"Dragsminde";"no";0;0;0;54,678333;11,308611
1783;"Dragsminde";"no";0;0;0;54,678333;11,308611
1784;"Dragsminde";"no";0;0;0;54,678333;11,308611
1785;"Dragsminde";"no";0;0;0;54,678333;11,308611
1786;"Dragsminde";"no";0;0;0;54,678333;11,308611
1787;"Dragsminde";"no";0;0;0;54,678333;11,308611
1788;"Dragsminde";"no";0;0;0;54,678333;11,308611
1789;"Dragsminde";"no";0;0;0;54,678333;11,308611
1790;"Dragsminde";"no";0;0;0;54,678333;11,308611
1791;"Dragsminde";"no";0;0;0;54,678333;11,308611
1792;"Dragsminde";"no";0;0;0;54,678333;11,308611
1793;"Dragsminde";"no";0;0;0;54,678333;11,308611
1794;"Dragsminde";"no";0;0;0;54,678333;11,308611
1795;"Dragsminde";"no";0;0;0;54,678333;11,308611
1796;"Dragsminde";"no";0;0;0;54,678333;11,308611
1797;"Dragsminde";"no";0;0;0;54,678333;11,308611
1798;"Dragsminde";"no";0;0;0;54,678333;11,308611
1799;"Dragsminde";"no";0;0;0;54,678333;11,308611
1800;"Dragsminde";"no";0;0;0;54,678333;11,308611
1801;"Dragsminde";"no";0;0;0;54,678333;11,308611
1802;"Dragsminde";"no";0;0;0;54,678333;11,308611
1803;"Dragsminde";"no";0;0;0;54,678333;11,308611
1804;"Dragsminde";"no";0;0;0;54,678333;11,308611
1805;"Dragsminde";"no";0;0;0;54,678333;11,308611
1806;"Dragsminde";"no";0;0;0;54,678333;11,308611
1807;"Dragsminde";"no";0;0;0;54,678333;11,308611
1808;"Dragsminde";"no";0;0;0;54,678333;11,308611
1809;"Dragsminde";"no";0;0;0;54,678333;11,308611
1810;"Dragsminde";"no";0;0;0;54,678333;11,308611
1811;"Dragsminde";"no";0;0;0;54,678333;11,308611
1812;"Dragsminde";"no";0;0;0;54,678333;11,308611
1813;"Dragsminde";"no";0;0;0;54,678333;11,308611
1814;"Dragsminde";"no";0;0;0;54,678333;11,308611
1815;"Dragsminde";"no";0;0;0;54,678333;11,308611
1816;"Dragsminde";"no";0;0;0;54,678333;11,308611
1817;"Dragsminde";"no";0;0;0;54,678333;11,308611
1818;"Dragsminde";"no";0;0;0;54,678333;11,308611
1819;"Dragsminde";"no";0;0;0;54,678333;11,308611
1820;"Dragsminde";"no";0;0;0;54,678333;11,308611
1821;"Dragsminde";"no";0;0;0;54,678333;11,308611
1822;"Dragsminde";"no";0;0;0;54,678333;11,308611
1823;"Dragsminde";"no";0;0;0;54,678333;11,308611
1824;"Dragsminde";"no";0;0;0;54,678333;11,308611
1825;"Dragsminde";"no";0;0;0;54,678333;11,308611
1826;"Dragsminde";"no";0;0;0;54,678333;11,308611
1827;"Dragsminde";"no";0;0;0;54,678333;11,308611
1828;"Dragsminde";"no";0;0;0;54,678333;11,308611
1829;"Dragsminde";"no";0;0;0;54,678333;11,308611
1830;"Dragsminde";"no";0;0;0;54,678333;11,308611
1831;"Dragsminde";"no";0;0;0;54,678333;11,308611
1832;"Dragsminde";"no";0;0;0;54,678333;11,308611
1833;"Dragsminde";"no";0;0;0;54,678333;11,308611
1834;"Dragsminde";"no";0;0;0;54,678333;11,308611
1835;"Dragsminde";"no";0;0;0;54,678333;11,308611
1836;"Dragsminde";"no";0;0;0;54,678333;11,308611
1837;"Dragsminde";"no";0;0;0;54,678333;11,308611
1838;"Dragsminde";"no";0;0;0;54,678333;11,308611
1839;"Dragsminde";"no";0;0;0;54,678333;11,308611
1840;"Dragsminde";"no";0;0;0;54,678333;11,308611
1841;"Dragsminde";"no";0;0;0;54,678333;11,308611
1842;"Dragsminde";"no";0;0;0;54,678333;11,308611
1843;"Dragsminde";"no";0;0;0;54,678333;11,308611
1844;"Dragsminde";"no";0;0;0;54,678333;11,308611
1845;"Dragsminde";"no";0;0;0;54,678333;11,308611
1846;"Dragsminde";"no";0;0;0;54,678333;11,308611
1847;"Dragsminde";"no";0;0;0;54,678333;11,308611
1848;"Dragsminde";"no";0;0;0;54,678333;11,308611
1849;"Dragsminde";"no";0;0;0;54,678333;11,308611
1850;"Dragsminde";"no";0;0;0;54,678333;11,308611
1851;"Dragsminde";"no";0;0;0;54,678333;11,308611
1852;"Dragsminde";"no";0;0;0;54,678333;11,308611
1853;"Dragsminde";"no";0;0;0;54,678333;11,308611
1854;"Dragsminde";"no";0;0;0;54,678333;11,308611
1855;"Dragsminde";"no";0;0;0;54,678333;11,308611
1856;"Dragsminde";"no";0;0;0;54,678333;11,308611
1857;"Dragsminde";"no";0;0;0;54,678333;11,308611
1634;"Svendborg";"no";0;0;0;55,059722;10,606666
1635;"Svendborg";"no";0;0;0;55,059722;10,606666
1636;"Svendborg";"no";0;0;0;55,059722;10,606666
1637;"Svendborg";"no";0;0;0;55,059722;10,606666
1638;"Svendborg";"no";0;0;0;55,059722;10,606666
1639;"Svendborg";"no";0;0;0;55,059722;10,606666
1640;"Svendborg";"no";0;0;0;55,059722;10,606666
1641;"Svendborg";"no";0;0;0;55,059722;10,606666
1642;"Svendborg";"no";0;0;0;55,059722;10,606666
1643;"Svendborg";"no";0;0;0;55,059722;10,606666
1644;"Svendborg";"no";0;0;0;55,059722;10,606666
1645;"Svendborg";"no";0;0;0;55,059722;10,606666
1646;"Svendborg";"no";0;0;0;55,059722;10,606666
1647;"Svendborg";"no";0;0;0;55,059722;10,606666
1648;"Svendborg";"no";0;0;0;55,059722;10,606666
1649;"Svendborg";"no";0;0;0;55,059722;10,606666
1650;"Svendborg";"no";0;0;0;55,059722;10,606666
1651;"Svendborg";"no";0;0;0;55,059722;10,606666
1652;"Svendborg";"no";0;0;0;55,059722;10,606666
1653;"Svendborg";"no";0;0;0;55,059722;10,606666
1654;"Svendborg";"no";0;0;0;55,059722;10,606666
1655;"Svendborg";"no";0;0;0;55,059722;10,606666
1656;"Svendborg";"no";0;0;0;55,059722;10,606666
1657;"Svendborg";"no";0;0;0;55,059722;10,606666
1658;"Svendborg";"no";0;0;0;55,059722;10,606666
1659;"Svendborg";"no";0;0;0;55,059722;10,606666
1660;"Svendborg";"no";0;0;0;55,059722;10,606666
1661;"Svendborg";"no";0;0;0;55,059722;10,606666
1662;"Svendborg";"no";0;0;0;55,059722;10,606666
1663;"Svendborg";"no";0;0;0;55,059722;10,606666
1664;"Svendborg";"no";0;0;0;55,059722;10,606666
1665;"Svendborg";"no";0;0;0;55,059722;10,606666
1666;"Svendborg";"no";0;0;0;55,059722;10,606666
1667;"Svendborg";"no";0;0;0;55,059722;10,606666
1668;"Svendborg";"no";0;0;0;55,059722;10,606666
1669;"Svendborg";"no";0;0;0;55,059722;10,606666
1670;"Svendborg";"no";0;0;0;55,059722;10,606666
1671;"Svendborg";"no";0;0;0;55,059722;10,606666
1672;"Svendborg";"no";0;0;0;55,059722;10,606666
1673;"Svendborg";"no";0;0;0;55,059722;10,606666
1674;"Svendborg";"no";0;0;0;55,059722;10,606666
1675;"Svendborg";"no";0;0;0;55,059722;10,606666
1676;"Svendborg";"no";0;0;0;55,059722;10,606666
1677;"Svendborg";"no";0;0;0;55,059722;10,606666
1678;"Svendborg";"no";0;0;0;55,059722;10,606666
1679;"Svendborg";"no";0;0;0;55,059722;10,606666
1680;"Svendborg";"no";0;0;0;55,059722;10,606666
1681;"Svendborg";"no";0;0;0;55,059722;10,606666
1682;"Svendborg";"no";0;0;0;55,059722;10,606666
1683;"Svendborg";"no";0;0;0;55,059722;10,606666
1684;"Svendborg";"no";0;0;0;55,059722;10,606666
1685;"Svendborg";"no";0;0;0;55,059722;10,606666
1686;"Svendborg";"no";0;0;0;55,059722;10,606666
1687;"Svendborg";"no";0;0;0;55,059722;10,606666
1688;"Svendborg";"no";0;0;0;55,059722;10,606666
1689;"Svendborg";"no";0;0;0;55,059722;10,606666
1690;"Svendborg";"no";0;0;0;55,059722;10,606666
1691;"Svendborg";"no";0;0;0;55,059722;10,606666
1692;"Svendborg";"no";0;0;0;55,059722;10,606666
1693;"Svendborg";"no";0;0;0;55,059722;10,606666
1694;"Svendborg";"no";0;0;0;55,059722;10,606666
1695;"Svendborg";"no";0;0;0;55,059722;10,606666
1696;"Svendborg";"no";0;0;0;55,059722;10,606666
1697;"Svendborg";"no";0;0;0;55,059722;10,606666
1698;"Svendborg";"no";0;0;0;55,059722;10,606666
1699;"Svendborg";"no";0;0;0;55,059722;10,606666
1700;"Svendborg";"no";0;0;0;55,059722;10,606666
1701;"Svendborg";"no";0;0;0;55,059722;10,606666
1702;"Svendborg";"no";0;0;0;55,059722;10,606666
1703;"Svendborg";"no";0;0;0;55,059722;10,606666
1704;"Svendborg";"no";0;1;1;55,059722;10,606666
1705;"Svendborg";"no";0;0;0;55,059722;10,606666
1706;"Svendborg";"no";0;0;0;55,059722;10,606666
1707;"Svendborg";"no";1;0;1;55,059722;10,606666
1708;"Svendborg";"no";0;0;0;55,059722;10,606666
1709;"Svendborg";"no";0;0;0;55,059722;10,606666
1710;"Svendborg";"no";0;0;0;55,059722;10,606666
1711;"Svendborg";"no";0;0;0;55,059722;10,606666
1712;"Svendborg";"no";0;0;0;55,059722;10,606666
1713;"Svendborg";"no";0;0;0;55,059722;10,606666
1714;"Svendborg";"no";0;0;0;55,059722;10,606666
1715;"Svendborg";"no";0;0;0;55,059722;10,606666
1716;"Svendborg";"no";0;0;0;55,059722;10,606666
1717;"Svendborg";"no";0;0;0;55,059722;10,606666
1718;"Svendborg";"no";0;0;0;55,059722;10,606666
1719;"Svendborg";"no";0;0;0;55,059722;10,606666
1720;"Svendborg";"no";0;0;0;55,059722;10,606666
1721;"Svendborg";"no";0;0;0;55,059722;10,606666
1722;"Svendborg";"no";0;0;0;55,059722;10,606666
1723;"Svendborg";"no";0;0;0;55,059722;10,606666
1724;"Svendborg";"no";0;0;0;55,059722;10,606666
1725;"Svendborg";"no";0;0;0;55,059722;10,606666
1726;"Svendborg";"no";0;0;0;55,059722;10,606666
1727;"Svendborg";"no";0;0;0;55,059722;10,606666
1728;"Svendborg";"no";0;0;0;55,059722;10,606666
1729;"Svendborg";"no";0;0;0;55,059722;10,606666
1730;"Svendborg";"no";0;0;0;55,059722;10,606666
1731;"Svendborg";"no";0;0;0;55,059722;10,606666
1732;"Svendborg";"no";0;0;0;55,059722;10,606666
1733;"Svendborg";"no";0;0;0;55,059722;10,606666
1734;"Svendborg";"no";0;0;0;55,059722;10,606666
1735;"Svendborg";"no";0;0;0;55,059722;10,606666
1736;"Svendborg";"no";0;0;0;55,059722;10,606666
1737;"Svendborg";"no";0;0;0;55,059722;10,606666
1738;"Svendborg";"no";0;2;2;55,059722;10,606666
1739;"Svendborg";"no";0;0;0;55,059722;10,606666
1740;"Svendborg";"no";0;0;0;55,059722;10,606666
1741;"Svendborg";"no";0;0;0;55,059722;10,606666
1742;"Svendborg";"no";0;0;0;55,059722;10,606666
1743;"Svendborg";"no";0;0;0;55,059722;10,606666
1744;"Svendborg";"no";0;0;0;55,059722;10,606666
1745;"Svendborg";"no";0;0;0;55,059722;10,606666
1746;"Svendborg";"no";0;0;0;55,059722;10,606666
1747;"Svendborg";"no";0;0;0;55,059722;10,606666
1748;"Svendborg";"no";0;0;0;55,059722;10,606666
1749;"Svendborg";"no";0;0;0;55,059722;10,606666
1750;"Svendborg";"no";0;0;0;55,059722;10,606666
1751;"Svendborg";"no";0;0;0;55,059722;10,606666
1752;"Svendborg";"no";0;0;0;55,059722;10,606666
1753;"Svendborg";"no";0;1;1;55,059722;10,606666
1754;"Svendborg";"no";0;0;0;55,059722;10,606666
1755;"Svendborg";"no";0;0;0;55,059722;10,606666
1756;"Svendborg";"no";0;0;0;55,059722;10,606666
1757;"Svendborg";"no";0;0;0;55,059722;10,606666
1758;"Svendborg";"no";0;0;0;55,059722;10,606666
1759;"Svendborg";"no";0;0;0;55,059722;10,606666
1760;"Svendborg";"no";0;0;0;55,059722;10,606666
1761;"Svendborg";"no";0;0;0;55,059722;10,606666
1762;"Svendborg";"no";0;0;0;55,059722;10,606666
1763;"Svendborg";"no";0;0;0;55,059722;10,606666
1764;"Svendborg";"no";0;0;0;55,059722;10,606666
1765;"Svendborg";"no";0;2;2;55,059722;10,606666
1766;"Svendborg";"no";0;1;1;55,059722;10,606666
1767;"Svendborg";"no";0;2;2;55,059722;10,606666
1768;"Svendborg";"no";0;1;1;55,059722;10,606666
1769;"Svendborg";"no";0;0;0;55,059722;10,606666
1770;"Svendborg";"no";0;0;0;55,059722;10,606666
1771;"Svendborg";"no";0;0;0;55,059722;10,606666
1772;"Svendborg";"no";0;1;1;55,059722;10,606666
1773;"Svendborg";"no";0;0;0;55,059722;10,606666
1774;"Svendborg";"no";0;2;2;55,059722;10,606666
1775;"Svendborg";"no";0;1;1;55,059722;10,606666
1776;"Svendborg";"no";0;0;0;55,059722;10,606666
1777;"Svendborg";"no";0;1;1;55,059722;10,606666
1778;"Svendborg";"no";0;0;0;55,059722;10,606666
1779;"Svendborg";"no";0;1;1;55,059722;10,606666
1780;"Svendborg";"no";0;1;1;55,059722;10,606666
1781;"Svendborg";"no";0;0;0;55,059722;10,606666
1782;"Svendborg";"no";0;0;0;55,059722;10,606666
1783;"Svendborg";"no";0;1;1;55,059722;10,606666
1784;"Svendborg";"no";0;0;0;55,059722;10,606666
1785;"Svendborg";"no";0;0;0;55,059722;10,606666
1786;"Svendborg";"no";0;1;1;55,059722;10,606666
1787;"Svendborg";"no";0;0;0;55,059722;10,606666
1788;"Svendborg";"no";0;2;2;55,059722;10,606666
1789;"Svendborg";"no";0;1;1;55,059722;10,606666
1790;"Svendborg";"no";0;0;0;55,059722;10,606666
1791;"Svendborg";"no";0;1;1;55,059722;10,606666
1792;"Svendborg";"no";0;0;0;55,059722;10,606666
1793;"Svendborg";"no";0;1;1;55,059722;10,606666
1794;"Svendborg";"no";0;1;1;55,059722;10,606666
1795;"Svendborg";"no";0;0;0;55,059722;10,606666
1796;"Svendborg";"no";0;0;0;55,059722;10,606666
1797;"Svendborg";"no";0;0;0;55,059722;10,606666
1798;"Svendborg";"no";0;0;0;55,059722;10,606666
1799;"Svendborg";"no";0;1;1;55,059722;10,606666
1800;"Svendborg";"no";0;0;0;55,059722;10,606666
1801;"Svendborg";"no";5;1;6;55,059722;10,606666
1802;"Svendborg";"no";0;0;0;55,059722;10,606666
1803;"Svendborg";"no";0;2;2;55,059722;10,606666
1804;"Svendborg";"no";0;2;2;55,059722;10,606666
1805;"Svendborg";"no";0;0;0;55,059722;10,606666
1806;"Svendborg";"no";0;1;1;55,059722;10,606666
1807;"Svendborg";"no";0;0;0;55,059722;10,606666
1808;"Svendborg";"no";0;0;0;55,059722;10,606666
1809;"Svendborg";"no";0;0;0;55,059722;10,606666
1810;"Svendborg";"no";0;3;3;55,059722;10,606666
1811;"Svendborg";"no";0;0;0;55,059722;10,606666
1812;"Svendborg";"no";0;0;0;55,059722;10,606666
1813;"Svendborg";"no";0;0;0;55,059722;10,606666
1814;"Svendborg";"no";0;0;0;55,059722;10,606666
1815;"Svendborg";"no";0;0;0;55,059722;10,606666
1816;"Svendborg";"no";0;0;0;55,059722;10,606666
1817;"Svendborg";"no";0;0;0;55,059722;10,606666
1818;"Svendborg";"no";0;1;1;55,059722;10,606666
1819;"Svendborg";"no";0;0;0;55,059722;10,606666
1820;"Svendborg";"no";0;0;0;55,059722;10,606666
1821;"Svendborg";"no";0;0;0;55,059722;10,606666
1822;"Svendborg";"no";0;0;0;55,059722;10,606666
1823;"Svendborg";"no";0;0;0;55,059722;10,606666
1824;"Svendborg";"no";0;0;0;55,059722;10,606666
1825;"Svendborg";"no";0;0;0;55,059722;10,606666
1826;"Svendborg";"no";0;0;0;55,059722;10,606666
1827;"Svendborg";"no";0;1;1;55,059722;10,606666
1828;"Svendborg";"no";1;2;3;55,059722;10,606666
1829;"Svendborg";"no";0;1;1;55,059722;10,606666
1830;"Svendborg";"no";0;0;0;55,059722;10,606666
1831;"Svendborg";"no";0;1;1;55,059722;10,606666
1832;"Svendborg";"no";0;1;1;55,059722;10,606666
1833;"Svendborg";"no";0;1;1;55,059722;10,606666
1834;"Svendborg";"no";1;2;3;55,059722;10,606666
1835;"Svendborg";"no";0;1;1;55,059722;10,606666
1836;"Svendborg";"no";0;0;0;55,059722;10,606666
1837;"Svendborg";"no";0;0;0;55,059722;10,606666
1838;"Svendborg";"no";0;3;3;55,059722;10,606666
1839;"Svendborg";"no";0;0;0;55,059722;10,606666
1840;"Svendborg";"no";0;0;0;55,059722;10,606666
1841;"Svendborg";"no";1;0;1;55,059722;10,606666
1842;"Svendborg";"no";0;1;1;55,059722;10,606666
1843;"Svendborg";"no";0;1;1;55,059722;10,606666
1844;"Svendborg";"no";0;1;1;55,059722;10,606666
1845;"Svendborg";"no";0;2;2;55,059722;10,606666
1846;"Svendborg";"no";0;0;0;55,059722;10,606666
1847;"Svendborg";"no";0;2;2;55,059722;10,606666
1848;"Svendborg";"no";0;3;3;55,059722;10,606666
1849;"Svendborg";"no";1;1;2;55,059722;10,606666
1850;"Svendborg";"no";0;0;0;55,059722;10,606666
1851;"Svendborg";"no";1;1;2;55,059722;10,606666
1852;"Svendborg";"no";1;4;5;55,059722;10,606666
1853;"Svendborg";"no";0;0;0;55,059722;10,606666
1854;"Svendborg";"no";2;0;2;55,059722;10,606666
1855;"Svendborg";"no";1;0;1;55,059722;10,606666
1856;"Svendborg";"no";1;0;1;55,059722;10,606666
1857;"Svendborg";"no";0;0;0;55,059722;10,606666
1634;"Danmark";"no";0;0;0;56;10
1635;"Danmark";"no";0;0;0;56;10
1636;"Danmark";"no";0;0;0;56;10
1637;"Danmark";"no";0;0;0;56;10
1638;"Danmark";"no";0;0;0;56;10
1639;"Danmark";"no";0;0;0;56;10
1640;"Danmark";"no";0;0;0;56;10
1641;"Danmark";"no";0;0;0;56;10
1642;"Danmark";"no";0;0;0;56;10
1643;"Danmark";"no";0;0;0;56;10
1644;"Danmark";"no";0;0;0;56;10
1645;"Danmark";"no";0;0;0;56;10
1646;"Danmark";"no";0;0;0;56;10
1647;"Danmark";"no";0;0;0;56;10
1648;"Danmark";"no";0;0;0;56;10
1649;"Danmark";"no";0;0;0;56;10
1650;"Danmark";"no";0;0;0;56;10
1651;"Danmark";"no";0;0;0;56;10
1652;"Danmark";"no";0;0;0;56;10
1653;"Danmark";"no";0;0;0;56;10
1654;"Danmark";"no";0;0;0;56;10
1655;"Danmark";"no";0;0;0;56;10
1656;"Danmark";"no";0;1;1;56;10
1657;"Danmark";"no";0;0;0;56;10
1658;"Danmark";"no";0;0;0;56;10
1659;"Danmark";"no";0;0;0;56;10
1660;"Danmark";"no";0;0;0;56;10
1661;"Danmark";"no";0;0;0;56;10
1662;"Danmark";"no";0;0;0;56;10
1663;"Danmark";"no";0;0;0;56;10
1664;"Danmark";"no";0;0;0;56;10
1665;"Danmark";"no";0;0;0;56;10
1666;"Danmark";"no";0;0;0;56;10
1667;"Danmark";"no";0;0;0;56;10
1668;"Danmark";"no";0;0;0;56;10
1669;"Danmark";"no";0;0;0;56;10
1670;"Danmark";"no";0;0;0;56;10
1671;"Danmark";"no";0;0;0;56;10
1672;"Danmark";"no";0;0;0;56;10
1673;"Danmark";"no";0;0;0;56;10
1674;"Danmark";"no";0;0;0;56;10
1675;"Danmark";"no";0;0;0;56;10
1676;"Danmark";"no";0;0;0;56;10
1677;"Danmark";"no";0;0;0;56;10
1678;"Danmark";"no";0;0;0;56;10
1679;"Danmark";"no";0;0;0;56;10
1680;"Danmark";"no";0;0;0;56;10
1681;"Danmark";"no";0;0;0;56;10
1682;"Danmark";"no";0;0;0;56;10
1683;"Danmark";"no";0;0;0;56;10
1684;"Danmark";"no";0;0;0;56;10
1685;"Danmark";"no";0;0;0;56;10
1686;"Danmark";"no";0;0;0;56;10
1687;"Danmark";"no";0;0;0;56;10
1688;"Danmark";"no";0;0;0;56;10
1689;"Danmark";"no";0;0;0;56;10
1690;"Danmark";"no";0;0;0;56;10
1691;"Danmark";"no";0;0;0;56;10
1692;"Danmark";"no";0;0;0;56;10
1693;"Danmark";"no";0;0;0;56;10
1694;"Danmark";"no";0;0;0;56;10
1695;"Danmark";"no";0;0;0;56;10
1696;"Danmark";"no";0;0;0;56;10
1697;"Danmark";"no";0;0;0;56;10
1698;"Danmark";"no";0;0;0;56;10
1699;"Danmark";"no";0;0;0;56;10
1700;"Danmark";"no";0;0;0;56;10
1701;"Danmark";"no";0;0;0;56;10
1702;"Danmark";"no";0;0;0;56;10
1703;"Danmark";"no";0;0;0;56;10
1704;"Danmark";"no";0;0;0;56;10
1705;"Danmark";"no";0;0;0;56;10
1706;"Danmark";"no";0;0;0;56;10
1707;"Danmark";"no";0;0;0;56;10
1708;"Danmark";"no";0;0;0;56;10
1709;"Danmark";"no";1;0;1;56;10
1710;"Danmark";"no";0;0;0;56;10
1711;"Danmark";"no";0;0;0;56;10
1712;"Danmark";"no";0;0;0;56;10
1713;"Danmark";"no";0;0;0;56;10
1714;"Danmark";"no";0;0;0;56;10
1715;"Danmark";"no";0;0;0;56;10
1716;"Danmark";"no";0;0;0;56;10
1717;"Danmark";"no";0;0;0;56;10
1718;"Danmark";"no";0;0;0;56;10
1719;"Danmark";"no";0;0;0;56;10
1720;"Danmark";"no";0;0;0;56;10
1721;"Danmark";"no";0;1;1;56;10
1722;"Danmark";"no";0;0;0;56;10
1723;"Danmark";"no";0;0;0;56;10
1724;"Danmark";"no";1;0;1;56;10
1725;"Danmark";"no";0;0;0;56;10
1726;"Danmark";"no";0;0;0;56;10
1727;"Danmark";"no";0;0;0;56;10
1728;"Danmark";"no";1;0;1;56;10
1729;"Danmark";"no";5;1;6;56;10
1730;"Danmark";"no";0;2;2;56;10
1731;"Danmark";"no";0;0;0;56;10
1732;"Danmark";"no";0;0;0;56;10
1733;"Danmark";"no";0;1;1;56;10
1734;"Danmark";"no";0;0;0;56;10
1735;"Danmark";"no";0;0;0;56;10
1736;"Danmark";"no";0;1;1;56;10
1737;"Danmark";"no";0;13;13;56;10
1738;"Danmark";"no";1;3;4;56;10
1739;"Danmark";"no";0;0;0;56;10
1740;"Danmark";"no";2;3;5;56;10
1741;"Danmark";"no";0;1;1;56;10
1742;"Danmark";"no";0;0;0;56;10
1743;"Danmark";"no";0;3;3;56;10
1744;"Danmark";"no";0;0;0;56;10
1745;"Danmark";"no";0;0;0;56;10
1746;"Danmark";"no";1;1;2;56;10
1747;"Danmark";"no";0;0;0;56;10
1748;"Danmark";"no";0;2;2;56;10
1749;"Danmark";"no";1;0;1;56;10
1750;"Danmark";"no";0;1;1;56;10
1751;"Danmark";"no";0;3;3;56;10
1752;"Danmark";"no";0;6;6;56;10
1753;"Danmark";"no";0;2;2;56;10
1754;"Danmark";"no";0;8;8;56;10
1755;"Danmark";"no";0;33;33;56;10
1756;"Danmark";"no";0;19;19;56;10
1757;"Danmark";"no";0;21;21;56;10
1758;"Danmark";"no";0;23;23;56;10
1759;"Danmark";"no";2;11;13;56;10
1760;"Danmark";"no";2;24;26;56;10
1761;"Danmark";"no";0;11;11;56;10
1762;"Danmark";"no";0;13;13;56;10
1763;"Danmark";"no";0;24;24;56;10
1764;"Danmark";"no";1;23;24;56;10
1765;"Danmark";"no";0;46;46;56;10
1766;"Danmark";"no";1;24;25;56;10
1767;"Danmark";"no";0;36;36;56;10
1768;"Danmark";"no";0;34;34;56;10
1769;"Danmark";"no";0;58;58;56;10
1770;"Danmark";"no";0;45;45;56;10
1771;"Danmark";"no";0;50;50;56;10
1772;"Danmark";"no";0;34;34;56;10
1773;"Danmark";"no";0;54;54;56;10
1774;"Danmark";"no";1;34;35;56;10
1775;"Danmark";"no";0;35;35;56;10
1776;"Danmark";"no";0;53;53;56;10
1777;"Danmark";"no";0;63;63;56;10
1778;"Danmark";"no";0;82;82;56;10
1779;"Danmark";"no";0;84;84;56;10
1780;"Danmark";"no";0;68;68;56;10
1781;"Danmark";"no";0;79;79;56;10
1782;"Danmark";"no";0;43;43;56;10
1783;"Danmark";"no";0;61;61;56;10
1784;"Danmark";"no";0;66;66;56;10
1785;"Danmark";"no";0;52;52;56;10
1786;"Danmark";"no";0;46;46;56;10
1787;"Danmark";"no";1;41;42;56;10
1788;"Danmark";"no";0;46;46;56;10
1789;"Danmark";"no";0;28;28;56;10
1790;"Danmark";"no";0;24;24;56;10
1791;"Danmark";"no";0;53;53;56;10
1792;"Danmark";"no";0;59;59;56;10
1793;"Danmark";"no";0;48;48;56;10
1794;"Danmark";"no";0;60;60;56;10
1795;"Danmark";"no";0;58;58;56;10
1796;"Danmark";"no";0;39;39;56;10
1797;"Danmark";"no";2;22;24;56;10
1798;"Danmark";"no";0;21;21;56;10
1799;"Danmark";"no";0;7;7;56;10
1800;"Danmark";"no";0;6;6;56;10
1801;"Danmark";"no";0;5;5;56;10
1802;"Danmark";"no";0;4;4;56;10
1803;"Danmark";"no";0;7;7;56;10
1804;"Danmark";"no";1;1;2;56;10
1805;"Danmark";"no";0;3;3;56;10
1806;"Danmark";"no";0;0;0;56;10
1807;"Danmark";"no";0;0;0;56;10
1808;"Danmark";"no";0;0;0;56;10
1809;"Danmark";"no";0;0;0;56;10
1810;"Danmark";"no";0;3;3;56;10
1811;"Danmark";"no";0;0;0;56;10
1812;"Danmark";"no";0;3;3;56;10
1813;"Danmark";"no";0;0;0;56;10
1814;"Danmark";"no";0;3;3;56;10
1815;"Danmark";"no";0;2;2;56;10
1816;"Danmark";"no";0;3;3;56;10
1817;"Danmark";"no";0;0;0;56;10
1818;"Danmark";"no";0;0;0;56;10
1819;"Danmark";"no";0;2;2;56;10
1820;"Danmark";"no";0;0;0;56;10
1821;"Danmark";"no";0;0;0;56;10
1822;"Danmark";"no";0;1;1;56;10
1823;"Danmark";"no";0;0;0;56;10
1824;"Danmark";"no";0;2;2;56;10
1825;"Danmark";"no";0;10;10;56;10
1826;"Danmark";"no";0;2;2;56;10
1827;"Danmark";"no";0;0;0;56;10
1828;"Danmark";"no";0;0;0;56;10
1829;"Danmark";"no";0;0;0;56;10
1830;"Danmark";"no";0;0;0;56;10
1831;"Danmark";"no";0;0;0;56;10
1832;"Danmark";"no";0;0;0;56;10
1833;"Danmark";"no";0;0;0;56;10
1834;"Danmark";"no";0;0;0;56;10
1835;"Danmark";"no";0;0;0;56;10
1836;"Danmark";"no";0;1;1;56;10
1837;"Danmark";"no";0;0;0;56;10
1838;"Danmark";"no";0;1;1;56;10
1839;"Danmark";"no";0;1;1;56;10
1840;"Danmark";"no";0;1;1;56;10
1841;"Danmark";"no";0;0;0;56;10
1842;"Danmark";"no";0;1;1;56;10
1843;"Danmark";"no";0;0;0;56;10
1844;"Danmark";"no";0;0;0;56;10
1845;"Danmark";"no";0;0;0;56;10
1846;"Danmark";"no";0;0;0;56;10
1847;"Danmark";"no";1;0;1;56;10
1848;"Danmark";"no";0;0;0;56;10
1849;"Danmark";"no";0;0;0;56;10
1850;"Danmark";"no";0;0;0;56;10
1851;"Danmark";"no";0;3;3;56;10
1852;"Danmark";"no";0;1;1;56;10
1853;"Danmark";"no";0;0;0;56;10
1854;"Danmark";"no";0;1;1;56;10
1855;"Danmark";"no";0;3;3;56;10
1856;"Danmark";"no";0;0;0;56;10
1857;"Danmark";"no";0;0;0;56;10
1634;"Ærøskøbing";"no";0;0;0;54,883333;10,416666
1635;"Ærøskøbing";"no";0;0;0;54,883333;10,416666
1636;"Ærøskøbing";"no";0;0;0;54,883333;10,416666
1637;"Ærøskøbing";"no";0;0;0;54,883333;10,416666
1638;"Ærøskøbing";"no";0;0;0;54,883333;10,416666
1639;"Ærøskøbing";"no";0;0;0;54,883333;10,416666
1640;"Ærøskøbing";"no";0;0;0;54,883333;10,416666
1641;"Ærøskøbing";"no";0;0;0;54,883333;10,416666
1642;"Ærøskøbing";"no";0;0;0;54,883333;10,416666
1643;"Ærøskøbing";"no";0;0;0;54,883333;10,416666
1644;"Ærøskøbing";"no";0;0;0;54,883333;10,416666
1645;"Ærøskøbing";"no";0;0;0;54,883333;10,416666
1646;"Ærøskøbing";"no";0;0;0;54,883333;10,416666
1647;"Ærøskøbing";"no";0;0;0;54,883333;10,416666
1648;"Ærøskøbing";"no";0;0;0;54,883333;10,416666
1649;"Ærøskøbing";"no";0;0;0;54,883333;10,416666
1650;"Ærøskøbing";"no";0;0;0;54,883333;10,416666
1651;"Ærøskøbing";"no";0;0;0;54,883333;10,416666
1652;"Ærøskøbing";"no";0;0;0;54,883333;10,416666
1653;"Ærøskøbing";"no";0;0;0;54,883333;10,416666
1654;"Ærøskøbing";"no";0;0;0;54,883333;10,416666
1655;"Ærøskøbing";"no";0;0;0;54,883333;10,416666
1656;"Ærøskøbing";"no";0;0;0;54,883333;10,416666
1657;"Ærøskøbing";"no";0;0;0;54,883333;10,416666
1658;"Ærøskøbing";"no";0;0;0;54,883333;10,416666
1659;"Ærøskøbing";"no";0;0;0;54,883333;10,416666
1660;"Ærøskøbing";"no";0;0;0;54,883333;10,416666
1661;"Ærøskøbing";"no";0;0;0;54,883333;10,416666
1662;"Ærøskøbing";"no";0;0;0;54,883333;10,416666
1663;"Ærøskøbing";"no";0;0;0;54,883333;10,416666
1664;"Ærøskøbing";"no";0;0;0;54,883333;10,416666
1665;"Ærøskøbing";"no";0;0;0;54,883333;10,416666
1666;"Ærøskøbing";"no";0;0;0;54,883333;10,416666
1667;"Ærøskøbing";"no";0;0;0;54,883333;10,416666
1668;"Ærøskøbing";"no";0;0;0;54,883333;10,416666
1669;"Ærøskøbing";"no";0;0;0;54,883333;10,416666
1670;"Ærøskøbing";"no";0;0;0;54,883333;10,416666
1671;"Ærøskøbing";"no";0;0;0;54,883333;10,416666
1672;"Ærøskøbing";"no";0;0;0;54,883333;10,416666
1673;"Ærøskøbing";"no";0;0;0;54,883333;10,416666
1674;"Ærøskøbing";"no";0;0;0;54,883333;10,416666
1675;"Ærøskøbing";"no";0;0;0;54,883333;10,416666
1676;"Ærøskøbing";"no";0;0;0;54,883333;10,416666
1677;"Ærøskøbing";"no";0;0;0;54,883333;10,416666
1678;"Ærøskøbing";"no";0;0;0;54,883333;10,416666
1679;"Ærøskøbing";"no";0;0;0;54,883333;10,416666
1680;"Ærøskøbing";"no";0;0;0;54,883333;10,416666
1681;"Ærøskøbing";"no";0;0;0;54,883333;10,416666
1682;"Ærøskøbing";"no";0;0;0;54,883333;10,416666
1683;"Ærøskøbing";"no";0;0;0;54,883333;10,416666
1684;"Ærøskøbing";"no";0;0;0;54,883333;10,416666
1685;"Ærøskøbing";"no";0;0;0;54,883333;10,416666
1686;"Ærøskøbing";"no";0;0;0;54,883333;10,416666
1687;"Ærøskøbing";"no";0;0;0;54,883333;10,416666
1688;"Ærøskøbing";"no";0;0;0;54,883333;10,416666
1689;"Ærøskøbing";"no";0;0;0;54,883333;10,416666
1690;"Ærøskøbing";"no";0;0;0;54,883333;10,416666
1691;"Ærøskøbing";"no";0;0;0;54,883333;10,416666
1692;"Ærøskøbing";"no";0;0;0;54,883333;10,416666
1693;"Ærøskøbing";"no";0;0;0;54,883333;10,416666
1694;"Ærøskøbing";"no";0;0;0;54,883333;10,416666
1695;"Ærøskøbing";"no";0;0;0;54,883333;10,416666
1696;"Ærøskøbing";"no";0;0;0;54,883333;10,416666
1697;"Ærøskøbing";"no";0;0;0;54,883333;10,416666
1698;"Ærøskøbing";"no";0;0;0;54,883333;10,416666
1699;"Ærøskøbing";"no";0;0;0;54,883333;10,416666
1700;"Ærøskøbing";"no";0;0;0;54,883333;10,416666
1701;"Ærøskøbing";"no";0;0;0;54,883333;10,416666
1702;"Ærøskøbing";"no";0;0;0;54,883333;10,416666
1703;"Ærøskøbing";"no";0;0;0;54,883333;10,416666
1704;"Ærøskøbing";"no";0;0;0;54,883333;10,416666
1705;"Ærøskøbing";"no";0;0;0;54,883333;10,416666
1706;"Ærøskøbing";"no";0;0;0;54,883333;10,416666
1707;"Ærøskøbing";"no";0;0;0;54,883333;10,416666
1708;"Ærøskøbing";"no";0;0;0;54,883333;10,416666
1709;"Ærøskøbing";"no";0;0;0;54,883333;10,416666
1710;"Ærøskøbing";"no";0;0;0;54,883333;10,416666
1711;"Ærøskøbing";"no";0;0;0;54,883333;10,416666
1712;"Ærøskøbing";"no";0;0;0;54,883333;10,416666
1713;"Ærøskøbing";"no";0;0;0;54,883333;10,416666
1714;"Ærøskøbing";"no";0;0;0;54,883333;10,416666
1715;"Ærøskøbing";"no";0;0;0;54,883333;10,416666
1716;"Ærøskøbing";"no";0;0;0;54,883333;10,416666
1717;"Ærøskøbing";"no";0;0;0;54,883333;10,416666
1718;"Ærøskøbing";"no";0;0;0;54,883333;10,416666
1719;"Ærøskøbing";"no";0;0;0;54,883333;10,416666
1720;"Ærøskøbing";"no";0;0;0;54,883333;10,416666
1721;"Ærøskøbing";"no";0;0;0;54,883333;10,416666
1722;"Ærøskøbing";"no";1;1;2;54,883333;10,416666
1723;"Ærøskøbing";"no";0;0;0;54,883333;10,416666
1724;"Ærøskøbing";"no";0;0;0;54,883333;10,416666
1725;"Ærøskøbing";"no";0;0;0;54,883333;10,416666
1726;"Ærøskøbing";"no";0;0;0;54,883333;10,416666
1727;"Ærøskøbing";"no";0;0;0;54,883333;10,416666
1728;"Ærøskøbing";"no";0;0;0;54,883333;10,416666
1729;"Ærøskøbing";"no";0;0;0;54,883333;10,416666
1730;"Ærøskøbing";"no";0;0;0;54,883333;10,416666
1731;"Ærøskøbing";"no";0;0;0;54,883333;10,416666
1732;"Ærøskøbing";"no";0;0;0;54,883333;10,416666
1733;"Ærøskøbing";"no";0;0;0;54,883333;10,416666
1734;"Ærøskøbing";"no";0;0;0;54,883333;10,416666
1735;"Ærøskøbing";"no";0;0;0;54,883333;10,416666
1736;"Ærøskøbing";"no";0;0;0;54,883333;10,416666
1737;"Ærøskøbing";"no";0;0;0;54,883333;10,416666
1738;"Ærøskøbing";"no";0;0;0;54,883333;10,416666
1739;"Ærøskøbing";"no";0;0;0;54,883333;10,416666
1740;"Ærøskøbing";"no";0;0;0;54,883333;10,416666
1741;"Ærøskøbing";"no";0;0;0;54,883333;10,416666
1742;"Ærøskøbing";"no";0;0;0;54,883333;10,416666
1743;"Ærøskøbing";"no";0;0;0;54,883333;10,416666
1744;"Ærøskøbing";"no";0;0;0;54,883333;10,416666
1745;"Ærøskøbing";"no";0;0;0;54,883333;10,416666
1746;"Ærøskøbing";"no";0;0;0;54,883333;10,416666
1747;"Ærøskøbing";"no";0;0;0;54,883333;10,416666
1748;"Ærøskøbing";"no";0;0;0;54,883333;10,416666
1749;"Ærøskøbing";"no";0;0;0;54,883333;10,416666
1750;"Ærøskøbing";"no";0;0;0;54,883333;10,416666
1751;"Ærøskøbing";"no";0;0;0;54,883333;10,416666
1752;"Ærøskøbing";"no";0;0;0;54,883333;10,416666
1753;"Ærøskøbing";"no";0;0;0;54,883333;10,416666
1754;"Ærøskøbing";"no";0;0;0;54,883333;10,416666
1755;"Ærøskøbing";"no";0;0;0;54,883333;10,416666
1756;"Ærøskøbing";"no";1;0;1;54,883333;10,416666
1757;"Ærøskøbing";"no";0;0;0;54,883333;10,416666
1758;"Ærøskøbing";"no";1;0;1;54,883333;10,416666
1759;"Ærøskøbing";"no";0;0;0;54,883333;10,416666
1760;"Ærøskøbing";"no";0;0;0;54,883333;10,416666
1761;"Ærøskøbing";"no";0;0;0;54,883333;10,416666
1762;"Ærøskøbing";"no";0;0;0;54,883333;10,416666
1763;"Ærøskøbing";"no";0;0;0;54,883333;10,416666
1764;"Ærøskøbing";"no";0;0;0;54,883333;10,416666
1765;"Ærøskøbing";"no";0;0;0;54,883333;10,416666
1766;"Ærøskøbing";"no";0;1;1;54,883333;10,416666
1767;"Ærøskøbing";"no";0;0;0;54,883333;10,416666
1768;"Ærøskøbing";"no";0;0;0;54,883333;10,416666
1769;"Ærøskøbing";"no";0;1;1;54,883333;10,416666
1770;"Ærøskøbing";"no";0;0;0;54,883333;10,416666
1771;"Ærøskøbing";"no";0;1;1;54,883333;10,416666
1772;"Ærøskøbing";"no";0;0;0;54,883333;10,416666
1773;"Ærøskøbing";"no";0;1;1;54,883333;10,416666
1774;"Ærøskøbing";"no";0;0;0;54,883333;10,416666
1775;"Ærøskøbing";"no";0;0;0;54,883333;10,416666
1776;"Ærøskøbing";"no";0;1;1;54,883333;10,416666
1777;"Ærøskøbing";"no";0;1;1;54,883333;10,416666
1778;"Ærøskøbing";"no";0;1;1;54,883333;10,416666
1779;"Ærøskøbing";"no";0;2;2;54,883333;10,416666
1780;"Ærøskøbing";"no";0;1;1;54,883333;10,416666
1781;"Ærøskøbing";"no";0;0;0;54,883333;10,416666
1782;"Ærøskøbing";"no";1;1;2;54,883333;10,416666
1783;"Ærøskøbing";"no";0;0;0;54,883333;10,416666
1784;"Ærøskøbing";"no";0;1;1;54,883333;10,416666
1785;"Ærøskøbing";"no";1;1;2;54,883333;10,416666
1786;"Ærøskøbing";"no";0;2;2;54,883333;10,416666
1787;"Ærøskøbing";"no";0;1;1;54,883333;10,416666
1788;"Ærøskøbing";"no";0;0;0;54,883333;10,416666
1789;"Ærøskøbing";"no";0;0;0;54,883333;10,416666
1790;"Ærøskøbing";"no";0;0;0;54,883333;10,416666
1791;"Ærøskøbing";"no";0;1;1;54,883333;10,416666
1792;"Ærøskøbing";"no";1;0;1;54,883333;10,416666
1793;"Ærøskøbing";"no";0;0;0;54,883333;10,416666
1794;"Ærøskøbing";"no";0;1;1;54,883333;10,416666
1795;"Ærøskøbing";"no";0;0;0;54,883333;10,416666
1796;"Ærøskøbing";"no";0;0;0;54,883333;10,416666
1797;"Ærøskøbing";"no";0;0;0;54,883333;10,416666
1798;"Ærøskøbing";"no";0;1;1;54,883333;10,416666
1799;"Ærøskøbing";"no";0;0;0;54,883333;10,416666
1800;"Ærøskøbing";"no";0;0;0;54,883333;10,416666
1801;"Ærøskøbing";"no";1;1;2;54,883333;10,416666
1802;"Ærøskøbing";"no";0;1;1;54,883333;10,416666
1803;"Ærøskøbing";"no";0;0;0;54,883333;10,416666
1804;"Ærøskøbing";"no";0;0;0;54,883333;10,416666
1805;"Ærøskøbing";"no";0;0;0;54,883333;10,416666
1806;"Ærøskøbing";"no";0;0;0;54,883333;10,416666
1807;"Ærøskøbing";"no";0;0;0;54,883333;10,416666
1808;"Ærøskøbing";"no";0;0;0;54,883333;10,416666
1809;"Ærøskøbing";"no";0;0;0;54,883333;10,416666
1810;"Ærøskøbing";"no";0;0;0;54,883333;10,416666
1811;"Ærøskøbing";"no";0;0;0;54,883333;10,416666
1812;"Ærøskøbing";"no";0;0;0;54,883333;10,416666
1813;"Ærøskøbing";"no";0;0;0;54,883333;10,416666
1814;"Ærøskøbing";"no";0;0;0;54,883333;10,416666
1815;"Ærøskøbing";"no";0;0;0;54,883333;10,416666
1816;"Ærøskøbing";"no";0;0;0;54,883333;10,416666
1817;"Ærøskøbing";"no";0;0;0;54,883333;10,416666
1818;"Ærøskøbing";"no";0;0;0;54,883333;10,416666
1819;"Ærøskøbing";"no";0;1;1;54,883333;10,416666
1820;"Ærøskøbing";"no";0;0;0;54,883333;10,416666
1821;"Ærøskøbing";"no";0;0;0;54,883333;10,416666
1822;"Ærøskøbing";"no";1;0;1;54,883333;10,416666
1823;"Ærøskøbing";"no";0;0;0;54,883333;10,416666
1824;"Ærøskøbing";"no";0;0;0;54,883333;10,416666
1825;"Ærøskøbing";"no";0;0;0;54,883333;10,416666
1826;"Ærøskøbing";"no";0;0;0;54,883333;10,416666
1827;"Ærøskøbing";"no";0;0;0;54,883333;10,416666
1828;"Ærøskøbing";"no";0;0;0;54,883333;10,416666
1829;"Ærøskøbing";"no";0;0;0;54,883333;10,416666
1830;"Ærøskøbing";"no";0;0;0;54,883333;10,416666
1831;"Ærøskøbing";"no";0;0;0;54,883333;10,416666
1832;"Ærøskøbing";"no";0;0;0;54,883333;10,416666
1833;"Ærøskøbing";"no";0;0;0;54,883333;10,416666
1834;"Ærøskøbing";"no";0;0;0;54,883333;10,416666
1835;"Ærøskøbing";"no";0;0;0;54,883333;10,416666
1836;"Ærøskøbing";"no";0;0;0;54,883333;10,416666
1837;"Ærøskøbing";"no";0;0;0;54,883333;10,416666
1838;"Ærøskøbing";"no";0;0;0;54,883333;10,416666
1839;"Ærøskøbing";"no";0;0;0;54,883333;10,416666
1840;"Ærøskøbing";"no";0;0;0;54,883333;10,416666
1841;"Ærøskøbing";"no";0;0;0;54,883333;10,416666
1842;"Ærøskøbing";"no";0;0;0;54,883333;10,416666
1843;"Ærøskøbing";"no";0;0;0;54,883333;10,416666
1844;"Ærøskøbing";"no";0;0;0;54,883333;10,416666
1845;"Ærøskøbing";"no";0;0;0;54,883333;10,416666
1846;"Ærøskøbing";"no";0;0;0;54,883333;10,416666
1847;"Ærøskøbing";"no";1;0;1;54,883333;10,416666
1848;"Ærøskøbing";"no";0;2;2;54,883333;10,416666
1849;"Ærøskøbing";"no";0;0;0;54,883333;10,416666
1850;"Ærøskøbing";"no";0;1;1;54,883333;10,416666
1851;"Ærøskøbing";"no";0;1;1;54,883333;10,416666
1852;"Ærøskøbing";"no";0;0;0;54,883333;10,416666
1853;"Ærøskøbing";"no";0;0;0;54,883333;10,416666
1854;"Ærøskøbing";"no";0;0;0;54,883333;10,416666
1855;"Ærøskøbing";"no";0;0;0;54,883333;10,416666
1856;"Ærøskøbing";"no";1;1;2;54,883333;10,416666
1857;"Ærøskøbing";"no";0;0;0;54,883333;10,416666
1634;"Bording";"no";0;0;0;56,168611;9,243611
1635;"Bording";"no";0;0;0;56,168611;9,243611
1636;"Bording";"no";0;0;0;56,168611;9,243611
1637;"Bording";"no";0;0;0;56,168611;9,243611
1638;"Bording";"no";0;0;0;56,168611;9,243611
1639;"Bording";"no";0;0;0;56,168611;9,243611
1640;"Bording";"no";0;0;0;56,168611;9,243611
1641;"Bording";"no";0;0;0;56,168611;9,243611
1642;"Bording";"no";0;0;0;56,168611;9,243611
1643;"Bording";"no";0;0;0;56,168611;9,243611
1644;"Bording";"no";0;0;0;56,168611;9,243611
1645;"Bording";"no";0;0;0;56,168611;9,243611
1646;"Bording";"no";0;0;0;56,168611;9,243611
1647;"Bording";"no";0;0;0;56,168611;9,243611
1648;"Bording";"no";0;0;0;56,168611;9,243611
1649;"Bording";"no";0;0;0;56,168611;9,243611
1650;"Bording";"no";0;0;0;56,168611;9,243611
1651;"Bording";"no";0;0;0;56,168611;9,243611
1652;"Bording";"no";0;0;0;56,168611;9,243611
1653;"Bording";"no";0;0;0;56,168611;9,243611
1654;"Bording";"no";0;0;0;56,168611;9,243611
1655;"Bording";"no";0;0;0;56,168611;9,243611
1656;"Bording";"no";0;0;0;56,168611;9,243611
1657;"Bording";"no";0;0;0;56,168611;9,243611
1658;"Bording";"no";0;0;0;56,168611;9,243611
1659;"Bording";"no";0;0;0;56,168611;9,243611
1660;"Bording";"no";0;0;0;56,168611;9,243611
1661;"Bording";"no";0;0;0;56,168611;9,243611
1662;"Bording";"no";0;0;0;56,168611;9,243611
1663;"Bording";"no";0;0;0;56,168611;9,243611
1664;"Bording";"no";0;0;0;56,168611;9,243611
1665;"Bording";"no";0;0;0;56,168611;9,243611
1666;"Bording";"no";0;0;0;56,168611;9,243611
1667;"Bording";"no";0;0;0;56,168611;9,243611
1668;"Bording";"no";0;0;0;56,168611;9,243611
1669;"Bording";"no";0;0;0;56,168611;9,243611
1670;"Bording";"no";0;0;0;56,168611;9,243611
1671;"Bording";"no";0;0;0;56,168611;9,243611
1672;"Bording";"no";0;0;0;56,168611;9,243611
1673;"Bording";"no";0;0;0;56,168611;9,243611
1674;"Bording";"no";0;0;0;56,168611;9,243611
1675;"Bording";"no";0;0;0;56,168611;9,243611
1676;"Bording";"no";0;0;0;56,168611;9,243611
1677;"Bording";"no";0;0;0;56,168611;9,243611
1678;"Bording";"no";0;0;0;56,168611;9,243611
1679;"Bording";"no";0;0;0;56,168611;9,243611
1680;"Bording";"no";0;0;0;56,168611;9,243611
1681;"Bording";"no";0;0;0;56,168611;9,243611
1682;"Bording";"no";0;0;0;56,168611;9,243611
1683;"Bording";"no";0;0;0;56,168611;9,243611
1684;"Bording";"no";0;0;0;56,168611;9,243611
1685;"Bording";"no";0;0;0;56,168611;9,243611
1686;"Bording";"no";0;0;0;56,168611;9,243611
1687;"Bording";"no";0;0;0;56,168611;9,243611
1688;"Bording";"no";0;0;0;56,168611;9,243611
1689;"Bording";"no";0;0;0;56,168611;9,243611
1690;"Bording";"no";0;0;0;56,168611;9,243611
1691;"Bording";"no";0;0;0;56,168611;9,243611
1692;"Bording";"no";0;0;0;56,168611;9,243611
1693;"Bording";"no";0;0;0;56,168611;9,243611
1694;"Bording";"no";0;0;0;56,168611;9,243611
1695;"Bording";"no";0;0;0;56,168611;9,243611
1696;"Bording";"no";0;0;0;56,168611;9,243611
1697;"Bording";"no";0;0;0;56,168611;9,243611
1698;"Bording";"no";0;0;0;56,168611;9,243611
1699;"Bording";"no";0;0;0;56,168611;9,243611
1700;"Bording";"no";0;0;0;56,168611;9,243611
1701;"Bording";"no";0;0;0;56,168611;9,243611
1702;"Bording";"no";0;0;0;56,168611;9,243611
1703;"Bording";"no";0;0;0;56,168611;9,243611
1704;"Bording";"no";0;0;0;56,168611;9,243611
1705;"Bording";"no";0;0;0;56,168611;9,243611
1706;"Bording";"no";0;0;0;56,168611;9,243611
1707;"Bording";"no";0;0;0;56,168611;9,243611
1708;"Bording";"no";0;0;0;56,168611;9,243611
1709;"Bording";"no";0;0;0;56,168611;9,243611
1710;"Bording";"no";0;0;0;56,168611;9,243611
1711;"Bording";"no";0;0;0;56,168611;9,243611
1712;"Bording";"no";0;0;0;56,168611;9,243611
1713;"Bording";"no";0;0;0;56,168611;9,243611
1714;"Bording";"no";0;0;0;56,168611;9,243611
1715;"Bording";"no";0;0;0;56,168611;9,243611
1716;"Bording";"no";0;0;0;56,168611;9,243611
1717;"Bording";"no";0;0;0;56,168611;9,243611
1718;"Bording";"no";0;0;0;56,168611;9,243611
1719;"Bording";"no";0;0;0;56,168611;9,243611
1720;"Bording";"no";0;0;0;56,168611;9,243611
1721;"Bording";"no";0;0;0;56,168611;9,243611
1722;"Bording";"no";0;0;0;56,168611;9,243611
1723;"Bording";"no";0;0;0;56,168611;9,243611
1724;"Bording";"no";1;0;1;56,168611;9,243611
1725;"Bording";"no";0;0;0;56,168611;9,243611
1726;"Bording";"no";0;0;0;56,168611;9,243611
1727;"Bording";"no";1;0;1;56,168611;9,243611
1728;"Bording";"no";0;0;0;56,168611;9,243611
1729;"Bording";"no";0;0;0;56,168611;9,243611
1730;"Bording";"no";0;0;0;56,168611;9,243611
1731;"Bording";"no";0;0;0;56,168611;9,243611
1732;"Bording";"no";0;0;0;56,168611;9,243611
1733;"Bording";"no";0;0;0;56,168611;9,243611
1734;"Bording";"no";0;0;0;56,168611;9,243611
1735;"Bording";"no";0;0;0;56,168611;9,243611
1736;"Bording";"no";0;0;0;56,168611;9,243611
1737;"Bording";"no";0;0;0;56,168611;9,243611
1738;"Bording";"no";0;0;0;56,168611;9,243611
1739;"Bording";"no";0;0;0;56,168611;9,243611
1740;"Bording";"no";0;0;0;56,168611;9,243611
1741;"Bording";"no";0;0;0;56,168611;9,243611
1742;"Bording";"no";0;0;0;56,168611;9,243611
1743;"Bording";"no";0;0;0;56,168611;9,243611
1744;"Bording";"no";0;0;0;56,168611;9,243611
1745;"Bording";"no";0;0;0;56,168611;9,243611
1746;"Bording";"no";0;0;0;56,168611;9,243611
1747;"Bording";"no";0;0;0;56,168611;9,243611
1748;"Bording";"no";0;0;0;56,168611;9,243611
1749;"Bording";"no";0;0;0;56,168611;9,243611
1750;"Bording";"no";0;0;0;56,168611;9,243611
1751;"Bording";"no";0;0;0;56,168611;9,243611
1752;"Bording";"no";0;0;0;56,168611;9,243611
1753;"Bording";"no";0;0;0;56,168611;9,243611
1754;"Bording";"no";0;0;0;56,168611;9,243611
1755;"Bording";"no";0;0;0;56,168611;9,243611
1756;"Bording";"no";0;0;0;56,168611;9,243611
1757;"Bording";"no";0;0;0;56,168611;9,243611
1758;"Bording";"no";0;0;0;56,168611;9,243611
1759;"Bording";"no";0;0;0;56,168611;9,243611
1760;"Bording";"no";0;0;0;56,168611;9,243611
1761;"Bording";"no";0;0;0;56,168611;9,243611
1762;"Bording";"no";0;0;0;56,168611;9,243611
1763;"Bording";"no";0;0;0;56,168611;9,243611
1764;"Bording";"no";0;0;0;56,168611;9,243611
1765;"Bording";"no";0;0;0;56,168611;9,243611
1766;"Bording";"no";0;0;0;56,168611;9,243611
1767;"Bording";"no";0;0;0;56,168611;9,243611
1768;"Bording";"no";0;0;0;56,168611;9,243611
1769;"Bording";"no";0;0;0;56,168611;9,243611
1770;"Bording";"no";0;0;0;56,168611;9,243611
1771;"Bording";"no";0;0;0;56,168611;9,243611
1772;"Bording";"no";0;0;0;56,168611;9,243611
1773;"Bording";"no";0;0;0;56,168611;9,243611
1774;"Bording";"no";0;0;0;56,168611;9,243611
1775;"Bording";"no";0;0;0;56,168611;9,243611
1776;"Bording";"no";0;0;0;56,168611;9,243611
1777;"Bording";"no";0;0;0;56,168611;9,243611
1778;"Bording";"no";0;0;0;56,168611;9,243611
1779;"Bording";"no";0;0;0;56,168611;9,243611
1780;"Bording";"no";0;0;0;56,168611;9,243611
1781;"Bording";"no";0;0;0;56,168611;9,243611
1782;"Bording";"no";0;0;0;56,168611;9,243611
1783;"Bording";"no";0;0;0;56,168611;9,243611
1784;"Bording";"no";0;0;0;56,168611;9,243611
1785;"Bording";"no";0;0;0;56,168611;9,243611
1786;"Bording";"no";0;0;0;56,168611;9,243611
1787;"Bording";"no";0;0;0;56,168611;9,243611
1788;"Bording";"no";0;0;0;56,168611;9,243611
1789;"Bording";"no";0;0;0;56,168611;9,243611
1790;"Bording";"no";0;0;0;56,168611;9,243611
1791;"Bording";"no";0;0;0;56,168611;9,243611
1792;"Bording";"no";0;0;0;56,168611;9,243611
1793;"Bording";"no";0;0;0;56,168611;9,243611
1794;"Bording";"no";0;0;0;56,168611;9,243611
1795;"Bording";"no";0;0;0;56,168611;9,243611
1796;"Bording";"no";0;0;0;56,168611;9,243611
1797;"Bording";"no";0;0;0;56,168611;9,243611
1798;"Bording";"no";0;0;0;56,168611;9,243611
1799;"Bording";"no";0;0;0;56,168611;9,243611
1800;"Bording";"no";0;0;0;56,168611;9,243611
1801;"Bording";"no";0;0;0;56,168611;9,243611
1802;"Bording";"no";0;0;0;56,168611;9,243611
1803;"Bording";"no";0;0;0;56,168611;9,243611
1804;"Bording";"no";0;0;0;56,168611;9,243611
1805;"Bording";"no";0;0;0;56,168611;9,243611
1806;"Bording";"no";0;0;0;56,168611;9,243611
1807;"Bording";"no";0;0;0;56,168611;9,243611
1808;"Bording";"no";0;0;0;56,168611;9,243611
1809;"Bording";"no";0;0;0;56,168611;9,243611
1810;"Bording";"no";0;0;0;56,168611;9,243611
1811;"Bording";"no";0;0;0;56,168611;9,243611
1812;"Bording";"no";0;0;0;56,168611;9,243611
1813;"Bording";"no";0;0;0;56,168611;9,243611
1814;"Bording";"no";0;0;0;56,168611;9,243611
1815;"Bording";"no";0;0;0;56,168611;9,243611
1816;"Bording";"no";0;0;0;56,168611;9,243611
1817;"Bording";"no";0;0;0;56,168611;9,243611
1818;"Bording";"no";0;0;0;56,168611;9,243611
1819;"Bording";"no";0;0;0;56,168611;9,243611
1820;"Bording";"no";0;0;0;56,168611;9,243611
1821;"Bording";"no";0;0;0;56,168611;9,243611
1822;"Bording";"no";0;0;0;56,168611;9,243611
1823;"Bording";"no";0;0;0;56,168611;9,243611
1824;"Bording";"no";0;0;0;56,168611;9,243611
1825;"Bording";"no";0;0;0;56,168611;9,243611
1826;"Bording";"no";0;0;0;56,168611;9,243611
1827;"Bording";"no";0;0;0;56,168611;9,243611
1828;"Bording";"no";0;0;0;56,168611;9,243611
1829;"Bording";"no";0;0;0;56,168611;9,243611
1830;"Bording";"no";0;0;0;56,168611;9,243611
1831;"Bording";"no";0;0;0;56,168611;9,243611
1832;"Bording";"no";0;0;0;56,168611;9,243611
1833;"Bording";"no";0;0;0;56,168611;9,243611
1834;"Bording";"no";0;0;0;56,168611;9,243611
1835;"Bording";"no";0;0;0;56,168611;9,243611
1836;"Bording";"no";0;0;0;56,168611;9,243611
1837;"Bording";"no";0;0;0;56,168611;9,243611
1838;"Bording";"no";0;0;0;56,168611;9,243611
1839;"Bording";"no";0;0;0;56,168611;9,243611
1840;"Bording";"no";0;0;0;56,168611;9,243611
1841;"Bording";"no";0;0;0;56,168611;9,243611
1842;"Bording";"no";0;0;0;56,168611;9,243611
1843;"Bording";"no";0;0;0;56,168611;9,243611
1844;"Bording";"no";0;0;0;56,168611;9,243611
1845;"Bording";"no";0;0;0;56,168611;9,243611
1846;"Bording";"no";0;0;0;56,168611;9,243611
1847;"Bording";"no";0;0;0;56,168611;9,243611
1848;"Bording";"no";0;0;0;56,168611;9,243611
1849;"Bording";"no";0;0;0;56,168611;9,243611
1850;"Bording";"no";0;0;0;56,168611;9,243611
1851;"Bording";"no";0;0;0;56,168611;9,243611
1852;"Bording";"no";0;0;0;56,168611;9,243611
1853;"Bording";"no";0;0;0;56,168611;9,243611
1854;"Bording";"no";0;0;0;56,168611;9,243611
1855;"Bording";"no";0;0;0;56,168611;9,243611
1856;"Bording";"no";0;0;0;56,168611;9,243611
1857;"Bording";"no";0;0;0;56,168611;9,243611
1634;"Als";"no";0;0;0;56,75;10,3
1635;"Als";"no";0;0;0;56,75;10,3
1636;"Als";"no";0;0;0;56,75;10,3
1637;"Als";"no";0;0;0;56,75;10,3
1638;"Als";"no";0;0;0;56,75;10,3
1639;"Als";"no";0;0;0;56,75;10,3
1640;"Als";"no";0;0;0;56,75;10,3
1641;"Als";"no";0;0;0;56,75;10,3
1642;"Als";"no";0;0;0;56,75;10,3
1643;"Als";"no";0;0;0;56,75;10,3
1644;"Als";"no";0;0;0;56,75;10,3
1645;"Als";"no";0;0;0;56,75;10,3
1646;"Als";"no";0;0;0;56,75;10,3
1647;"Als";"no";0;0;0;56,75;10,3
1648;"Als";"no";0;0;0;56,75;10,3
1649;"Als";"no";0;0;0;56,75;10,3
1650;"Als";"no";0;0;0;56,75;10,3
1651;"Als";"no";0;0;0;56,75;10,3
1652;"Als";"no";0;0;0;56,75;10,3
1653;"Als";"no";0;0;0;56,75;10,3
1654;"Als";"no";0;0;0;56,75;10,3
1655;"Als";"no";0;0;0;56,75;10,3
1656;"Als";"no";0;0;0;56,75;10,3
1657;"Als";"no";0;0;0;56,75;10,3
1658;"Als";"no";0;0;0;56,75;10,3
1659;"Als";"no";0;0;0;56,75;10,3
1660;"Als";"no";0;0;0;56,75;10,3
1661;"Als";"no";0;0;0;56,75;10,3
1662;"Als";"no";0;0;0;56,75;10,3
1663;"Als";"no";0;0;0;56,75;10,3
1664;"Als";"no";0;0;0;56,75;10,3
1665;"Als";"no";0;0;0;56,75;10,3
1666;"Als";"no";0;0;0;56,75;10,3
1667;"Als";"no";0;0;0;56,75;10,3
1668;"Als";"no";0;0;0;56,75;10,3
1669;"Als";"no";0;0;0;56,75;10,3
1670;"Als";"no";0;0;0;56,75;10,3
1671;"Als";"no";0;0;0;56,75;10,3
1672;"Als";"no";0;0;0;56,75;10,3
1673;"Als";"no";0;0;0;56,75;10,3
1674;"Als";"no";0;0;0;56,75;10,3
1675;"Als";"no";0;0;0;56,75;10,3
1676;"Als";"no";0;0;0;56,75;10,3
1677;"Als";"no";0;0;0;56,75;10,3
1678;"Als";"no";0;0;0;56,75;10,3
1679;"Als";"no";0;0;0;56,75;10,3
1680;"Als";"no";0;0;0;56,75;10,3
1681;"Als";"no";0;0;0;56,75;10,3
1682;"Als";"no";0;0;0;56,75;10,3
1683;"Als";"no";0;0;0;56,75;10,3
1684;"Als";"no";0;0;0;56,75;10,3
1685;"Als";"no";0;0;0;56,75;10,3
1686;"Als";"no";0;0;0;56,75;10,3
1687;"Als";"no";0;0;0;56,75;10,3
1688;"Als";"no";0;0;0;56,75;10,3
1689;"Als";"no";0;0;0;56,75;10,3
1690;"Als";"no";0;0;0;56,75;10,3
1691;"Als";"no";0;0;0;56,75;10,3
1692;"Als";"no";0;0;0;56,75;10,3
1693;"Als";"no";0;0;0;56,75;10,3
1694;"Als";"no";0;0;0;56,75;10,3
1695;"Als";"no";0;0;0;56,75;10,3
1696;"Als";"no";0;0;0;56,75;10,3
1697;"Als";"no";0;0;0;56,75;10,3
1698;"Als";"no";0;0;0;56,75;10,3
1699;"Als";"no";0;0;0;56,75;10,3
1700;"Als";"no";0;0;0;56,75;10,3
1701;"Als";"no";0;0;0;56,75;10,3
1702;"Als";"no";0;0;0;56,75;10,3
1703;"Als";"no";0;0;0;56,75;10,3
1704;"Als";"no";0;0;0;56,75;10,3
1705;"Als";"no";0;0;0;56,75;10,3
1706;"Als";"no";0;0;0;56,75;10,3
1707;"Als";"no";0;0;0;56,75;10,3
1708;"Als";"no";0;0;0;56,75;10,3
1709;"Als";"no";0;0;0;56,75;10,3
1710;"Als";"no";0;0;0;56,75;10,3
1711;"Als";"no";0;0;0;56,75;10,3
1712;"Als";"no";0;0;0;56,75;10,3
1713;"Als";"no";0;0;0;56,75;10,3
1714;"Als";"no";0;0;0;56,75;10,3
1715;"Als";"no";0;0;0;56,75;10,3
1716;"Als";"no";0;0;0;56,75;10,3
1717;"Als";"no";0;0;0;56,75;10,3
1718;"Als";"no";0;0;0;56,75;10,3
1719;"Als";"no";0;0;0;56,75;10,3
1720;"Als";"no";0;0;0;56,75;10,3
1721;"Als";"no";0;0;0;56,75;10,3
1722;"Als";"no";0;0;0;56,75;10,3
1723;"Als";"no";0;0;0;56,75;10,3
1724;"Als";"no";0;0;0;56,75;10,3
1725;"Als";"no";1;0;1;56,75;10,3
1726;"Als";"no";0;0;0;56,75;10,3
1727;"Als";"no";0;0;0;56,75;10,3
1728;"Als";"no";0;0;0;56,75;10,3
1729;"Als";"no";0;0;0;56,75;10,3
1730;"Als";"no";0;0;0;56,75;10,3
1731;"Als";"no";0;0;0;56,75;10,3
1732;"Als";"no";0;0;0;56,75;10,3
1733;"Als";"no";0;0;0;56,75;10,3
1734;"Als";"no";0;0;0;56,75;10,3
1735;"Als";"no";0;0;0;56,75;10,3
1736;"Als";"no";0;0;0;56,75;10,3
1737;"Als";"no";0;0;0;56,75;10,3
1738;"Als";"no";0;0;0;56,75;10,3
1739;"Als";"no";0;0;0;56,75;10,3
1740;"Als";"no";0;0;0;56,75;10,3
1741;"Als";"no";0;0;0;56,75;10,3
1742;"Als";"no";0;0;0;56,75;10,3
1743;"Als";"no";0;0;0;56,75;10,3
1744;"Als";"no";0;0;0;56,75;10,3
1745;"Als";"no";0;0;0;56,75;10,3
1746;"Als";"no";0;0;0;56,75;10,3
1747;"Als";"no";0;0;0;56,75;10,3
1748;"Als";"no";0;0;0;56,75;10,3
1749;"Als";"no";0;0;0;56,75;10,3
1750;"Als";"no";0;0;0;56,75;10,3
1751;"Als";"no";0;0;0;56,75;10,3
1752;"Als";"no";0;0;0;56,75;10,3
1753;"Als";"no";0;0;0;56,75;10,3
1754;"Als";"no";0;0;0;56,75;10,3
1755;"Als";"no";0;0;0;56,75;10,3
1756;"Als";"no";0;0;0;56,75;10,3
1757;"Als";"no";0;0;0;56,75;10,3
1758;"Als";"no";0;0;0;56,75;10,3
1759;"Als";"no";0;0;0;56,75;10,3
1760;"Als";"no";0;0;0;56,75;10,3
1761;"Als";"no";0;0;0;56,75;10,3
1762;"Als";"no";0;0;0;56,75;10,3
1763;"Als";"no";0;0;0;56,75;10,3
1764;"Als";"no";0;0;0;56,75;10,3
1765;"Als";"no";0;0;0;56,75;10,3
1766;"Als";"no";0;0;0;56,75;10,3
1767;"Als";"no";0;0;0;56,75;10,3
1768;"Als";"no";0;0;0;56,75;10,3
1769;"Als";"no";0;0;0;56,75;10,3
1770;"Als";"no";0;0;0;56,75;10,3
1771;"Als";"no";0;0;0;56,75;10,3
1772;"Als";"no";0;0;0;56,75;10,3
1773;"Als";"no";0;0;0;56,75;10,3
1774;"Als";"no";0;0;0;56,75;10,3
1775;"Als";"no";0;0;0;56,75;10,3
1776;"Als";"no";0;0;0;56,75;10,3
1777;"Als";"no";0;0;0;56,75;10,3
1778;"Als";"no";0;0;0;56,75;10,3
1779;"Als";"no";0;0;0;56,75;10,3
1780;"Als";"no";0;0;0;56,75;10,3
1781;"Als";"no";0;0;0;56,75;10,3
1782;"Als";"no";0;0;0;56,75;10,3
1783;"Als";"no";1;0;1;56,75;10,3
1784;"Als";"no";0;0;0;56,75;10,3
1785;"Als";"no";0;0;0;56,75;10,3
1786;"Als";"no";0;0;0;56,75;10,3
1787;"Als";"no";0;0;0;56,75;10,3
1788;"Als";"no";0;0;0;56,75;10,3
1789;"Als";"no";0;0;0;56,75;10,3
1790;"Als";"no";0;0;0;56,75;10,3
1791;"Als";"no";0;0;0;56,75;10,3
1792;"Als";"no";0;0;0;56,75;10,3
1793;"Als";"no";0;0;0;56,75;10,3
1794;"Als";"no";0;0;0;56,75;10,3
1795;"Als";"no";0;0;0;56,75;10,3
1796;"Als";"no";0;0;0;56,75;10,3
1797;"Als";"no";0;0;0;56,75;10,3
1798;"Als";"no";0;0;0;56,75;10,3
1799;"Als";"no";0;0;0;56,75;10,3
1800;"Als";"no";0;0;0;56,75;10,3
1801;"Als";"no";0;0;0;56,75;10,3
1802;"Als";"no";0;0;0;56,75;10,3
1803;"Als";"no";0;0;0;56,75;10,3
1804;"Als";"no";0;0;0;56,75;10,3
1805;"Als";"no";0;0;0;56,75;10,3
1806;"Als";"no";0;0;0;56,75;10,3
1807;"Als";"no";0;0;0;56,75;10,3
1808;"Als";"no";0;0;0;56,75;10,3
1809;"Als";"no";0;0;0;56,75;10,3
1810;"Als";"no";0;0;0;56,75;10,3
1811;"Als";"no";0;0;0;56,75;10,3
1812;"Als";"no";0;0;0;56,75;10,3
1813;"Als";"no";0;0;0;56,75;10,3
1814;"Als";"no";0;0;0;56,75;10,3
1815;"Als";"no";0;0;0;56,75;10,3
1816;"Als";"no";0;0;0;56,75;10,3
1817;"Als";"no";0;0;0;56,75;10,3
1818;"Als";"no";0;0;0;56,75;10,3
1819;"Als";"no";0;0;0;56,75;10,3
1820;"Als";"no";0;0;0;56,75;10,3
1821;"Als";"no";0;0;0;56,75;10,3
1822;"Als";"no";0;0;0;56,75;10,3
1823;"Als";"no";0;0;0;56,75;10,3
1824;"Als";"no";0;0;0;56,75;10,3
1825;"Als";"no";0;0;0;56,75;10,3
1826;"Als";"no";0;0;0;56,75;10,3
1827;"Als";"no";0;0;0;56,75;10,3
1828;"Als";"no";0;0;0;56,75;10,3
1829;"Als";"no";0;0;0;56,75;10,3
1830;"Als";"no";0;0;0;56,75;10,3
1831;"Als";"no";0;0;0;56,75;10,3
1832;"Als";"no";0;0;0;56,75;10,3
1833;"Als";"no";0;0;0;56,75;10,3
1834;"Als";"no";0;0;0;56,75;10,3
1835;"Als";"no";0;0;0;56,75;10,3
1836;"Als";"no";0;0;0;56,75;10,3
1837;"Als";"no";0;0;0;56,75;10,3
1838;"Als";"no";0;0;0;56,75;10,3
1839;"Als";"no";0;0;0;56,75;10,3
1840;"Als";"no";0;0;0;56,75;10,3
1841;"Als";"no";0;0;0;56,75;10,3
1842;"Als";"no";0;0;0;56,75;10,3
1843;"Als";"no";0;0;0;56,75;10,3
1844;"Als";"no";0;0;0;56,75;10,3
1845;"Als";"no";0;0;0;56,75;10,3
1846;"Als";"no";0;0;0;56,75;10,3
1847;"Als";"no";0;0;0;56,75;10,3
1848;"Als";"no";0;0;0;56,75;10,3
1849;"Als";"no";0;0;0;56,75;10,3
1850;"Als";"no";0;0;0;56,75;10,3
1851;"Als";"no";0;0;0;56,75;10,3
1852;"Als";"no";0;0;0;56,75;10,3
1853;"Als";"no";0;0;0;56,75;10,3
1854;"Als";"no";0;0;0;56,75;10,3
1855;"Als";"no";0;0;0;56,75;10,3
1856;"Als";"no";0;0;0;56,75;10,3
1857;"Als";"no";0;0;0;56,75;10,3
1634;"Stevens Klint";"no";0;0;0;55,279518;12,446236
1635;"Stevens Klint";"no";0;0;0;55,279518;12,446236
1636;"Stevens Klint";"no";0;0;0;55,279518;12,446236
1637;"Stevens Klint";"no";0;0;0;55,279518;12,446236
1638;"Stevens Klint";"no";0;0;0;55,279518;12,446236
1639;"Stevens Klint";"no";0;0;0;55,279518;12,446236
1640;"Stevens Klint";"no";0;0;0;55,279518;12,446236
1641;"Stevens Klint";"no";0;0;0;55,279518;12,446236
1642;"Stevens Klint";"no";0;0;0;55,279518;12,446236
1643;"Stevens Klint";"no";0;0;0;55,279518;12,446236
1644;"Stevens Klint";"no";0;0;0;55,279518;12,446236
1645;"Stevens Klint";"no";0;0;0;55,279518;12,446236
1646;"Stevens Klint";"no";0;0;0;55,279518;12,446236
1647;"Stevens Klint";"no";0;0;0;55,279518;12,446236
1648;"Stevens Klint";"no";0;0;0;55,279518;12,446236
1649;"Stevens Klint";"no";0;0;0;55,279518;12,446236
1650;"Stevens Klint";"no";0;0;0;55,279518;12,446236
1651;"Stevens Klint";"no";0;0;0;55,279518;12,446236
1652;"Stevens Klint";"no";0;0;0;55,279518;12,446236
1653;"Stevens Klint";"no";0;0;0;55,279518;12,446236
1654;"Stevens Klint";"no";0;0;0;55,279518;12,446236
1655;"Stevens Klint";"no";0;0;0;55,279518;12,446236
1656;"Stevens Klint";"no";0;0;0;55,279518;12,446236
1657;"Stevens Klint";"no";0;0;0;55,279518;12,446236
1658;"Stevens Klint";"no";0;0;0;55,279518;12,446236
1659;"Stevens Klint";"no";0;0;0;55,279518;12,446236
1660;"Stevens Klint";"no";0;0;0;55,279518;12,446236
1661;"Stevens Klint";"no";0;0;0;55,279518;12,446236
1662;"Stevens Klint";"no";0;0;0;55,279518;12,446236
1663;"Stevens Klint";"no";0;0;0;55,279518;12,446236
1664;"Stevens Klint";"no";0;0;0;55,279518;12,446236
1665;"Stevens Klint";"no";0;0;0;55,279518;12,446236
1666;"Stevens Klint";"no";0;0;0;55,279518;12,446236
1667;"Stevens Klint";"no";0;0;0;55,279518;12,446236
1668;"Stevens Klint";"no";0;0;0;55,279518;12,446236
1669;"Stevens Klint";"no";0;0;0;55,279518;12,446236
1670;"Stevens Klint";"no";0;0;0;55,279518;12,446236
1671;"Stevens Klint";"no";0;0;0;55,279518;12,446236
1672;"Stevens Klint";"no";0;0;0;55,279518;12,446236
1673;"Stevens Klint";"no";0;0;0;55,279518;12,446236
1674;"Stevens Klint";"no";0;0;0;55,279518;12,446236
1675;"Stevens Klint";"no";0;0;0;55,279518;12,446236
1676;"Stevens Klint";"no";0;0;0;55,279518;12,446236
1677;"Stevens Klint";"no";0;0;0;55,279518;12,446236
1678;"Stevens Klint";"no";0;0;0;55,279518;12,446236
1679;"Stevens Klint";"no";0;0;0;55,279518;12,446236
1680;"Stevens Klint";"no";0;0;0;55,279518;12,446236
1681;"Stevens Klint";"no";0;0;0;55,279518;12,446236
1682;"Stevens Klint";"no";0;0;0;55,279518;12,446236
1683;"Stevens Klint";"no";0;0;0;55,279518;12,446236
1684;"Stevens Klint";"no";0;0;0;55,279518;12,446236
1685;"Stevens Klint";"no";0;0;0;55,279518;12,446236
1686;"Stevens Klint";"no";0;0;0;55,279518;12,446236
1687;"Stevens Klint";"no";0;0;0;55,279518;12,446236
1688;"Stevens Klint";"no";0;0;0;55,279518;12,446236
1689;"Stevens Klint";"no";0;0;0;55,279518;12,446236
1690;"Stevens Klint";"no";0;0;0;55,279518;12,446236
1691;"Stevens Klint";"no";0;0;0;55,279518;12,446236
1692;"Stevens Klint";"no";0;0;0;55,279518;12,446236
1693;"Stevens Klint";"no";0;0;0;55,279518;12,446236
1694;"Stevens Klint";"no";0;0;0;55,279518;12,446236
1695;"Stevens Klint";"no";0;0;0;55,279518;12,446236
1696;"Stevens Klint";"no";0;0;0;55,279518;12,446236
1697;"Stevens Klint";"no";0;0;0;55,279518;12,446236
1698;"Stevens Klint";"no";0;0;0;55,279518;12,446236
1699;"Stevens Klint";"no";0;0;0;55,279518;12,446236
1700;"Stevens Klint";"no";0;0;0;55,279518;12,446236
1701;"Stevens Klint";"no";0;0;0;55,279518;12,446236
1702;"Stevens Klint";"no";0;0;0;55,279518;12,446236
1703;"Stevens Klint";"no";0;0;0;55,279518;12,446236
1704;"Stevens Klint";"no";0;0;0;55,279518;12,446236
1705;"Stevens Klint";"no";0;0;0;55,279518;12,446236
1706;"Stevens Klint";"no";0;0;0;55,279518;12,446236
1707;"Stevens Klint";"no";0;0;0;55,279518;12,446236
1708;"Stevens Klint";"no";0;0;0;55,279518;12,446236
1709;"Stevens Klint";"no";0;0;0;55,279518;12,446236
1710;"Stevens Klint";"no";0;0;0;55,279518;12,446236
1711;"Stevens Klint";"no";0;0;0;55,279518;12,446236
1712;"Stevens Klint";"no";0;0;0;55,279518;12,446236
1713;"Stevens Klint";"no";0;0;0;55,279518;12,446236
1714;"Stevens Klint";"no";0;0;0;55,279518;12,446236
1715;"Stevens Klint";"no";0;0;0;55,279518;12,446236
1716;"Stevens Klint";"no";0;0;0;55,279518;12,446236
1717;"Stevens Klint";"no";0;0;0;55,279518;12,446236
1718;"Stevens Klint";"no";0;0;0;55,279518;12,446236
1719;"Stevens Klint";"no";0;0;0;55,279518;12,446236
1720;"Stevens Klint";"no";0;0;0;55,279518;12,446236
1721;"Stevens Klint";"no";0;0;0;55,279518;12,446236
1722;"Stevens Klint";"no";0;0;0;55,279518;12,446236
1723;"Stevens Klint";"no";0;0;0;55,279518;12,446236
1724;"Stevens Klint";"no";0;0;0;55,279518;12,446236
1725;"Stevens Klint";"no";0;0;0;55,279518;12,446236
1726;"Stevens Klint";"no";0;0;0;55,279518;12,446236
1727;"Stevens Klint";"no";0;0;0;55,279518;12,446236
1728;"Stevens Klint";"no";0;0;0;55,279518;12,446236
1729;"Stevens Klint";"no";0;0;0;55,279518;12,446236
1730;"Stevens Klint";"no";1;0;1;55,279518;12,446236
1731;"Stevens Klint";"no";0;0;0;55,279518;12,446236
1732;"Stevens Klint";"no";0;0;0;55,279518;12,446236
1733;"Stevens Klint";"no";0;0;0;55,279518;12,446236
1734;"Stevens Klint";"no";0;0;0;55,279518;12,446236
1735;"Stevens Klint";"no";0;0;0;55,279518;12,446236
1736;"Stevens Klint";"no";0;0;0;55,279518;12,446236
1737;"Stevens Klint";"no";0;0;0;55,279518;12,446236
1738;"Stevens Klint";"no";0;0;0;55,279518;12,446236
1739;"Stevens Klint";"no";0;0;0;55,279518;12,446236
1740;"Stevens Klint";"no";0;0;0;55,279518;12,446236
1741;"Stevens Klint";"no";0;0;0;55,279518;12,446236
1742;"Stevens Klint";"no";0;0;0;55,279518;12,446236
1743;"Stevens Klint";"no";0;0;0;55,279518;12,446236
1744;"Stevens Klint";"no";0;0;0;55,279518;12,446236
1745;"Stevens Klint";"no";0;0;0;55,279518;12,446236
1746;"Stevens Klint";"no";0;0;0;55,279518;12,446236
1747;"Stevens Klint";"no";0;0;0;55,279518;12,446236
1748;"Stevens Klint";"no";0;0;0;55,279518;12,446236
1749;"Stevens Klint";"no";0;0;0;55,279518;12,446236
1750;"Stevens Klint";"no";0;0;0;55,279518;12,446236
1751;"Stevens Klint";"no";0;0;0;55,279518;12,446236
1752;"Stevens Klint";"no";0;0;0;55,279518;12,446236
1753;"Stevens Klint";"no";0;0;0;55,279518;12,446236
1754;"Stevens Klint";"no";0;0;0;55,279518;12,446236
1755;"Stevens Klint";"no";0;0;0;55,279518;12,446236
1756;"Stevens Klint";"no";0;0;0;55,279518;12,446236
1757;"Stevens Klint";"no";0;0;0;55,279518;12,446236
1758;"Stevens Klint";"no";0;0;0;55,279518;12,446236
1759;"Stevens Klint";"no";0;0;0;55,279518;12,446236
1760;"Stevens Klint";"no";0;0;0;55,279518;12,446236
1761;"Stevens Klint";"no";0;0;0;55,279518;12,446236
1762;"Stevens Klint";"no";0;0;0;55,279518;12,446236
1763;"Stevens Klint";"no";0;0;0;55,279518;12,446236
1764;"Stevens Klint";"no";0;0;0;55,279518;12,446236
1765;"Stevens Klint";"no";0;0;0;55,279518;12,446236
1766;"Stevens Klint";"no";0;0;0;55,279518;12,446236
1767;"Stevens Klint";"no";0;0;0;55,279518;12,446236
1768;"Stevens Klint";"no";0;0;0;55,279518;12,446236
1769;"Stevens Klint";"no";0;0;0;55,279518;12,446236
1770;"Stevens Klint";"no";0;0;0;55,279518;12,446236
1771;"Stevens Klint";"no";0;0;0;55,279518;12,446236
1772;"Stevens Klint";"no";0;0;0;55,279518;12,446236
1773;"Stevens Klint";"no";0;0;0;55,279518;12,446236
1774;"Stevens Klint";"no";0;0;0;55,279518;12,446236
1775;"Stevens Klint";"no";0;0;0;55,279518;12,446236
1776;"Stevens Klint";"no";0;0;0;55,279518;12,446236
1777;"Stevens Klint";"no";0;0;0;55,279518;12,446236
1778;"Stevens Klint";"no";0;0;0;55,279518;12,446236
1779;"Stevens Klint";"no";0;0;0;55,279518;12,446236
1780;"Stevens Klint";"no";0;0;0;55,279518;12,446236
1781;"Stevens Klint";"no";0;0;0;55,279518;12,446236
1782;"Stevens Klint";"no";0;0;0;55,279518;12,446236
1783;"Stevens Klint";"no";0;0;0;55,279518;12,446236
1784;"Stevens Klint";"no";0;0;0;55,279518;12,446236
1785;"Stevens Klint";"no";1;2;3;55,279518;12,446236
1786;"Stevens Klint";"no";0;0;0;55,279518;12,446236
1787;"Stevens Klint";"no";0;0;0;55,279518;12,446236
1788;"Stevens Klint";"no";0;0;0;55,279518;12,446236
1789;"Stevens Klint";"no";0;0;0;55,279518;12,446236
1790;"Stevens Klint";"no";0;0;0;55,279518;12,446236
1791;"Stevens Klint";"no";0;0;0;55,279518;12,446236
1792;"Stevens Klint";"no";0;0;0;55,279518;12,446236
1793;"Stevens Klint";"no";0;0;0;55,279518;12,446236
1794;"Stevens Klint";"no";0;0;0;55,279518;12,446236
1795;"Stevens Klint";"no";0;0;0;55,279518;12,446236
1796;"Stevens Klint";"no";0;0;0;55,279518;12,446236
1797;"Stevens Klint";"no";0;0;0;55,279518;12,446236
1798;"Stevens Klint";"no";0;0;0;55,279518;12,446236
1799;"Stevens Klint";"no";0;0;0;55,279518;12,446236
1800;"Stevens Klint";"no";0;0;0;55,279518;12,446236
1801;"Stevens Klint";"no";0;0;0;55,279518;12,446236
1802;"Stevens Klint";"no";0;0;0;55,279518;12,446236
1803;"Stevens Klint";"no";0;0;0;55,279518;12,446236
1804;"Stevens Klint";"no";0;0;0;55,279518;12,446236
1805;"Stevens Klint";"no";0;0;0;55,279518;12,446236
1806;"Stevens Klint";"no";0;0;0;55,279518;12,446236
1807;"Stevens Klint";"no";0;0;0;55,279518;12,446236
1808;"Stevens Klint";"no";0;0;0;55,279518;12,446236
1809;"Stevens Klint";"no";0;0;0;55,279518;12,446236
1810;"Stevens Klint";"no";0;0;0;55,279518;12,446236
1811;"Stevens Klint";"no";0;0;0;55,279518;12,446236
1812;"Stevens Klint";"no";0;0;0;55,279518;12,446236
1813;"Stevens Klint";"no";0;0;0;55,279518;12,446236
1814;"Stevens Klint";"no";0;0;0;55,279518;12,446236
1815;"Stevens Klint";"no";0;0;0;55,279518;12,446236
1816;"Stevens Klint";"no";0;0;0;55,279518;12,446236
1817;"Stevens Klint";"no";1;0;1;55,279518;12,446236
1818;"Stevens Klint";"no";0;0;0;55,279518;12,446236
1819;"Stevens Klint";"no";0;0;0;55,279518;12,446236
1820;"Stevens Klint";"no";0;0;0;55,279518;12,446236
1821;"Stevens Klint";"no";0;0;0;55,279518;12,446236
1822;"Stevens Klint";"no";0;0;0;55,279518;12,446236
1823;"Stevens Klint";"no";0;0;0;55,279518;12,446236
1824;"Stevens Klint";"no";0;0;0;55,279518;12,446236
1825;"Stevens Klint";"no";0;0;0;55,279518;12,446236
1826;"Stevens Klint";"no";0;0;0;55,279518;12,446236
1827;"Stevens Klint";"no";0;1;1;55,279518;12,446236
1828;"Stevens Klint";"no";0;0;0;55,279518;12,446236
1829;"Stevens Klint";"no";0;0;0;55,279518;12,446236
1830;"Stevens Klint";"no";0;1;1;55,279518;12,446236
1831;"Stevens Klint";"no";0;0;0;55,279518;12,446236
1832;"Stevens Klint";"no";0;1;1;55,279518;12,446236
1833;"Stevens Klint";"no";0;1;1;55,279518;12,446236
1834;"Stevens Klint";"no";0;1;1;55,279518;12,446236
1835;"Stevens Klint";"no";0;1;1;55,279518;12,446236
1836;"Stevens Klint";"no";0;1;1;55,279518;12,446236
1837;"Stevens Klint";"no";0;1;1;55,279518;12,446236
1838;"Stevens Klint";"no";0;2;2;55,279518;12,446236
1839;"Stevens Klint";"no";0;2;2;55,279518;12,446236
1840;"Stevens Klint";"no";0;1;1;55,279518;12,446236
1841;"Stevens Klint";"no";0;1;1;55,279518;12,446236
1842;"Stevens Klint";"no";0;0;0;55,279518;12,446236
1843;"Stevens Klint";"no";0;0;0;55,279518;12,446236
1844;"Stevens Klint";"no";0;0;0;55,279518;12,446236
1845;"Stevens Klint";"no";0;0;0;55,279518;12,446236
1846;"Stevens Klint";"no";0;0;0;55,279518;12,446236
1847;"Stevens Klint";"no";0;1;1;55,279518;12,446236
1848;"Stevens Klint";"no";0;0;0;55,279518;12,446236
1849;"Stevens Klint";"no";0;0;0;55,279518;12,446236
1850;"Stevens Klint";"no";0;0;0;55,279518;12,446236
1851;"Stevens Klint";"no";0;0;0;55,279518;12,446236
1852;"Stevens Klint";"no";0;0;0;55,279518;12,446236
1853;"Stevens Klint";"no";0;0;0;55,279518;12,446236
1854;"Stevens Klint";"no";0;0;0;55,279518;12,446236
1855;"Stevens Klint";"no";0;0;0;55,279518;12,446236
1856;"Stevens Klint";"no";0;0;0;55,279518;12,446236
1857;"Stevens Klint";"no";0;0;0;55,279518;12,446236
1634;"Nordborg";"no";0;0;0;55,05;9,75
1635;"Nordborg";"no";0;0;0;55,05;9,75
1636;"Nordborg";"no";0;0;0;55,05;9,75
1637;"Nordborg";"no";0;0;0;55,05;9,75
1638;"Nordborg";"no";0;0;0;55,05;9,75
1639;"Nordborg";"no";0;0;0;55,05;9,75
1640;"Nordborg";"no";0;0;0;55,05;9,75
1641;"Nordborg";"no";0;0;0;55,05;9,75
1642;"Nordborg";"no";0;0;0;55,05;9,75
1643;"Nordborg";"no";0;0;0;55,05;9,75
1644;"Nordborg";"no";0;0;0;55,05;9,75
1645;"Nordborg";"no";0;0;0;55,05;9,75
1646;"Nordborg";"no";0;0;0;55,05;9,75
1647;"Nordborg";"no";0;0;0;55,05;9,75
1648;"Nordborg";"no";0;0;0;55,05;9,75
1649;"Nordborg";"no";0;0;0;55,05;9,75
1650;"Nordborg";"no";0;0;0;55,05;9,75
1651;"Nordborg";"no";0;0;0;55,05;9,75
1652;"Nordborg";"no";0;0;0;55,05;9,75
1653;"Nordborg";"no";0;0;0;55,05;9,75
1654;"Nordborg";"no";0;0;0;55,05;9,75
1655;"Nordborg";"no";0;0;0;55,05;9,75
1656;"Nordborg";"no";0;0;0;55,05;9,75
1657;"Nordborg";"no";0;0;0;55,05;9,75
1658;"Nordborg";"no";0;0;0;55,05;9,75
1659;"Nordborg";"no";0;0;0;55,05;9,75
1660;"Nordborg";"no";0;0;0;55,05;9,75
1661;"Nordborg";"no";0;0;0;55,05;9,75
1662;"Nordborg";"no";0;0;0;55,05;9,75
1663;"Nordborg";"no";0;0;0;55,05;9,75
1664;"Nordborg";"no";0;0;0;55,05;9,75
1665;"Nordborg";"no";0;0;0;55,05;9,75
1666;"Nordborg";"no";0;0;0;55,05;9,75
1667;"Nordborg";"no";0;0;0;55,05;9,75
1668;"Nordborg";"no";0;0;0;55,05;9,75
1669;"Nordborg";"no";0;0;0;55,05;9,75
1670;"Nordborg";"no";0;0;0;55,05;9,75
1671;"Nordborg";"no";0;0;0;55,05;9,75
1672;"Nordborg";"no";0;0;0;55,05;9,75
1673;"Nordborg";"no";0;0;0;55,05;9,75
1674;"Nordborg";"no";0;0;0;55,05;9,75
1675;"Nordborg";"no";0;0;0;55,05;9,75
1676;"Nordborg";"no";0;0;0;55,05;9,75
1677;"Nordborg";"no";0;0;0;55,05;9,75
1678;"Nordborg";"no";0;0;0;55,05;9,75
1679;"Nordborg";"no";0;0;0;55,05;9,75
1680;"Nordborg";"no";0;0;0;55,05;9,75
1681;"Nordborg";"no";0;0;0;55,05;9,75
1682;"Nordborg";"no";0;0;0;55,05;9,75
1683;"Nordborg";"no";0;0;0;55,05;9,75
1684;"Nordborg";"no";0;0;0;55,05;9,75
1685;"Nordborg";"no";0;0;0;55,05;9,75
1686;"Nordborg";"no";0;0;0;55,05;9,75
1687;"Nordborg";"no";0;0;0;55,05;9,75
1688;"Nordborg";"no";0;0;0;55,05;9,75
1689;"Nordborg";"no";0;0;0;55,05;9,75
1690;"Nordborg";"no";0;0;0;55,05;9,75
1691;"Nordborg";"no";0;0;0;55,05;9,75
1692;"Nordborg";"no";0;0;0;55,05;9,75
1693;"Nordborg";"no";0;0;0;55,05;9,75
1694;"Nordborg";"no";0;0;0;55,05;9,75
1695;"Nordborg";"no";0;0;0;55,05;9,75
1696;"Nordborg";"no";0;0;0;55,05;9,75
1697;"Nordborg";"no";0;0;0;55,05;9,75
1698;"Nordborg";"no";0;0;0;55,05;9,75
1699;"Nordborg";"no";0;0;0;55,05;9,75
1700;"Nordborg";"no";0;0;0;55,05;9,75
1701;"Nordborg";"no";0;0;0;55,05;9,75
1702;"Nordborg";"no";0;0;0;55,05;9,75
1703;"Nordborg";"no";0;0;0;55,05;9,75
1704;"Nordborg";"no";0;0;0;55,05;9,75
1705;"Nordborg";"no";0;0;0;55,05;9,75
1706;"Nordborg";"no";0;0;0;55,05;9,75
1707;"Nordborg";"no";0;0;0;55,05;9,75
1708;"Nordborg";"no";0;0;0;55,05;9,75
1709;"Nordborg";"no";0;0;0;55,05;9,75
1710;"Nordborg";"no";0;0;0;55,05;9,75
1711;"Nordborg";"no";0;0;0;55,05;9,75
1712;"Nordborg";"no";0;0;0;55,05;9,75
1713;"Nordborg";"no";0;0;0;55,05;9,75
1714;"Nordborg";"no";0;0;0;55,05;9,75
1715;"Nordborg";"no";0;0;0;55,05;9,75
1716;"Nordborg";"no";0;1;1;55,05;9,75
1717;"Nordborg";"no";0;0;0;55,05;9,75
1718;"Nordborg";"no";0;0;0;55,05;9,75
1719;"Nordborg";"no";0;0;0;55,05;9,75
1720;"Nordborg";"no";0;0;0;55,05;9,75
1721;"Nordborg";"no";0;0;0;55,05;9,75
1722;"Nordborg";"no";0;0;0;55,05;9,75
1723;"Nordborg";"no";0;0;0;55,05;9,75
1724;"Nordborg";"no";0;0;0;55,05;9,75
1725;"Nordborg";"no";0;0;0;55,05;9,75
1726;"Nordborg";"no";0;0;0;55,05;9,75
1727;"Nordborg";"no";0;0;0;55,05;9,75
1728;"Nordborg";"no";0;0;0;55,05;9,75
1729;"Nordborg";"no";0;0;0;55,05;9,75
1730;"Nordborg";"no";0;0;0;55,05;9,75
1731;"Nordborg";"no";0;0;0;55,05;9,75
1732;"Nordborg";"no";0;0;0;55,05;9,75
1733;"Nordborg";"no";0;0;0;55,05;9,75
1734;"Nordborg";"no";0;0;0;55,05;9,75
1735;"Nordborg";"no";0;0;0;55,05;9,75
1736;"Nordborg";"no";0;0;0;55,05;9,75
1737;"Nordborg";"no";0;0;0;55,05;9,75
1738;"Nordborg";"no";0;0;0;55,05;9,75
1739;"Nordborg";"no";0;0;0;55,05;9,75
1740;"Nordborg";"no";0;0;0;55,05;9,75
1741;"Nordborg";"no";0;0;0;55,05;9,75
1742;"Nordborg";"no";0;0;0;55,05;9,75
1743;"Nordborg";"no";0;0;0;55,05;9,75
1744;"Nordborg";"no";0;0;0;55,05;9,75
1745;"Nordborg";"no";0;0;0;55,05;9,75
1746;"Nordborg";"no";0;0;0;55,05;9,75
1747;"Nordborg";"no";0;0;0;55,05;9,75
1748;"Nordborg";"no";0;0;0;55,05;9,75
1749;"Nordborg";"no";0;0;0;55,05;9,75
1750;"Nordborg";"no";0;0;0;55,05;9,75
1751;"Nordborg";"no";0;0;0;55,05;9,75
1752;"Nordborg";"no";0;0;0;55,05;9,75
1753;"Nordborg";"no";0;0;0;55,05;9,75
1754;"Nordborg";"no";0;0;0;55,05;9,75
1755;"Nordborg";"no";0;0;0;55,05;9,75
1756;"Nordborg";"no";0;0;0;55,05;9,75
1757;"Nordborg";"no";0;0;0;55,05;9,75
1758;"Nordborg";"no";0;0;0;55,05;9,75
1759;"Nordborg";"no";0;0;0;55,05;9,75
1760;"Nordborg";"no";0;0;0;55,05;9,75
1761;"Nordborg";"no";0;0;0;55,05;9,75
1762;"Nordborg";"no";0;0;0;55,05;9,75
1763;"Nordborg";"no";0;0;0;55,05;9,75
1764;"Nordborg";"no";0;0;0;55,05;9,75
1765;"Nordborg";"no";0;0;0;55,05;9,75
1766;"Nordborg";"no";0;0;0;55,05;9,75
1767;"Nordborg";"no";0;0;0;55,05;9,75
1768;"Nordborg";"no";0;0;0;55,05;9,75
1769;"Nordborg";"no";0;0;0;55,05;9,75
1770;"Nordborg";"no";0;0;0;55,05;9,75
1771;"Nordborg";"no";0;0;0;55,05;9,75
1772;"Nordborg";"no";0;0;0;55,05;9,75
1773;"Nordborg";"no";0;0;0;55,05;9,75
1774;"Nordborg";"no";0;0;0;55,05;9,75
1775;"Nordborg";"no";1;0;1;55,05;9,75
1776;"Nordborg";"no";0;0;0;55,05;9,75
1777;"Nordborg";"no";0;0;0;55,05;9,75
1778;"Nordborg";"no";0;0;0;55,05;9,75
1779;"Nordborg";"no";0;1;1;55,05;9,75
1780;"Nordborg";"no";0;0;0;55,05;9,75
1781;"Nordborg";"no";0;0;0;55,05;9,75
1782;"Nordborg";"no";0;0;0;55,05;9,75
1783;"Nordborg";"no";0;0;0;55,05;9,75
1784;"Nordborg";"no";0;0;0;55,05;9,75
1785;"Nordborg";"no";0;0;0;55,05;9,75
1786;"Nordborg";"no";0;0;0;55,05;9,75
1787;"Nordborg";"no";0;0;0;55,05;9,75
1788;"Nordborg";"no";1;1;2;55,05;9,75
1789;"Nordborg";"no";1;0;1;55,05;9,75
1790;"Nordborg";"no";1;1;2;55,05;9,75
1791;"Nordborg";"no";0;1;1;55,05;9,75
1792;"Nordborg";"no";0;0;0;55,05;9,75
1793;"Nordborg";"no";2;0;2;55,05;9,75
1794;"Nordborg";"no";1;0;1;55,05;9,75
1795;"Nordborg";"no";1;0;1;55,05;9,75
1796;"Nordborg";"no";3;0;3;55,05;9,75
1797;"Nordborg";"no";3;0;3;55,05;9,75
1798;"Nordborg";"no";3;1;4;55,05;9,75
1799;"Nordborg";"no";4;0;4;55,05;9,75
1800;"Nordborg";"no";4;0;4;55,05;9,75
1801;"Nordborg";"no";2;1;3;55,05;9,75
1802;"Nordborg";"no";2;0;2;55,05;9,75
1803;"Nordborg";"no";3;0;3;55,05;9,75
1804;"Nordborg";"no";3;1;4;55,05;9,75
1805;"Nordborg";"no";2;0;2;55,05;9,75
1806;"Nordborg";"no";3;0;3;55,05;9,75
1807;"Nordborg";"no";0;0;0;55,05;9,75
1808;"Nordborg";"no";0;0;0;55,05;9,75
1809;"Nordborg";"no";0;0;0;55,05;9,75
1810;"Nordborg";"no";0;0;0;55,05;9,75
1811;"Nordborg";"no";0;0;0;55,05;9,75
1812;"Nordborg";"no";0;0;0;55,05;9,75
1813;"Nordborg";"no";0;0;0;55,05;9,75
1814;"Nordborg";"no";0;0;0;55,05;9,75
1815;"Nordborg";"no";0;0;0;55,05;9,75
1816;"Nordborg";"no";1;0;1;55,05;9,75
1817;"Nordborg";"no";0;0;0;55,05;9,75
1818;"Nordborg";"no";0;0;0;55,05;9,75
1819;"Nordborg";"no";0;0;0;55,05;9,75
1820;"Nordborg";"no";0;0;0;55,05;9,75
1821;"Nordborg";"no";0;0;0;55,05;9,75
1822;"Nordborg";"no";0;0;0;55,05;9,75
1823;"Nordborg";"no";1;0;1;55,05;9,75
1824;"Nordborg";"no";0;0;0;55,05;9,75
1825;"Nordborg";"no";0;0;0;55,05;9,75
1826;"Nordborg";"no";0;0;0;55,05;9,75
1827;"Nordborg";"no";0;0;0;55,05;9,75
1828;"Nordborg";"no";0;0;0;55,05;9,75
1829;"Nordborg";"no";0;0;0;55,05;9,75
1830;"Nordborg";"no";0;0;0;55,05;9,75
1831;"Nordborg";"no";0;1;1;55,05;9,75
1832;"Nordborg";"no";0;0;0;55,05;9,75
1833;"Nordborg";"no";1;0;1;55,05;9,75
1834;"Nordborg";"no";0;0;0;55,05;9,75
1835;"Nordborg";"no";0;0;0;55,05;9,75
1836;"Nordborg";"no";0;0;0;55,05;9,75
1837;"Nordborg";"no";0;0;0;55,05;9,75
1838;"Nordborg";"no";0;0;0;55,05;9,75
1839;"Nordborg";"no";1;0;1;55,05;9,75
1840;"Nordborg";"no";0;0;0;55,05;9,75
1841;"Nordborg";"no";0;0;0;55,05;9,75
1842;"Nordborg";"no";0;0;0;55,05;9,75
1843;"Nordborg";"no";0;0;0;55,05;9,75
1844;"Nordborg";"no";0;0;0;55,05;9,75
1845;"Nordborg";"no";0;0;0;55,05;9,75
1846;"Nordborg";"no";0;0;0;55,05;9,75
1847;"Nordborg";"no";0;0;0;55,05;9,75
1848;"Nordborg";"no";1;0;1;55,05;9,75
1849;"Nordborg";"no";1;0;1;55,05;9,75
1850;"Nordborg";"no";0;0;0;55,05;9,75
1851;"Nordborg";"no";0;0;0;55,05;9,75
1852;"Nordborg";"no";0;0;0;55,05;9,75
1853;"Nordborg";"no";0;0;0;55,05;9,75
1854;"Nordborg";"no";0;0;0;55,05;9,75
1855;"Nordborg";"no";1;0;1;55,05;9,75
1856;"Nordborg";"no";0;0;0;55,05;9,75
1857;"Nordborg";"no";0;0;0;55,05;9,75
1634;"Ærø";"no";0;0;0;54,883333;10,333333
1635;"Ærø";"no";0;0;0;54,883333;10,333333
1636;"Ærø";"no";0;0;0;54,883333;10,333333
1637;"Ærø";"no";0;0;0;54,883333;10,333333
1638;"Ærø";"no";0;0;0;54,883333;10,333333
1639;"Ærø";"no";0;0;0;54,883333;10,333333
1640;"Ærø";"no";0;0;0;54,883333;10,333333
1641;"Ærø";"no";0;0;0;54,883333;10,333333
1642;"Ærø";"no";0;0;0;54,883333;10,333333
1643;"Ærø";"no";0;0;0;54,883333;10,333333
1644;"Ærø";"no";0;0;0;54,883333;10,333333
1645;"Ærø";"no";0;0;0;54,883333;10,333333
1646;"Ærø";"no";0;0;0;54,883333;10,333333
1647;"Ærø";"no";0;0;0;54,883333;10,333333
1648;"Ærø";"no";0;0;0;54,883333;10,333333
1649;"Ærø";"no";0;0;0;54,883333;10,333333
1650;"Ærø";"no";0;0;0;54,883333;10,333333
1651;"Ærø";"no";0;0;0;54,883333;10,333333
1652;"Ærø";"no";0;0;0;54,883333;10,333333
1653;"Ærø";"no";0;0;0;54,883333;10,333333
1654;"Ærø";"no";0;0;0;54,883333;10,333333
1655;"Ærø";"no";0;0;0;54,883333;10,333333
1656;"Ærø";"no";0;0;0;54,883333;10,333333
1657;"Ærø";"no";0;0;0;54,883333;10,333333
1658;"Ærø";"no";0;0;0;54,883333;10,333333
1659;"Ærø";"no";0;0;0;54,883333;10,333333
1660;"Ærø";"no";0;0;0;54,883333;10,333333
1661;"Ærø";"no";0;0;0;54,883333;10,333333
1662;"Ærø";"no";0;0;0;54,883333;10,333333
1663;"Ærø";"no";0;0;0;54,883333;10,333333
1664;"Ærø";"no";0;0;0;54,883333;10,333333
1665;"Ærø";"no";0;0;0;54,883333;10,333333
1666;"Ærø";"no";0;0;0;54,883333;10,333333
1667;"Ærø";"no";0;0;0;54,883333;10,333333
1668;"Ærø";"no";0;0;0;54,883333;10,333333
1669;"Ærø";"no";0;0;0;54,883333;10,333333
1670;"Ærø";"no";0;0;0;54,883333;10,333333
1671;"Ærø";"no";0;0;0;54,883333;10,333333
1672;"Ærø";"no";0;0;0;54,883333;10,333333
1673;"Ærø";"no";0;0;0;54,883333;10,333333
1674;"Ærø";"no";0;0;0;54,883333;10,333333
1675;"Ærø";"no";0;0;0;54,883333;10,333333
1676;"Ærø";"no";0;0;0;54,883333;10,333333
1677;"Ærø";"no";0;0;0;54,883333;10,333333
1678;"Ærø";"no";0;0;0;54,883333;10,333333
1679;"Ærø";"no";0;0;0;54,883333;10,333333
1680;"Ærø";"no";0;0;0;54,883333;10,333333
1681;"Ærø";"no";0;0;0;54,883333;10,333333
1682;"Ærø";"no";0;0;0;54,883333;10,333333
1683;"Ærø";"no";0;0;0;54,883333;10,333333
1684;"Ærø";"no";0;0;0;54,883333;10,333333
1685;"Ærø";"no";0;0;0;54,883333;10,333333
1686;"Ærø";"no";0;0;0;54,883333;10,333333
1687;"Ærø";"no";0;0;0;54,883333;10,333333
1688;"Ærø";"no";0;0;0;54,883333;10,333333
1689;"Ærø";"no";0;0;0;54,883333;10,333333
1690;"Ærø";"no";0;0;0;54,883333;10,333333
1691;"Ærø";"no";0;0;0;54,883333;10,333333
1692;"Ærø";"no";0;0;0;54,883333;10,333333
1693;"Ærø";"no";0;0;0;54,883333;10,333333
1694;"Ærø";"no";0;0;0;54,883333;10,333333
1695;"Ærø";"no";0;0;0;54,883333;10,333333
1696;"Ærø";"no";0;0;0;54,883333;10,333333
1697;"Ærø";"no";0;0;0;54,883333;10,333333
1698;"Ærø";"no";0;0;0;54,883333;10,333333
1699;"Ærø";"no";0;0;0;54,883333;10,333333
1700;"Ærø";"no";0;0;0;54,883333;10,333333
1701;"Ærø";"no";0;0;0;54,883333;10,333333
1702;"Ærø";"no";0;0;0;54,883333;10,333333
1703;"Ærø";"no";0;0;0;54,883333;10,333333
1704;"Ærø";"no";0;0;0;54,883333;10,333333
1705;"Ærø";"no";0;0;0;54,883333;10,333333
1706;"Ærø";"no";0;0;0;54,883333;10,333333
1707;"Ærø";"no";0;0;0;54,883333;10,333333
1708;"Ærø";"no";0;0;0;54,883333;10,333333
1709;"Ærø";"no";0;0;0;54,883333;10,333333
1710;"Ærø";"no";0;0;0;54,883333;10,333333
1711;"Ærø";"no";0;0;0;54,883333;10,333333
1712;"Ærø";"no";0;0;0;54,883333;10,333333
1713;"Ærø";"no";0;0;0;54,883333;10,333333
1714;"Ærø";"no";0;0;0;54,883333;10,333333
1715;"Ærø";"no";0;0;0;54,883333;10,333333
1716;"Ærø";"no";0;0;0;54,883333;10,333333
1717;"Ærø";"no";0;0;0;54,883333;10,333333
1718;"Ærø";"no";0;0;0;54,883333;10,333333
1719;"Ærø";"no";0;0;0;54,883333;10,333333
1720;"Ærø";"no";0;0;0;54,883333;10,333333
1721;"Ærø";"no";0;0;0;54,883333;10,333333
1722;"Ærø";"no";0;0;0;54,883333;10,333333
1723;"Ærø";"no";0;0;0;54,883333;10,333333
1724;"Ærø";"no";0;0;0;54,883333;10,333333
1725;"Ærø";"no";0;0;0;54,883333;10,333333
1726;"Ærø";"no";0;0;0;54,883333;10,333333
1727;"Ærø";"no";0;0;0;54,883333;10,333333
1728;"Ærø";"no";0;0;0;54,883333;10,333333
1729;"Ærø";"no";0;0;0;54,883333;10,333333
1730;"Ærø";"no";0;0;0;54,883333;10,333333
1731;"Ærø";"no";0;0;0;54,883333;10,333333
1732;"Ærø";"no";0;0;0;54,883333;10,333333
1733;"Ærø";"no";0;0;0;54,883333;10,333333
1734;"Ærø";"no";0;0;0;54,883333;10,333333
1735;"Ærø";"no";0;0;0;54,883333;10,333333
1736;"Ærø";"no";0;0;0;54,883333;10,333333
1737;"Ærø";"no";0;0;0;54,883333;10,333333
1738;"Ærø";"no";0;0;0;54,883333;10,333333
1739;"Ærø";"no";0;0;0;54,883333;10,333333
1740;"Ærø";"no";0;0;0;54,883333;10,333333
1741;"Ærø";"no";0;0;0;54,883333;10,333333
1742;"Ærø";"no";0;0;0;54,883333;10,333333
1743;"Ærø";"no";0;0;0;54,883333;10,333333
1744;"Ærø";"no";0;0;0;54,883333;10,333333
1745;"Ærø";"no";0;0;0;54,883333;10,333333
1746;"Ærø";"no";0;0;0;54,883333;10,333333
1747;"Ærø";"no";0;0;0;54,883333;10,333333
1748;"Ærø";"no";0;0;0;54,883333;10,333333
1749;"Ærø";"no";0;0;0;54,883333;10,333333
1750;"Ærø";"no";0;0;0;54,883333;10,333333
1751;"Ærø";"no";0;0;0;54,883333;10,333333
1752;"Ærø";"no";0;0;0;54,883333;10,333333
1753;"Ærø";"no";0;0;0;54,883333;10,333333
1754;"Ærø";"no";0;0;0;54,883333;10,333333
1755;"Ærø";"no";0;0;0;54,883333;10,333333
1756;"Ærø";"no";0;0;0;54,883333;10,333333
1757;"Ærø";"no";0;0;0;54,883333;10,333333
1758;"Ærø";"no";0;0;0;54,883333;10,333333
1759;"Ærø";"no";0;0;0;54,883333;10,333333
1760;"Ærø";"no";0;0;0;54,883333;10,333333
1761;"Ærø";"no";0;0;0;54,883333;10,333333
1762;"Ærø";"no";0;0;0;54,883333;10,333333
1763;"Ærø";"no";0;0;0;54,883333;10,333333
1764;"Ærø";"no";0;0;0;54,883333;10,333333
1765;"Ærø";"no";0;0;0;54,883333;10,333333
1766;"Ærø";"no";0;0;0;54,883333;10,333333
1767;"Ærø";"no";0;0;0;54,883333;10,333333
1768;"Ærø";"no";0;0;0;54,883333;10,333333
1769;"Ærø";"no";0;0;0;54,883333;10,333333
1770;"Ærø";"no";0;0;0;54,883333;10,333333
1771;"Ærø";"no";0;0;0;54,883333;10,333333
1772;"Ærø";"no";0;0;0;54,883333;10,333333
1773;"Ærø";"no";0;0;0;54,883333;10,333333
1774;"Ærø";"no";0;0;0;54,883333;10,333333
1775;"Ærø";"no";0;0;0;54,883333;10,333333
1776;"Ærø";"no";0;0;0;54,883333;10,333333
1777;"Ærø";"no";0;0;0;54,883333;10,333333
1778;"Ærø";"no";0;0;0;54,883333;10,333333
1779;"Ærø";"no";0;0;0;54,883333;10,333333
1780;"Ærø";"no";1;0;1;54,883333;10,333333
1781;"Ærø";"no";0;0;0;54,883333;10,333333
1782;"Ærø";"no";0;3;3;54,883333;10,333333
1783;"Ærø";"no";0;0;0;54,883333;10,333333
1784;"Ærø";"no";0;2;2;54,883333;10,333333
1785;"Ærø";"no";0;0;0;54,883333;10,333333
1786;"Ærø";"no";0;6;6;54,883333;10,333333
1787;"Ærø";"no";0;0;0;54,883333;10,333333
1788;"Ærø";"no";0;0;0;54,883333;10,333333
1789;"Ærø";"no";0;0;0;54,883333;10,333333
1790;"Ærø";"no";0;0;0;54,883333;10,333333
1791;"Ærø";"no";0;0;0;54,883333;10,333333
1792;"Ærø";"no";0;0;0;54,883333;10,333333
1793;"Ærø";"no";0;0;0;54,883333;10,333333
1794;"Ærø";"no";0;0;0;54,883333;10,333333
1795;"Ærø";"no";0;0;0;54,883333;10,333333
1796;"Ærø";"no";0;0;0;54,883333;10,333333
1797;"Ærø";"no";0;0;0;54,883333;10,333333
1798;"Ærø";"no";0;0;0;54,883333;10,333333
1799;"Ærø";"no";0;0;0;54,883333;10,333333
1800;"Ærø";"no";0;0;0;54,883333;10,333333
1801;"Ærø";"no";0;0;0;54,883333;10,333333
1802;"Ærø";"no";0;0;0;54,883333;10,333333
1803;"Ærø";"no";0;0;0;54,883333;10,333333
1804;"Ærø";"no";0;0;0;54,883333;10,333333
1805;"Ærø";"no";0;0;0;54,883333;10,333333
1806;"Ærø";"no";0;0;0;54,883333;10,333333
1807;"Ærø";"no";0;0;0;54,883333;10,333333
1808;"Ærø";"no";0;0;0;54,883333;10,333333
1809;"Ærø";"no";0;0;0;54,883333;10,333333
1810;"Ærø";"no";0;0;0;54,883333;10,333333
1811;"Ærø";"no";0;0;0;54,883333;10,333333
1812;"Ærø";"no";0;0;0;54,883333;10,333333
1813;"Ærø";"no";0;0;0;54,883333;10,333333
1814;"Ærø";"no";0;0;0;54,883333;10,333333
1815;"Ærø";"no";0;0;0;54,883333;10,333333
1816;"Ærø";"no";0;0;0;54,883333;10,333333
1817;"Ærø";"no";0;0;0;54,883333;10,333333
1818;"Ærø";"no";0;0;0;54,883333;10,333333
1819;"Ærø";"no";0;0;0;54,883333;10,333333
1820;"Ærø";"no";0;0;0;54,883333;10,333333
1821;"Ærø";"no";0;0;0;54,883333;10,333333
1822;"Ærø";"no";0;0;0;54,883333;10,333333
1823;"Ærø";"no";0;0;0;54,883333;10,333333
1824;"Ærø";"no";0;0;0;54,883333;10,333333
1825;"Ærø";"no";0;0;0;54,883333;10,333333
1826;"Ærø";"no";0;0;0;54,883333;10,333333
1827;"Ærø";"no";0;0;0;54,883333;10,333333
1828;"Ærø";"no";0;0;0;54,883333;10,333333
1829;"Ærø";"no";0;0;0;54,883333;10,333333
1830;"Ærø";"no";0;0;0;54,883333;10,333333
1831;"Ærø";"no";0;0;0;54,883333;10,333333
1832;"Ærø";"no";0;0;0;54,883333;10,333333
1833;"Ærø";"no";0;0;0;54,883333;10,333333
1834;"Ærø";"no";0;0;0;54,883333;10,333333
1835;"Ærø";"no";0;0;0;54,883333;10,333333
1836;"Ærø";"no";0;0;0;54,883333;10,333333
1837;"Ærø";"no";0;0;0;54,883333;10,333333
1838;"Ærø";"no";0;0;0;54,883333;10,333333
1839;"Ærø";"no";0;0;0;54,883333;10,333333
1840;"Ærø";"no";0;0;0;54,883333;10,333333
1841;"Ærø";"no";0;0;0;54,883333;10,333333
1842;"Ærø";"no";0;0;0;54,883333;10,333333
1843;"Ærø";"no";0;0;0;54,883333;10,333333
1844;"Ærø";"no";0;0;0;54,883333;10,333333
1845;"Ærø";"no";0;0;0;54,883333;10,333333
1846;"Ærø";"no";0;0;0;54,883333;10,333333
1847;"Ærø";"no";0;0;0;54,883333;10,333333
1848;"Ærø";"no";0;0;0;54,883333;10,333333
1849;"Ærø";"no";0;0;0;54,883333;10,333333
1850;"Ærø";"no";0;0;0;54,883333;10,333333
1851;"Ærø";"no";0;0;0;54,883333;10,333333
1852;"Ærø";"no";0;0;0;54,883333;10,333333
1853;"Ærø";"no";0;0;0;54,883333;10,333333
1854;"Ærø";"no";0;0;0;54,883333;10,333333
1855;"Ærø";"no";0;0;0;54,883333;10,333333
1856;"Ærø";"no";0;0;0;54,883333;10,333333
1857;"Ærø";"no";0;0;0;54,883333;10,333333
1634;"Fanø";"no";0;0;0;55,416666;8,416666
1635;"Fanø";"no";0;0;0;55,416666;8,416666
1636;"Fanø";"no";0;0;0;55,416666;8,416666
1637;"Fanø";"no";0;0;0;55,416666;8,416666
1638;"Fanø";"no";0;0;0;55,416666;8,416666
1639;"Fanø";"no";0;0;0;55,416666;8,416666
1640;"Fanø";"no";0;0;0;55,416666;8,416666
1641;"Fanø";"no";0;0;0;55,416666;8,416666
1642;"Fanø";"no";0;0;0;55,416666;8,416666
1643;"Fanø";"no";0;0;0;55,416666;8,416666
1644;"Fanø";"no";0;0;0;55,416666;8,416666
1645;"Fanø";"no";0;0;0;55,416666;8,416666
1646;"Fanø";"no";0;0;0;55,416666;8,416666
1647;"Fanø";"no";0;0;0;55,416666;8,416666
1648;"Fanø";"no";0;0;0;55,416666;8,416666
1649;"Fanø";"no";0;0;0;55,416666;8,416666
1650;"Fanø";"no";0;0;0;55,416666;8,416666
1651;"Fanø";"no";0;0;0;55,416666;8,416666
1652;"Fanø";"no";0;0;0;55,416666;8,416666
1653;"Fanø";"no";0;0;0;55,416666;8,416666
1654;"Fanø";"no";0;0;0;55,416666;8,416666
1655;"Fanø";"no";0;0;0;55,416666;8,416666
1656;"Fanø";"no";0;0;0;55,416666;8,416666
1657;"Fanø";"no";0;0;0;55,416666;8,416666
1658;"Fanø";"no";0;0;0;55,416666;8,416666
1659;"Fanø";"no";0;0;0;55,416666;8,416666
1660;"Fanø";"no";0;0;0;55,416666;8,416666
1661;"Fanø";"no";0;0;0;55,416666;8,416666
1662;"Fanø";"no";0;0;0;55,416666;8,416666
1663;"Fanø";"no";0;0;0;55,416666;8,416666
1664;"Fanø";"no";0;0;0;55,416666;8,416666
1665;"Fanø";"no";0;0;0;55,416666;8,416666
1666;"Fanø";"no";0;0;0;55,416666;8,416666
1667;"Fanø";"no";0;0;0;55,416666;8,416666
1668;"Fanø";"no";0;0;0;55,416666;8,416666
1669;"Fanø";"no";0;0;0;55,416666;8,416666
1670;"Fanø";"no";0;0;0;55,416666;8,416666
1671;"Fanø";"no";0;0;0;55,416666;8,416666
1672;"Fanø";"no";0;0;0;55,416666;8,416666
1673;"Fanø";"no";0;0;0;55,416666;8,416666
1674;"Fanø";"no";0;0;0;55,416666;8,416666
1675;"Fanø";"no";0;0;0;55,416666;8,416666
1676;"Fanø";"no";0;0;0;55,416666;8,416666
1677;"Fanø";"no";0;0;0;55,416666;8,416666
1678;"Fanø";"no";0;0;0;55,416666;8,416666
1679;"Fanø";"no";0;0;0;55,416666;8,416666
1680;"Fanø";"no";0;0;0;55,416666;8,416666
1681;"Fanø";"no";0;0;0;55,416666;8,416666
1682;"Fanø";"no";0;0;0;55,416666;8,416666
1683;"Fanø";"no";0;0;0;55,416666;8,416666
1684;"Fanø";"no";0;0;0;55,416666;8,416666
1685;"Fanø";"no";0;0;0;55,416666;8,416666
1686;"Fanø";"no";0;0;0;55,416666;8,416666
1687;"Fanø";"no";0;0;0;55,416666;8,416666
1688;"Fanø";"no";0;0;0;55,416666;8,416666
1689;"Fanø";"no";0;0;0;55,416666;8,416666
1690;"Fanø";"no";0;0;0;55,416666;8,416666
1691;"Fanø";"no";0;0;0;55,416666;8,416666
1692;"Fanø";"no";0;0;0;55,416666;8,416666
1693;"Fanø";"no";0;0;0;55,416666;8,416666
1694;"Fanø";"no";0;0;0;55,416666;8,416666
1695;"Fanø";"no";0;0;0;55,416666;8,416666
1696;"Fanø";"no";0;0;0;55,416666;8,416666
1697;"Fanø";"no";0;0;0;55,416666;8,416666
1698;"Fanø";"no";0;0;0;55,416666;8,416666
1699;"Fanø";"no";0;0;0;55,416666;8,416666
1700;"Fanø";"no";0;0;0;55,416666;8,416666
1701;"Fanø";"no";0;0;0;55,416666;8,416666
1702;"Fanø";"no";0;0;0;55,416666;8,416666
1703;"Fanø";"no";0;0;0;55,416666;8,416666
1704;"Fanø";"no";0;0;0;55,416666;8,416666
1705;"Fanø";"no";0;0;0;55,416666;8,416666
1706;"Fanø";"no";0;0;0;55,416666;8,416666
1707;"Fanø";"no";0;0;0;55,416666;8,416666
1708;"Fanø";"no";0;0;0;55,416666;8,416666
1709;"Fanø";"no";0;0;0;55,416666;8,416666
1710;"Fanø";"no";0;0;0;55,416666;8,416666
1711;"Fanø";"no";0;0;0;55,416666;8,416666
1712;"Fanø";"no";0;0;0;55,416666;8,416666
1713;"Fanø";"no";0;0;0;55,416666;8,416666
1714;"Fanø";"no";0;0;0;55,416666;8,416666
1715;"Fanø";"no";0;0;0;55,416666;8,416666
1716;"Fanø";"no";0;0;0;55,416666;8,416666
1717;"Fanø";"no";0;0;0;55,416666;8,416666
1718;"Fanø";"no";0;0;0;55,416666;8,416666
1719;"Fanø";"no";0;0;0;55,416666;8,416666
1720;"Fanø";"no";0;0;0;55,416666;8,416666
1721;"Fanø";"no";0;0;0;55,416666;8,416666
1722;"Fanø";"no";0;0;0;55,416666;8,416666
1723;"Fanø";"no";0;0;0;55,416666;8,416666
1724;"Fanø";"no";0;0;0;55,416666;8,416666
1725;"Fanø";"no";0;0;0;55,416666;8,416666
1726;"Fanø";"no";0;0;0;55,416666;8,416666
1727;"Fanø";"no";0;0;0;55,416666;8,416666
1728;"Fanø";"no";0;0;0;55,416666;8,416666
1729;"Fanø";"no";0;0;0;55,416666;8,416666
1730;"Fanø";"no";0;0;0;55,416666;8,416666
1731;"Fanø";"no";0;0;0;55,416666;8,416666
1732;"Fanø";"no";0;0;0;55,416666;8,416666
1733;"Fanø";"no";0;0;0;55,416666;8,416666
1734;"Fanø";"no";0;0;0;55,416666;8,416666
1735;"Fanø";"no";0;0;0;55,416666;8,416666
1736;"Fanø";"no";0;0;0;55,416666;8,416666
1737;"Fanø";"no";0;0;0;55,416666;8,416666
1738;"Fanø";"no";0;0;0;55,416666;8,416666
1739;"Fanø";"no";0;0;0;55,416666;8,416666
1740;"Fanø";"no";0;0;0;55,416666;8,416666
1741;"Fanø";"no";0;0;0;55,416666;8,416666
1742;"Fanø";"no";0;0;0;55,416666;8,416666
1743;"Fanø";"no";0;0;0;55,416666;8,416666
1744;"Fanø";"no";0;0;0;55,416666;8,416666
1745;"Fanø";"no";0;0;0;55,416666;8,416666
1746;"Fanø";"no";0;0;0;55,416666;8,416666
1747;"Fanø";"no";0;0;0;55,416666;8,416666
1748;"Fanø";"no";0;0;0;55,416666;8,416666
1749;"Fanø";"no";0;0;0;55,416666;8,416666
1750;"Fanø";"no";0;0;0;55,416666;8,416666
1751;"Fanø";"no";0;0;0;55,416666;8,416666
1752;"Fanø";"no";0;0;0;55,416666;8,416666
1753;"Fanø";"no";0;0;0;55,416666;8,416666
1754;"Fanø";"no";0;0;0;55,416666;8,416666
1755;"Fanø";"no";0;0;0;55,416666;8,416666
1756;"Fanø";"no";0;0;0;55,416666;8,416666
1757;"Fanø";"no";0;0;0;55,416666;8,416666
1758;"Fanø";"no";0;0;0;55,416666;8,416666
1759;"Fanø";"no";0;0;0;55,416666;8,416666
1760;"Fanø";"no";0;0;0;55,416666;8,416666
1761;"Fanø";"no";0;0;0;55,416666;8,416666
1762;"Fanø";"no";0;0;0;55,416666;8,416666
1763;"Fanø";"no";0;0;0;55,416666;8,416666
1764;"Fanø";"no";0;0;0;55,416666;8,416666
1765;"Fanø";"no";0;0;0;55,416666;8,416666
1766;"Fanø";"no";0;0;0;55,416666;8,416666
1767;"Fanø";"no";0;0;0;55,416666;8,416666
1768;"Fanø";"no";0;0;0;55,416666;8,416666
1769;"Fanø";"no";0;0;0;55,416666;8,416666
1770;"Fanø";"no";0;0;0;55,416666;8,416666
1771;"Fanø";"no";0;0;0;55,416666;8,416666
1772;"Fanø";"no";0;0;0;55,416666;8,416666
1773;"Fanø";"no";0;0;0;55,416666;8,416666
1774;"Fanø";"no";0;0;0;55,416666;8,416666
1775;"Fanø";"no";0;0;0;55,416666;8,416666
1776;"Fanø";"no";0;0;0;55,416666;8,416666
1777;"Fanø";"no";0;0;0;55,416666;8,416666
1778;"Fanø";"no";0;0;0;55,416666;8,416666
1779;"Fanø";"no";0;0;0;55,416666;8,416666
1780;"Fanø";"no";0;0;0;55,416666;8,416666
1781;"Fanø";"no";1;0;1;55,416666;8,416666
1782;"Fanø";"no";0;0;0;55,416666;8,416666
1783;"Fanø";"no";1;0;1;55,416666;8,416666
1784;"Fanø";"no";0;0;0;55,416666;8,416666
1785;"Fanø";"no";0;0;0;55,416666;8,416666
1786;"Fanø";"no";0;0;0;55,416666;8,416666
1787;"Fanø";"no";0;0;0;55,416666;8,416666
1788;"Fanø";"no";0;0;0;55,416666;8,416666
1789;"Fanø";"no";0;0;0;55,416666;8,416666
1790;"Fanø";"no";0;0;0;55,416666;8,416666
1791;"Fanø";"no";0;0;0;55,416666;8,416666
1792;"Fanø";"no";0;0;0;55,416666;8,416666
1793;"Fanø";"no";0;0;0;55,416666;8,416666
1794;"Fanø";"no";0;0;0;55,416666;8,416666
1795;"Fanø";"no";0;0;0;55,416666;8,416666
1796;"Fanø";"no";0;0;0;55,416666;8,416666
1797;"Fanø";"no";0;1;1;55,416666;8,416666
1798;"Fanø";"no";0;0;0;55,416666;8,416666
1799;"Fanø";"no";0;0;0;55,416666;8,416666
1800;"Fanø";"no";0;0;0;55,416666;8,416666
1801;"Fanø";"no";0;0;0;55,416666;8,416666
1802;"Fanø";"no";0;0;0;55,416666;8,416666
1803;"Fanø";"no";0;0;0;55,416666;8,416666
1804;"Fanø";"no";0;0;0;55,416666;8,416666
1805;"Fanø";"no";0;0;0;55,416666;8,416666
1806;"Fanø";"no";0;1;1;55,416666;8,416666
1807;"Fanø";"no";0;0;0;55,416666;8,416666
1808;"Fanø";"no";0;0;0;55,416666;8,416666
1809;"Fanø";"no";0;0;0;55,416666;8,416666
1810;"Fanø";"no";0;0;0;55,416666;8,416666
1811;"Fanø";"no";0;0;0;55,416666;8,416666
1812;"Fanø";"no";0;0;0;55,416666;8,416666
1813;"Fanø";"no";0;0;0;55,416666;8,416666
1814;"Fanø";"no";0;0;0;55,416666;8,416666
1815;"Fanø";"no";0;0;0;55,416666;8,416666
1816;"Fanø";"no";0;0;0;55,416666;8,416666
1817;"Fanø";"no";0;0;0;55,416666;8,416666
1818;"Fanø";"no";0;0;0;55,416666;8,416666
1819;"Fanø";"no";0;0;0;55,416666;8,416666
1820;"Fanø";"no";0;0;0;55,416666;8,416666
1821;"Fanø";"no";0;0;0;55,416666;8,416666
1822;"Fanø";"no";0;0;0;55,416666;8,416666
1823;"Fanø";"no";0;0;0;55,416666;8,416666
1824;"Fanø";"no";0;0;0;55,416666;8,416666
1825;"Fanø";"no";0;0;0;55,416666;8,416666
1826;"Fanø";"no";0;0;0;55,416666;8,416666
1827;"Fanø";"no";0;0;0;55,416666;8,416666
1828;"Fanø";"no";0;0;0;55,416666;8,416666
1829;"Fanø";"no";0;0;0;55,416666;8,416666
1830;"Fanø";"no";0;0;0;55,416666;8,416666
1831;"Fanø";"no";0;0;0;55,416666;8,416666
1832;"Fanø";"no";1;0;1;55,416666;8,416666
1833;"Fanø";"no";0;0;0;55,416666;8,416666
1834;"Fanø";"no";0;0;0;55,416666;8,416666
1835;"Fanø";"no";0;0;0;55,416666;8,416666
1836;"Fanø";"no";0;0;0;55,416666;8,416666
1837;"Fanø";"no";0;0;0;55,416666;8,416666
1838;"Fanø";"no";0;0;0;55,416666;8,416666
1839;"Fanø";"no";0;2;2;55,416666;8,416666
1840;"Fanø";"no";0;0;0;55,416666;8,416666
1841;"Fanø";"no";1;0;1;55,416666;8,416666
1842;"Fanø";"no";0;0;0;55,416666;8,416666
1843;"Fanø";"no";2;0;2;55,416666;8,416666
1844;"Fanø";"no";0;0;0;55,416666;8,416666
1845;"Fanø";"no";0;0;0;55,416666;8,416666
1846;"Fanø";"no";4;0;4;55,416666;8,416666
1847;"Fanø";"no";3;0;3;55,416666;8,416666
1848;"Fanø";"no";0;0;0;55,416666;8,416666
1849;"Fanø";"no";1;0;1;55,416666;8,416666
1850;"Fanø";"no";0;0;0;55,416666;8,416666
1851;"Fanø";"no";3;0;3;55,416666;8,416666
1852;"Fanø";"no";2;0;2;55,416666;8,416666
1853;"Fanø";"no";0;0;0;55,416666;8,416666
1854;"Fanø";"no";1;0;1;55,416666;8,416666
1855;"Fanø";"no";0;0;0;55,416666;8,416666
1856;"Fanø";"no";0;0;0;55,416666;8,416666
1857;"Fanø";"no";0;0;0;55,416666;8,416666
1634;"Hornbeek";"no";0;0;0;56,0913;12,4571
1635;"Hornbeek";"no";0;0;0;56,0913;12,4571
1636;"Hornbeek";"no";0;0;0;56,0913;12,4571
1637;"Hornbeek";"no";0;0;0;56,0913;12,4571
1638;"Hornbeek";"no";0;0;0;56,0913;12,4571
1639;"Hornbeek";"no";0;0;0;56,0913;12,4571
1640;"Hornbeek";"no";0;0;0;56,0913;12,4571
1641;"Hornbeek";"no";0;0;0;56,0913;12,4571
1642;"Hornbeek";"no";0;0;0;56,0913;12,4571
1643;"Hornbeek";"no";0;0;0;56,0913;12,4571
1644;"Hornbeek";"no";0;0;0;56,0913;12,4571
1645;"Hornbeek";"no";0;0;0;56,0913;12,4571
1646;"Hornbeek";"no";0;0;0;56,0913;12,4571
1647;"Hornbeek";"no";0;0;0;56,0913;12,4571
1648;"Hornbeek";"no";0;0;0;56,0913;12,4571
1649;"Hornbeek";"no";0;0;0;56,0913;12,4571
1650;"Hornbeek";"no";0;0;0;56,0913;12,4571
1651;"Hornbeek";"no";0;0;0;56,0913;12,4571
1652;"Hornbeek";"no";0;0;0;56,0913;12,4571
1653;"Hornbeek";"no";0;0;0;56,0913;12,4571
1654;"Hornbeek";"no";0;0;0;56,0913;12,4571
1655;"Hornbeek";"no";0;0;0;56,0913;12,4571
1656;"Hornbeek";"no";0;0;0;56,0913;12,4571
1657;"Hornbeek";"no";0;0;0;56,0913;12,4571
1658;"Hornbeek";"no";0;0;0;56,0913;12,4571
1659;"Hornbeek";"no";0;0;0;56,0913;12,4571
1660;"Hornbeek";"no";0;0;0;56,0913;12,4571
1661;"Hornbeek";"no";0;0;0;56,0913;12,4571
1662;"Hornbeek";"no";0;0;0;56,0913;12,4571
1663;"Hornbeek";"no";0;0;0;56,0913;12,4571
1664;"Hornbeek";"no";0;0;0;56,0913;12,4571
1665;"Hornbeek";"no";0;0;0;56,0913;12,4571
1666;"Hornbeek";"no";0;0;0;56,0913;12,4571
1667;"Hornbeek";"no";0;0;0;56,0913;12,4571
1668;"Hornbeek";"no";0;0;0;56,0913;12,4571
1669;"Hornbeek";"no";0;0;0;56,0913;12,4571
1670;"Hornbeek";"no";0;0;0;56,0913;12,4571
1671;"Hornbeek";"no";0;0;0;56,0913;12,4571
1672;"Hornbeek";"no";0;0;0;56,0913;12,4571
1673;"Hornbeek";"no";0;0;0;56,0913;12,4571
1674;"Hornbeek";"no";0;0;0;56,0913;12,4571
1675;"Hornbeek";"no";0;0;0;56,0913;12,4571
1676;"Hornbeek";"no";0;0;0;56,0913;12,4571
1677;"Hornbeek";"no";0;0;0;56,0913;12,4571
1678;"Hornbeek";"no";0;0;0;56,0913;12,4571
1679;"Hornbeek";"no";0;0;0;56,0913;12,4571
1680;"Hornbeek";"no";0;0;0;56,0913;12,4571
1681;"Hornbeek";"no";0;0;0;56,0913;12,4571
1682;"Hornbeek";"no";0;0;0;56,0913;12,4571
1683;"Hornbeek";"no";0;0;0;56,0913;12,4571
1684;"Hornbeek";"no";0;0;0;56,0913;12,4571
1685;"Hornbeek";"no";0;0;0;56,0913;12,4571
1686;"Hornbeek";"no";0;0;0;56,0913;12,4571
1687;"Hornbeek";"no";0;0;0;56,0913;12,4571
1688;"Hornbeek";"no";0;0;0;56,0913;12,4571
1689;"Hornbeek";"no";0;0;0;56,0913;12,4571
1690;"Hornbeek";"no";0;0;0;56,0913;12,4571
1691;"Hornbeek";"no";0;0;0;56,0913;12,4571
1692;"Hornbeek";"no";0;0;0;56,0913;12,4571
1693;"Hornbeek";"no";0;0;0;56,0913;12,4571
1694;"Hornbeek";"no";0;0;0;56,0913;12,4571
1695;"Hornbeek";"no";0;0;0;56,0913;12,4571
1696;"Hornbeek";"no";0;0;0;56,0913;12,4571
1697;"Hornbeek";"no";0;0;0;56,0913;12,4571
1698;"Hornbeek";"no";0;0;0;56,0913;12,4571
1699;"Hornbeek";"no";0;0;0;56,0913;12,4571
1700;"Hornbeek";"no";0;0;0;56,0913;12,4571
1701;"Hornbeek";"no";0;0;0;56,0913;12,4571
1702;"Hornbeek";"no";0;0;0;56,0913;12,4571
1703;"Hornbeek";"no";0;0;0;56,0913;12,4571
1704;"Hornbeek";"no";0;0;0;56,0913;12,4571
1705;"Hornbeek";"no";0;0;0;56,0913;12,4571
1706;"Hornbeek";"no";0;0;0;56,0913;12,4571
1707;"Hornbeek";"no";0;0;0;56,0913;12,4571
1708;"Hornbeek";"no";0;0;0;56,0913;12,4571
1709;"Hornbeek";"no";0;0;0;56,0913;12,4571
1710;"Hornbeek";"no";0;0;0;56,0913;12,4571
1711;"Hornbeek";"no";0;0;0;56,0913;12,4571
1712;"Hornbeek";"no";0;0;0;56,0913;12,4571
1713;"Hornbeek";"no";0;0;0;56,0913;12,4571
1714;"Hornbeek";"no";0;0;0;56,0913;12,4571
1715;"Hornbeek";"no";0;0;0;56,0913;12,4571
1716;"Hornbeek";"no";0;0;0;56,0913;12,4571
1717;"Hornbeek";"no";0;0;0;56,0913;12,4571
1718;"Hornbeek";"no";0;0;0;56,0913;12,4571
1719;"Hornbeek";"no";0;0;0;56,0913;12,4571
1720;"Hornbeek";"no";0;0;0;56,0913;12,4571
1721;"Hornbeek";"no";0;0;0;56,0913;12,4571
1722;"Hornbeek";"no";0;0;0;56,0913;12,4571
1723;"Hornbeek";"no";0;0;0;56,0913;12,4571
1724;"Hornbeek";"no";0;0;0;56,0913;12,4571
1725;"Hornbeek";"no";0;0;0;56,0913;12,4571
1726;"Hornbeek";"no";0;0;0;56,0913;12,4571
1727;"Hornbeek";"no";0;0;0;56,0913;12,4571
1728;"Hornbeek";"no";0;0;0;56,0913;12,4571
1729;"Hornbeek";"no";0;0;0;56,0913;12,4571
1730;"Hornbeek";"no";0;0;0;56,0913;12,4571
1731;"Hornbeek";"no";0;0;0;56,0913;12,4571
1732;"Hornbeek";"no";0;0;0;56,0913;12,4571
1733;"Hornbeek";"no";0;0;0;56,0913;12,4571
1734;"Hornbeek";"no";0;0;0;56,0913;12,4571
1735;"Hornbeek";"no";0;0;0;56,0913;12,4571
1736;"Hornbeek";"no";0;0;0;56,0913;12,4571
1737;"Hornbeek";"no";0;1;1;56,0913;12,4571
1738;"Hornbeek";"no";0;0;0;56,0913;12,4571
1739;"Hornbeek";"no";0;0;0;56,0913;12,4571
1740;"Hornbeek";"no";0;0;0;56,0913;12,4571
1741;"Hornbeek";"no";0;0;0;56,0913;12,4571
1742;"Hornbeek";"no";0;0;0;56,0913;12,4571
1743;"Hornbeek";"no";0;0;0;56,0913;12,4571
1744;"Hornbeek";"no";0;0;0;56,0913;12,4571
1745;"Hornbeek";"no";0;0;0;56,0913;12,4571
1746;"Hornbeek";"no";0;0;0;56,0913;12,4571
1747;"Hornbeek";"no";0;0;0;56,0913;12,4571
1748;"Hornbeek";"no";0;0;0;56,0913;12,4571
1749;"Hornbeek";"no";0;0;0;56,0913;12,4571
1750;"Hornbeek";"no";0;0;0;56,0913;12,4571
1751;"Hornbeek";"no";0;0;0;56,0913;12,4571
1752;"Hornbeek";"no";0;0;0;56,0913;12,4571
1753;"Hornbeek";"no";0;0;0;56,0913;12,4571
1754;"Hornbeek";"no";0;0;0;56,0913;12,4571
1755;"Hornbeek";"no";0;0;0;56,0913;12,4571
1756;"Hornbeek";"no";0;0;0;56,0913;12,4571
1757;"Hornbeek";"no";0;0;0;56,0913;12,4571
1758;"Hornbeek";"no";0;0;0;56,0913;12,4571
1759;"Hornbeek";"no";0;0;0;56,0913;12,4571
1760;"Hornbeek";"no";0;0;0;56,0913;12,4571
1761;"Hornbeek";"no";0;0;0;56,0913;12,4571
1762;"Hornbeek";"no";0;0;0;56,0913;12,4571
1763;"Hornbeek";"no";0;0;0;56,0913;12,4571
1764;"Hornbeek";"no";0;0;0;56,0913;12,4571
1765;"Hornbeek";"no";0;0;0;56,0913;12,4571
1766;"Hornbeek";"no";0;0;0;56,0913;12,4571
1767;"Hornbeek";"no";0;0;0;56,0913;12,4571
1768;"Hornbeek";"no";0;0;0;56,0913;12,4571
1769;"Hornbeek";"no";0;0;0;56,0913;12,4571
1770;"Hornbeek";"no";0;0;0;56,0913;12,4571
1771;"Hornbeek";"no";0;0;0;56,0913;12,4571
1772;"Hornbeek";"no";0;0;0;56,0913;12,4571
1773;"Hornbeek";"no";0;0;0;56,0913;12,4571
1774;"Hornbeek";"no";0;0;0;56,0913;12,4571
1775;"Hornbeek";"no";0;0;0;56,0913;12,4571
1776;"Hornbeek";"no";0;0;0;56,0913;12,4571
1777;"Hornbeek";"no";0;0;0;56,0913;12,4571
1778;"Hornbeek";"no";0;0;0;56,0913;12,4571
1779;"Hornbeek";"no";0;0;0;56,0913;12,4571
1780;"Hornbeek";"no";0;0;0;56,0913;12,4571
1781;"Hornbeek";"no";0;0;0;56,0913;12,4571
1782;"Hornbeek";"no";0;0;0;56,0913;12,4571
1783;"Hornbeek";"no";0;0;0;56,0913;12,4571
1784;"Hornbeek";"no";2;0;2;56,0913;12,4571
1785;"Hornbeek";"no";0;0;0;56,0913;12,4571
1786;"Hornbeek";"no";0;0;0;56,0913;12,4571
1787;"Hornbeek";"no";0;0;0;56,0913;12,4571
1788;"Hornbeek";"no";0;0;0;56,0913;12,4571
1789;"Hornbeek";"no";0;0;0;56,0913;12,4571
1790;"Hornbeek";"no";0;0;0;56,0913;12,4571
1791;"Hornbeek";"no";0;0;0;56,0913;12,4571
1792;"Hornbeek";"no";0;0;0;56,0913;12,4571
1793;"Hornbeek";"no";0;0;0;56,0913;12,4571
1794;"Hornbeek";"no";0;0;0;56,0913;12,4571
1795;"Hornbeek";"no";0;0;0;56,0913;12,4571
1796;"Hornbeek";"no";0;0;0;56,0913;12,4571
1797;"Hornbeek";"no";0;0;0;56,0913;12,4571
1798;"Hornbeek";"no";0;0;0;56,0913;12,4571
1799;"Hornbeek";"no";0;0;0;56,0913;12,4571
1800;"Hornbeek";"no";0;0;0;56,0913;12,4571
1801;"Hornbeek";"no";0;0;0;56,0913;12,4571
1802;"Hornbeek";"no";0;0;0;56,0913;12,4571
1803;"Hornbeek";"no";1;1;2;56,0913;12,4571
1804;"Hornbeek";"no";0;0;0;56,0913;12,4571
1805;"Hornbeek";"no";0;0;0;56,0913;12,4571
1806;"Hornbeek";"no";0;0;0;56,0913;12,4571
1807;"Hornbeek";"no";0;0;0;56,0913;12,4571
1808;"Hornbeek";"no";0;0;0;56,0913;12,4571
1809;"Hornbeek";"no";0;0;0;56,0913;12,4571
1810;"Hornbeek";"no";0;0;0;56,0913;12,4571
1811;"Hornbeek";"no";0;0;0;56,0913;12,4571
1812;"Hornbeek";"no";0;0;0;56,0913;12,4571
1813;"Hornbeek";"no";0;0;0;56,0913;12,4571
1814;"Hornbeek";"no";0;0;0;56,0913;12,4571
1815;"Hornbeek";"no";0;1;1;56,0913;12,4571
1816;"Hornbeek";"no";0;0;0;56,0913;12,4571
1817;"Hornbeek";"no";0;0;0;56,0913;12,4571
1818;"Hornbeek";"no";0;0;0;56,0913;12,4571
1819;"Hornbeek";"no";0;0;0;56,0913;12,4571
1820;"Hornbeek";"no";0;0;0;56,0913;12,4571
1821;"Hornbeek";"no";0;1;1;56,0913;12,4571
1822;"Hornbeek";"no";0;0;0;56,0913;12,4571
1823;"Hornbeek";"no";0;0;0;56,0913;12,4571
1824;"Hornbeek";"no";0;0;0;56,0913;12,4571
1825;"Hornbeek";"no";0;0;0;56,0913;12,4571
1826;"Hornbeek";"no";0;0;0;56,0913;12,4571
1827;"Hornbeek";"no";0;0;0;56,0913;12,4571
1828;"Hornbeek";"no";0;0;0;56,0913;12,4571
1829;"Hornbeek";"no";0;0;0;56,0913;12,4571
1830;"Hornbeek";"no";0;0;0;56,0913;12,4571
1831;"Hornbeek";"no";0;0;0;56,0913;12,4571
1832;"Hornbeek";"no";0;0;0;56,0913;12,4571
1833;"Hornbeek";"no";0;0;0;56,0913;12,4571
1834;"Hornbeek";"no";0;0;0;56,0913;12,4571
1835;"Hornbeek";"no";0;0;0;56,0913;12,4571
1836;"Hornbeek";"no";0;0;0;56,0913;12,4571
1837;"Hornbeek";"no";0;0;0;56,0913;12,4571
1838;"Hornbeek";"no";0;0;0;56,0913;12,4571
1839;"Hornbeek";"no";0;0;0;56,0913;12,4571
1840;"Hornbeek";"no";0;0;0;56,0913;12,4571
1841;"Hornbeek";"no";0;0;0;56,0913;12,4571
1842;"Hornbeek";"no";0;0;0;56,0913;12,4571
1843;"Hornbeek";"no";0;0;0;56,0913;12,4571
1844;"Hornbeek";"no";0;0;0;56,0913;12,4571
1845;"Hornbeek";"no";0;0;0;56,0913;12,4571
1846;"Hornbeek";"no";0;0;0;56,0913;12,4571
1847;"Hornbeek";"no";0;0;0;56,0913;12,4571
1848;"Hornbeek";"no";0;0;0;56,0913;12,4571
1849;"Hornbeek";"no";0;0;0;56,0913;12,4571
1850;"Hornbeek";"no";1;1;2;56,0913;12,4571
1851;"Hornbeek";"no";0;0;0;56,0913;12,4571
1852;"Hornbeek";"no";0;1;1;56,0913;12,4571
1853;"Hornbeek";"no";0;2;2;56,0913;12,4571
1854;"Hornbeek";"no";0;0;0;56,0913;12,4571
1855;"Hornbeek";"no";0;0;0;56,0913;12,4571
1856;"Hornbeek";"no";0;1;1;56,0913;12,4571
1857;"Hornbeek";"no";0;0;0;56,0913;12,4571
1634;"Marstal";"no";0;0;0;54,85;10,516666
1635;"Marstal";"no";0;0;0;54,85;10,516666
1636;"Marstal";"no";0;0;0;54,85;10,516666
1637;"Marstal";"no";0;0;0;54,85;10,516666
1638;"Marstal";"no";0;0;0;54,85;10,516666
1639;"Marstal";"no";0;0;0;54,85;10,516666
1640;"Marstal";"no";0;0;0;54,85;10,516666
1641;"Marstal";"no";0;0;0;54,85;10,516666
1642;"Marstal";"no";0;0;0;54,85;10,516666
1643;"Marstal";"no";0;0;0;54,85;10,516666
1644;"Marstal";"no";0;0;0;54,85;10,516666
1645;"Marstal";"no";0;0;0;54,85;10,516666
1646;"Marstal";"no";0;0;0;54,85;10,516666
1647;"Marstal";"no";0;0;0;54,85;10,516666
1648;"Marstal";"no";0;0;0;54,85;10,516666
1649;"Marstal";"no";0;0;0;54,85;10,516666
1650;"Marstal";"no";0;0;0;54,85;10,516666
1651;"Marstal";"no";0;0;0;54,85;10,516666
1652;"Marstal";"no";0;0;0;54,85;10,516666
1653;"Marstal";"no";0;0;0;54,85;10,516666
1654;"Marstal";"no";0;0;0;54,85;10,516666
1655;"Marstal";"no";0;0;0;54,85;10,516666
1656;"Marstal";"no";0;0;0;54,85;10,516666
1657;"Marstal";"no";0;0;0;54,85;10,516666
1658;"Marstal";"no";0;0;0;54,85;10,516666
1659;"Marstal";"no";0;0;0;54,85;10,516666
1660;"Marstal";"no";0;0;0;54,85;10,516666
1661;"Marstal";"no";0;0;0;54,85;10,516666
1662;"Marstal";"no";0;0;0;54,85;10,516666
1663;"Marstal";"no";0;0;0;54,85;10,516666
1664;"Marstal";"no";0;0;0;54,85;10,516666
1665;"Marstal";"no";0;0;0;54,85;10,516666
1666;"Marstal";"no";0;0;0;54,85;10,516666
1667;"Marstal";"no";0;0;0;54,85;10,516666
1668;"Marstal";"no";0;0;0;54,85;10,516666
1669;"Marstal";"no";0;0;0;54,85;10,516666
1670;"Marstal";"no";0;0;0;54,85;10,516666
1671;"Marstal";"no";0;0;0;54,85;10,516666
1672;"Marstal";"no";0;0;0;54,85;10,516666
1673;"Marstal";"no";0;0;0;54,85;10,516666
1674;"Marstal";"no";0;0;0;54,85;10,516666
1675;"Marstal";"no";0;0;0;54,85;10,516666
1676;"Marstal";"no";0;0;0;54,85;10,516666
1677;"Marstal";"no";0;0;0;54,85;10,516666
1678;"Marstal";"no";0;0;0;54,85;10,516666
1679;"Marstal";"no";0;0;0;54,85;10,516666
1680;"Marstal";"no";0;0;0;54,85;10,516666
1681;"Marstal";"no";0;0;0;54,85;10,516666
1682;"Marstal";"no";0;0;0;54,85;10,516666
1683;"Marstal";"no";0;0;0;54,85;10,516666
1684;"Marstal";"no";0;0;0;54,85;10,516666
1685;"Marstal";"no";0;0;0;54,85;10,516666
1686;"Marstal";"no";0;0;0;54,85;10,516666
1687;"Marstal";"no";0;0;0;54,85;10,516666
1688;"Marstal";"no";0;0;0;54,85;10,516666
1689;"Marstal";"no";0;0;0;54,85;10,516666
1690;"Marstal";"no";0;0;0;54,85;10,516666
1691;"Marstal";"no";0;0;0;54,85;10,516666
1692;"Marstal";"no";0;0;0;54,85;10,516666
1693;"Marstal";"no";0;0;0;54,85;10,516666
1694;"Marstal";"no";0;0;0;54,85;10,516666
1695;"Marstal";"no";0;0;0;54,85;10,516666
1696;"Marstal";"no";0;0;0;54,85;10,516666
1697;"Marstal";"no";0;0;0;54,85;10,516666
1698;"Marstal";"no";0;0;0;54,85;10,516666
1699;"Marstal";"no";0;0;0;54,85;10,516666
1700;"Marstal";"no";0;0;0;54,85;10,516666
1701;"Marstal";"no";0;0;0;54,85;10,516666
1702;"Marstal";"no";0;0;0;54,85;10,516666
1703;"Marstal";"no";0;0;0;54,85;10,516666
1704;"Marstal";"no";0;0;0;54,85;10,516666
1705;"Marstal";"no";0;0;0;54,85;10,516666
1706;"Marstal";"no";0;0;0;54,85;10,516666
1707;"Marstal";"no";0;0;0;54,85;10,516666
1708;"Marstal";"no";0;0;0;54,85;10,516666
1709;"Marstal";"no";0;0;0;54,85;10,516666
1710;"Marstal";"no";0;0;0;54,85;10,516666
1711;"Marstal";"no";0;0;0;54,85;10,516666
1712;"Marstal";"no";0;0;0;54,85;10,516666
1713;"Marstal";"no";0;0;0;54,85;10,516666
1714;"Marstal";"no";0;0;0;54,85;10,516666
1715;"Marstal";"no";0;0;0;54,85;10,516666
1716;"Marstal";"no";0;0;0;54,85;10,516666
1717;"Marstal";"no";0;0;0;54,85;10,516666
1718;"Marstal";"no";0;0;0;54,85;10,516666
1719;"Marstal";"no";0;0;0;54,85;10,516666
1720;"Marstal";"no";0;0;0;54,85;10,516666
1721;"Marstal";"no";0;0;0;54,85;10,516666
1722;"Marstal";"no";0;0;0;54,85;10,516666
1723;"Marstal";"no";0;0;0;54,85;10,516666
1724;"Marstal";"no";0;0;0;54,85;10,516666
1725;"Marstal";"no";0;0;0;54,85;10,516666
1726;"Marstal";"no";0;0;0;54,85;10,516666
1727;"Marstal";"no";0;0;0;54,85;10,516666
1728;"Marstal";"no";0;0;0;54,85;10,516666
1729;"Marstal";"no";0;0;0;54,85;10,516666
1730;"Marstal";"no";0;0;0;54,85;10,516666
1731;"Marstal";"no";0;0;0;54,85;10,516666
1732;"Marstal";"no";0;0;0;54,85;10,516666
1733;"Marstal";"no";0;0;0;54,85;10,516666
1734;"Marstal";"no";0;0;0;54,85;10,516666
1735;"Marstal";"no";0;0;0;54,85;10,516666
1736;"Marstal";"no";0;0;0;54,85;10,516666
1737;"Marstal";"no";0;0;0;54,85;10,516666
1738;"Marstal";"no";0;0;0;54,85;10,516666
1739;"Marstal";"no";0;0;0;54,85;10,516666
1740;"Marstal";"no";0;0;0;54,85;10,516666
1741;"Marstal";"no";0;0;0;54,85;10,516666
1742;"Marstal";"no";0;0;0;54,85;10,516666
1743;"Marstal";"no";0;0;0;54,85;10,516666
1744;"Marstal";"no";0;0;0;54,85;10,516666
1745;"Marstal";"no";0;0;0;54,85;10,516666
1746;"Marstal";"no";0;0;0;54,85;10,516666
1747;"Marstal";"no";0;0;0;54,85;10,516666
1748;"Marstal";"no";0;0;0;54,85;10,516666
1749;"Marstal";"no";0;0;0;54,85;10,516666
1750;"Marstal";"no";0;0;0;54,85;10,516666
1751;"Marstal";"no";0;0;0;54,85;10,516666
1752;"Marstal";"no";0;0;0;54,85;10,516666
1753;"Marstal";"no";0;0;0;54,85;10,516666
1754;"Marstal";"no";0;0;0;54,85;10,516666
1755;"Marstal";"no";0;0;0;54,85;10,516666
1756;"Marstal";"no";0;0;0;54,85;10,516666
1757;"Marstal";"no";0;0;0;54,85;10,516666
1758;"Marstal";"no";0;0;0;54,85;10,516666
1759;"Marstal";"no";0;0;0;54,85;10,516666
1760;"Marstal";"no";0;0;0;54,85;10,516666
1761;"Marstal";"no";0;0;0;54,85;10,516666
1762;"Marstal";"no";0;0;0;54,85;10,516666
1763;"Marstal";"no";0;0;0;54,85;10,516666
1764;"Marstal";"no";0;0;0;54,85;10,516666
1765;"Marstal";"no";0;0;0;54,85;10,516666
1766;"Marstal";"no";0;0;0;54,85;10,516666
1767;"Marstal";"no";0;0;0;54,85;10,516666
1768;"Marstal";"no";0;0;0;54,85;10,516666
1769;"Marstal";"no";0;0;0;54,85;10,516666
1770;"Marstal";"no";0;0;0;54,85;10,516666
1771;"Marstal";"no";0;0;0;54,85;10,516666
1772;"Marstal";"no";0;0;0;54,85;10,516666
1773;"Marstal";"no";0;0;0;54,85;10,516666
1774;"Marstal";"no";0;0;0;54,85;10,516666
1775;"Marstal";"no";0;0;0;54,85;10,516666
1776;"Marstal";"no";0;0;0;54,85;10,516666
1777;"Marstal";"no";0;0;0;54,85;10,516666
1778;"Marstal";"no";0;0;0;54,85;10,516666
1779;"Marstal";"no";0;0;0;54,85;10,516666
1780;"Marstal";"no";0;0;0;54,85;10,516666
1781;"Marstal";"no";0;0;0;54,85;10,516666
1782;"Marstal";"no";0;2;2;54,85;10,516666
1783;"Marstal";"no";0;0;0;54,85;10,516666
1784;"Marstal";"no";1;0;1;54,85;10,516666
1785;"Marstal";"no";0;0;0;54,85;10,516666
1786;"Marstal";"no";0;0;0;54,85;10,516666
1787;"Marstal";"no";0;0;0;54,85;10,516666
1788;"Marstal";"no";0;1;1;54,85;10,516666
1789;"Marstal";"no";0;1;1;54,85;10,516666
1790;"Marstal";"no";0;0;0;54,85;10,516666
1791;"Marstal";"no";0;0;0;54,85;10,516666
1792;"Marstal";"no";0;0;0;54,85;10,516666
1793;"Marstal";"no";0;0;0;54,85;10,516666
1794;"Marstal";"no";0;0;0;54,85;10,516666
1795;"Marstal";"no";0;0;0;54,85;10,516666
1796;"Marstal";"no";0;0;0;54,85;10,516666
1797;"Marstal";"no";0;0;0;54,85;10,516666
1798;"Marstal";"no";0;0;0;54,85;10,516666
1799;"Marstal";"no";0;0;0;54,85;10,516666
1800;"Marstal";"no";0;0;0;54,85;10,516666
1801;"Marstal";"no";0;0;0;54,85;10,516666
1802;"Marstal";"no";0;0;0;54,85;10,516666
1803;"Marstal";"no";0;0;0;54,85;10,516666
1804;"Marstal";"no";0;1;1;54,85;10,516666
1805;"Marstal";"no";0;0;0;54,85;10,516666
1806;"Marstal";"no";0;1;1;54,85;10,516666
1807;"Marstal";"no";0;0;0;54,85;10,516666
1808;"Marstal";"no";0;0;0;54,85;10,516666
1809;"Marstal";"no";0;0;0;54,85;10,516666
1810;"Marstal";"no";0;0;0;54,85;10,516666
1811;"Marstal";"no";0;0;0;54,85;10,516666
1812;"Marstal";"no";0;0;0;54,85;10,516666
1813;"Marstal";"no";0;0;0;54,85;10,516666
1814;"Marstal";"no";0;0;0;54,85;10,516666
1815;"Marstal";"no";0;1;1;54,85;10,516666
1816;"Marstal";"no";0;0;0;54,85;10,516666
1817;"Marstal";"no";0;0;0;54,85;10,516666
1818;"Marstal";"no";0;0;0;54,85;10,516666
1819;"Marstal";"no";0;2;2;54,85;10,516666
1820;"Marstal";"no";0;0;0;54,85;10,516666
1821;"Marstal";"no";0;0;0;54,85;10,516666
1822;"Marstal";"no";0;0;0;54,85;10,516666
1823;"Marstal";"no";0;0;0;54,85;10,516666
1824;"Marstal";"no";0;0;0;54,85;10,516666
1825;"Marstal";"no";0;0;0;54,85;10,516666
1826;"Marstal";"no";0;0;0;54,85;10,516666
1827;"Marstal";"no";0;0;0;54,85;10,516666
1828;"Marstal";"no";0;1;1;54,85;10,516666
1829;"Marstal";"no";0;0;0;54,85;10,516666
1830;"Marstal";"no";0;0;0;54,85;10,516666
1831;"Marstal";"no";0;0;0;54,85;10,516666
1832;"Marstal";"no";0;0;0;54,85;10,516666
1833;"Marstal";"no";0;0;0;54,85;10,516666
1834;"Marstal";"no";0;0;0;54,85;10,516666
1835;"Marstal";"no";0;0;0;54,85;10,516666
1836;"Marstal";"no";0;1;1;54,85;10,516666
1837;"Marstal";"no";0;0;0;54,85;10,516666
1838;"Marstal";"no";0;0;0;54,85;10,516666
1839;"Marstal";"no";0;0;0;54,85;10,516666
1840;"Marstal";"no";0;0;0;54,85;10,516666
1841;"Marstal";"no";0;0;0;54,85;10,516666
1842;"Marstal";"no";0;0;0;54,85;10,516666
1843;"Marstal";"no";0;2;2;54,85;10,516666
1844;"Marstal";"no";0;0;0;54,85;10,516666
1845;"Marstal";"no";0;0;0;54,85;10,516666
1846;"Marstal";"no";0;0;0;54,85;10,516666
1847;"Marstal";"no";0;0;0;54,85;10,516666
1848;"Marstal";"no";0;0;0;54,85;10,516666
1849;"Marstal";"no";1;0;1;54,85;10,516666
1850;"Marstal";"no";0;0;0;54,85;10,516666
1851;"Marstal";"no";0;0;0;54,85;10,516666
1852;"Marstal";"no";0;0;0;54,85;10,516666
1853;"Marstal";"no";0;0;0;54,85;10,516666
1854;"Marstal";"no";0;2;2;54,85;10,516666
1855;"Marstal";"no";0;0;0;54,85;10,516666
1856;"Marstal";"no";0;0;0;54,85;10,516666
1857;"Marstal";"no";0;0;0;54,85;10,516666
1634;"Hjørring";"no";0;0;0;57,464166;9,982222
1635;"Hjørring";"no";0;0;0;57,464166;9,982222
1636;"Hjørring";"no";0;0;0;57,464166;9,982222
1637;"Hjørring";"no";0;0;0;57,464166;9,982222
1638;"Hjørring";"no";0;0;0;57,464166;9,982222
1639;"Hjørring";"no";0;0;0;57,464166;9,982222
1640;"Hjørring";"no";0;0;0;57,464166;9,982222
1641;"Hjørring";"no";0;0;0;57,464166;9,982222
1642;"Hjørring";"no";0;0;0;57,464166;9,982222
1643;"Hjørring";"no";0;0;0;57,464166;9,982222
1644;"Hjørring";"no";0;0;0;57,464166;9,982222
1645;"Hjørring";"no";0;0;0;57,464166;9,982222
1646;"Hjørring";"no";0;0;0;57,464166;9,982222
1647;"Hjørring";"no";0;0;0;57,464166;9,982222
1648;"Hjørring";"no";0;0;0;57,464166;9,982222
1649;"Hjørring";"no";0;0;0;57,464166;9,982222
1650;"Hjørring";"no";0;0;0;57,464166;9,982222
1651;"Hjørring";"no";0;0;0;57,464166;9,982222
1652;"Hjørring";"no";0;0;0;57,464166;9,982222
1653;"Hjørring";"no";0;0;0;57,464166;9,982222
1654;"Hjørring";"no";0;0;0;57,464166;9,982222
1655;"Hjørring";"no";0;0;0;57,464166;9,982222
1656;"Hjørring";"no";0;0;0;57,464166;9,982222
1657;"Hjørring";"no";0;0;0;57,464166;9,982222
1658;"Hjørring";"no";0;0;0;57,464166;9,982222
1659;"Hjørring";"no";0;0;0;57,464166;9,982222
1660;"Hjørring";"no";0;0;0;57,464166;9,982222
1661;"Hjørring";"no";0;0;0;57,464166;9,982222
1662;"Hjørring";"no";0;0;0;57,464166;9,982222
1663;"Hjørring";"no";0;0;0;57,464166;9,982222
1664;"Hjørring";"no";0;0;0;57,464166;9,982222
1665;"Hjørring";"no";0;0;0;57,464166;9,982222
1666;"Hjørring";"no";0;0;0;57,464166;9,982222
1667;"Hjørring";"no";0;0;0;57,464166;9,982222
1668;"Hjørring";"no";0;0;0;57,464166;9,982222
1669;"Hjørring";"no";0;0;0;57,464166;9,982222
1670;"Hjørring";"no";0;0;0;57,464166;9,982222
1671;"Hjørring";"no";0;0;0;57,464166;9,982222
1672;"Hjørring";"no";0;0;0;57,464166;9,982222
1673;"Hjørring";"no";0;0;0;57,464166;9,982222
1674;"Hjørring";"no";0;0;0;57,464166;9,982222
1675;"Hjørring";"no";0;0;0;57,464166;9,982222
1676;"Hjørring";"no";0;0;0;57,464166;9,982222
1677;"Hjørring";"no";0;0;0;57,464166;9,982222
1678;"Hjørring";"no";0;0;0;57,464166;9,982222
1679;"Hjørring";"no";0;0;0;57,464166;9,982222
1680;"Hjørring";"no";0;0;0;57,464166;9,982222
1681;"Hjørring";"no";0;0;0;57,464166;9,982222
1682;"Hjørring";"no";0;0;0;57,464166;9,982222
1683;"Hjørring";"no";0;0;0;57,464166;9,982222
1684;"Hjørring";"no";0;0;0;57,464166;9,982222
1685;"Hjørring";"no";0;0;0;57,464166;9,982222
1686;"Hjørring";"no";0;0;0;57,464166;9,982222
1687;"Hjørring";"no";0;0;0;57,464166;9,982222
1688;"Hjørring";"no";0;0;0;57,464166;9,982222
1689;"Hjørring";"no";0;0;0;57,464166;9,982222
1690;"Hjørring";"no";0;0;0;57,464166;9,982222
1691;"Hjørring";"no";0;0;0;57,464166;9,982222
1692;"Hjørring";"no";0;0;0;57,464166;9,982222
1693;"Hjørring";"no";0;0;0;57,464166;9,982222
1694;"Hjørring";"no";0;0;0;57,464166;9,982222
1695;"Hjørring";"no";0;0;0;57,464166;9,982222
1696;"Hjørring";"no";0;0;0;57,464166;9,982222
1697;"Hjørring";"no";0;0;0;57,464166;9,982222
1698;"Hjørring";"no";0;0;0;57,464166;9,982222
1699;"Hjørring";"no";0;0;0;57,464166;9,982222
1700;"Hjørring";"no";0;0;0;57,464166;9,982222
1701;"Hjørring";"no";0;0;0;57,464166;9,982222
1702;"Hjørring";"no";0;0;0;57,464166;9,982222
1703;"Hjørring";"no";0;0;0;57,464166;9,982222
1704;"Hjørring";"no";0;0;0;57,464166;9,982222
1705;"Hjørring";"no";0;0;0;57,464166;9,982222
1706;"Hjørring";"no";0;0;0;57,464166;9,982222
1707;"Hjørring";"no";0;0;0;57,464166;9,982222
1708;"Hjørring";"no";0;0;0;57,464166;9,982222
1709;"Hjørring";"no";0;0;0;57,464166;9,982222
1710;"Hjørring";"no";0;0;0;57,464166;9,982222
1711;"Hjørring";"no";0;0;0;57,464166;9,982222
1712;"Hjørring";"no";0;0;0;57,464166;9,982222
1713;"Hjørring";"no";0;0;0;57,464166;9,982222
1714;"Hjørring";"no";0;0;0;57,464166;9,982222
1715;"Hjørring";"no";0;0;0;57,464166;9,982222
1716;"Hjørring";"no";0;0;0;57,464166;9,982222
1717;"Hjørring";"no";0;0;0;57,464166;9,982222
1718;"Hjørring";"no";0;0;0;57,464166;9,982222
1719;"Hjørring";"no";0;0;0;57,464166;9,982222
1720;"Hjørring";"no";0;0;0;57,464166;9,982222
1721;"Hjørring";"no";0;0;0;57,464166;9,982222
1722;"Hjørring";"no";0;0;0;57,464166;9,982222
1723;"Hjørring";"no";0;0;0;57,464166;9,982222
1724;"Hjørring";"no";0;0;0;57,464166;9,982222
1725;"Hjørring";"no";0;0;0;57,464166;9,982222
1726;"Hjørring";"no";0;0;0;57,464166;9,982222
1727;"Hjørring";"no";0;0;0;57,464166;9,982222
1728;"Hjørring";"no";0;0;0;57,464166;9,982222
1729;"Hjørring";"no";0;0;0;57,464166;9,982222
1730;"Hjørring";"no";0;0;0;57,464166;9,982222
1731;"Hjørring";"no";0;0;0;57,464166;9,982222
1732;"Hjørring";"no";0;0;0;57,464166;9,982222
1733;"Hjørring";"no";0;0;0;57,464166;9,982222
1734;"Hjørring";"no";0;0;0;57,464166;9,982222
1735;"Hjørring";"no";0;0;0;57,464166;9,982222
1736;"Hjørring";"no";0;0;0;57,464166;9,982222
1737;"Hjørring";"no";0;0;0;57,464166;9,982222
1738;"Hjørring";"no";0;0;0;57,464166;9,982222
1739;"Hjørring";"no";0;0;0;57,464166;9,982222
1740;"Hjørring";"no";0;0;0;57,464166;9,982222
1741;"Hjørring";"no";0;0;0;57,464166;9,982222
1742;"Hjørring";"no";0;0;0;57,464166;9,982222
1743;"Hjørring";"no";0;0;0;57,464166;9,982222
1744;"Hjørring";"no";0;0;0;57,464166;9,982222
1745;"Hjørring";"no";0;0;0;57,464166;9,982222
1746;"Hjørring";"no";0;0;0;57,464166;9,982222
1747;"Hjørring";"no";0;0;0;57,464166;9,982222
1748;"Hjørring";"no";0;0;0;57,464166;9,982222
1749;"Hjørring";"no";0;0;0;57,464166;9,982222
1750;"Hjørring";"no";0;0;0;57,464166;9,982222
1751;"Hjørring";"no";0;0;0;57,464166;9,982222
1752;"Hjørring";"no";0;0;0;57,464166;9,982222
1753;"Hjørring";"no";0;0;0;57,464166;9,982222
1754;"Hjørring";"no";0;0;0;57,464166;9,982222
1755;"Hjørring";"no";0;0;0;57,464166;9,982222
1756;"Hjørring";"no";0;0;0;57,464166;9,982222
1757;"Hjørring";"no";0;0;0;57,464166;9,982222
1758;"Hjørring";"no";0;0;0;57,464166;9,982222
1759;"Hjørring";"no";0;0;0;57,464166;9,982222
1760;"Hjørring";"no";0;0;0;57,464166;9,982222
1761;"Hjørring";"no";0;0;0;57,464166;9,982222
1762;"Hjørring";"no";0;0;0;57,464166;9,982222
1763;"Hjørring";"no";0;0;0;57,464166;9,982222
1764;"Hjørring";"no";0;0;0;57,464166;9,982222
1765;"Hjørring";"no";0;0;0;57,464166;9,982222
1766;"Hjørring";"no";0;0;0;57,464166;9,982222
1767;"Hjørring";"no";0;0;0;57,464166;9,982222
1768;"Hjørring";"no";0;0;0;57,464166;9,982222
1769;"Hjørring";"no";0;0;0;57,464166;9,982222
1770;"Hjørring";"no";0;0;0;57,464166;9,982222
1771;"Hjørring";"no";0;0;0;57,464166;9,982222
1772;"Hjørring";"no";0;0;0;57,464166;9,982222
1773;"Hjørring";"no";0;0;0;57,464166;9,982222
1774;"Hjørring";"no";0;0;0;57,464166;9,982222
1775;"Hjørring";"no";0;0;0;57,464166;9,982222
1776;"Hjørring";"no";0;0;0;57,464166;9,982222
1777;"Hjørring";"no";0;0;0;57,464166;9,982222
1778;"Hjørring";"no";0;0;0;57,464166;9,982222
1779;"Hjørring";"no";0;0;0;57,464166;9,982222
1780;"Hjørring";"no";0;0;0;57,464166;9,982222
1781;"Hjørring";"no";0;0;0;57,464166;9,982222
1782;"Hjørring";"no";0;0;0;57,464166;9,982222
1783;"Hjørring";"no";0;0;0;57,464166;9,982222
1784;"Hjørring";"no";0;0;0;57,464166;9,982222
1785;"Hjørring";"no";1;0;1;57,464166;9,982222
1786;"Hjørring";"no";0;0;0;57,464166;9,982222
1787;"Hjørring";"no";0;0;0;57,464166;9,982222
1788;"Hjørring";"no";0;0;0;57,464166;9,982222
1789;"Hjørring";"no";0;0;0;57,464166;9,982222
1790;"Hjørring";"no";0;0;0;57,464166;9,982222
1791;"Hjørring";"no";0;0;0;57,464166;9,982222
1792;"Hjørring";"no";0;0;0;57,464166;9,982222
1793;"Hjørring";"no";0;0;0;57,464166;9,982222
1794;"Hjørring";"no";0;0;0;57,464166;9,982222
1795;"Hjørring";"no";0;0;0;57,464166;9,982222
1796;"Hjørring";"no";0;0;0;57,464166;9,982222
1797;"Hjørring";"no";0;0;0;57,464166;9,982222
1798;"Hjørring";"no";0;0;0;57,464166;9,982222
1799;"Hjørring";"no";0;0;0;57,464166;9,982222
1800;"Hjørring";"no";0;0;0;57,464166;9,982222
1801;"Hjørring";"no";0;0;0;57,464166;9,982222
1802;"Hjørring";"no";1;0;1;57,464166;9,982222
1803;"Hjørring";"no";0;0;0;57,464166;9,982222
1804;"Hjørring";"no";0;0;0;57,464166;9,982222
1805;"Hjørring";"no";0;0;0;57,464166;9,982222
1806;"Hjørring";"no";0;0;0;57,464166;9,982222
1807;"Hjørring";"no";0;0;0;57,464166;9,982222
1808;"Hjørring";"no";0;0;0;57,464166;9,982222
1809;"Hjørring";"no";0;0;0;57,464166;9,982222
1810;"Hjørring";"no";0;0;0;57,464166;9,982222
1811;"Hjørring";"no";0;0;0;57,464166;9,982222
1812;"Hjørring";"no";0;0;0;57,464166;9,982222
1813;"Hjørring";"no";0;0;0;57,464166;9,982222
1814;"Hjørring";"no";0;0;0;57,464166;9,982222
1815;"Hjørring";"no";0;0;0;57,464166;9,982222
1816;"Hjørring";"no";0;0;0;57,464166;9,982222
1817;"Hjørring";"no";0;0;0;57,464166;9,982222
1818;"Hjørring";"no";4;1;5;57,464166;9,982222
1819;"Hjørring";"no";0;0;0;57,464166;9,982222
1820;"Hjørring";"no";0;0;0;57,464166;9,982222
1821;"Hjørring";"no";1;0;1;57,464166;9,982222
1822;"Hjørring";"no";0;0;0;57,464166;9,982222
1823;"Hjørring";"no";0;0;0;57,464166;9,982222
1824;"Hjørring";"no";0;0;0;57,464166;9,982222
1825;"Hjørring";"no";0;0;0;57,464166;9,982222
1826;"Hjørring";"no";0;0;0;57,464166;9,982222
1827;"Hjørring";"no";0;0;0;57,464166;9,982222
1828;"Hjørring";"no";0;0;0;57,464166;9,982222
1829;"Hjørring";"no";0;0;0;57,464166;9,982222
1830;"Hjørring";"no";0;0;0;57,464166;9,982222
1831;"Hjørring";"no";1;0;1;57,464166;9,982222
1832;"Hjørring";"no";0;0;0;57,464166;9,982222
1833;"Hjørring";"no";2;0;2;57,464166;9,982222
1834;"Hjørring";"no";0;0;0;57,464166;9,982222
1835;"Hjørring";"no";0;0;0;57,464166;9,982222
1836;"Hjørring";"no";0;0;0;57,464166;9,982222
1837;"Hjørring";"no";0;0;0;57,464166;9,982222
1838;"Hjørring";"no";0;0;0;57,464166;9,982222
1839;"Hjørring";"no";0;0;0;57,464166;9,982222
1840;"Hjørring";"no";1;0;1;57,464166;9,982222
1841;"Hjørring";"no";1;0;1;57,464166;9,982222
1842;"Hjørring";"no";2;0;2;57,464166;9,982222
1843;"Hjørring";"no";1;0;1;57,464166;9,982222
1844;"Hjørring";"no";1;0;1;57,464166;9,982222
1845;"Hjørring";"no";0;0;0;57,464166;9,982222
1846;"Hjørring";"no";0;0;0;57,464166;9,982222
1847;"Hjørring";"no";3;0;3;57,464166;9,982222
1848;"Hjørring";"no";0;0;0;57,464166;9,982222
1849;"Hjørring";"no";0;0;0;57,464166;9,982222
1850;"Hjørring";"no";1;1;2;57,464166;9,982222
1851;"Hjørring";"no";0;0;0;57,464166;9,982222
1852;"Hjørring";"no";1;1;2;57,464166;9,982222
1853;"Hjørring";"no";0;0;0;57,464166;9,982222
1854;"Hjørring";"no";0;0;0;57,464166;9,982222
1855;"Hjørring";"no";1;0;1;57,464166;9,982222
1856;"Hjørring";"no";3;0;3;57,464166;9,982222
1857;"Hjørring";"no";0;0;0;57,464166;9,982222
1634;"Vejle";"no";0;0;0;55,709166;9,535555
1635;"Vejle";"no";0;0;0;55,709166;9,535555
1636;"Vejle";"no";0;0;0;55,709166;9,535555
1637;"Vejle";"no";0;0;0;55,709166;9,535555
1638;"Vejle";"no";0;0;0;55,709166;9,535555
1639;"Vejle";"no";0;0;0;55,709166;9,535555
1640;"Vejle";"no";0;0;0;55,709166;9,535555
1641;"Vejle";"no";0;0;0;55,709166;9,535555
1642;"Vejle";"no";0;0;0;55,709166;9,535555
1643;"Vejle";"no";0;0;0;55,709166;9,535555
1644;"Vejle";"no";0;0;0;55,709166;9,535555
1645;"Vejle";"no";0;0;0;55,709166;9,535555
1646;"Vejle";"no";0;0;0;55,709166;9,535555
1647;"Vejle";"no";0;0;0;55,709166;9,535555
1648;"Vejle";"no";0;0;0;55,709166;9,535555
1649;"Vejle";"no";0;0;0;55,709166;9,535555
1650;"Vejle";"no";0;0;0;55,709166;9,535555
1651;"Vejle";"no";0;0;0;55,709166;9,535555
1652;"Vejle";"no";0;0;0;55,709166;9,535555
1653;"Vejle";"no";0;0;0;55,709166;9,535555
1654;"Vejle";"no";0;0;0;55,709166;9,535555
1655;"Vejle";"no";0;0;0;55,709166;9,535555
1656;"Vejle";"no";0;0;0;55,709166;9,535555
1657;"Vejle";"no";0;0;0;55,709166;9,535555
1658;"Vejle";"no";0;0;0;55,709166;9,535555
1659;"Vejle";"no";0;0;0;55,709166;9,535555
1660;"Vejle";"no";0;0;0;55,709166;9,535555
1661;"Vejle";"no";0;0;0;55,709166;9,535555
1662;"Vejle";"no";0;0;0;55,709166;9,535555
1663;"Vejle";"no";0;0;0;55,709166;9,535555
1664;"Vejle";"no";0;0;0;55,709166;9,535555
1665;"Vejle";"no";0;0;0;55,709166;9,535555
1666;"Vejle";"no";0;0;0;55,709166;9,535555
1667;"Vejle";"no";0;0;0;55,709166;9,535555
1668;"Vejle";"no";0;0;0;55,709166;9,535555
1669;"Vejle";"no";0;0;0;55,709166;9,535555
1670;"Vejle";"no";0;0;0;55,709166;9,535555
1671;"Vejle";"no";0;0;0;55,709166;9,535555
1672;"Vejle";"no";0;0;0;55,709166;9,535555
1673;"Vejle";"no";0;0;0;55,709166;9,535555
1674;"Vejle";"no";0;0;0;55,709166;9,535555
1675;"Vejle";"no";0;0;0;55,709166;9,535555
1676;"Vejle";"no";0;0;0;55,709166;9,535555
1677;"Vejle";"no";0;0;0;55,709166;9,535555
1678;"Vejle";"no";0;0;0;55,709166;9,535555
1679;"Vejle";"no";0;0;0;55,709166;9,535555
1680;"Vejle";"no";0;0;0;55,709166;9,535555
1681;"Vejle";"no";0;0;0;55,709166;9,535555
1682;"Vejle";"no";0;0;0;55,709166;9,535555
1683;"Vejle";"no";0;0;0;55,709166;9,535555
1684;"Vejle";"no";0;0;0;55,709166;9,535555
1685;"Vejle";"no";0;0;0;55,709166;9,535555
1686;"Vejle";"no";0;0;0;55,709166;9,535555
1687;"Vejle";"no";0;0;0;55,709166;9,535555
1688;"Vejle";"no";0;0;0;55,709166;9,535555
1689;"Vejle";"no";0;0;0;55,709166;9,535555
1690;"Vejle";"no";0;0;0;55,709166;9,535555
1691;"Vejle";"no";0;0;0;55,709166;9,535555
1692;"Vejle";"no";0;0;0;55,709166;9,535555
1693;"Vejle";"no";0;0;0;55,709166;9,535555
1694;"Vejle";"no";0;0;0;55,709166;9,535555
1695;"Vejle";"no";0;0;0;55,709166;9,535555
1696;"Vejle";"no";0;0;0;55,709166;9,535555
1697;"Vejle";"no";0;0;0;55,709166;9,535555
1698;"Vejle";"no";0;0;0;55,709166;9,535555
1699;"Vejle";"no";0;0;0;55,709166;9,535555
1700;"Vejle";"no";0;0;0;55,709166;9,535555
1701;"Vejle";"no";0;0;0;55,709166;9,535555
1702;"Vejle";"no";0;0;0;55,709166;9,535555
1703;"Vejle";"no";0;0;0;55,709166;9,535555
1704;"Vejle";"no";0;0;0;55,709166;9,535555
1705;"Vejle";"no";0;0;0;55,709166;9,535555
1706;"Vejle";"no";0;0;0;55,709166;9,535555
1707;"Vejle";"no";0;0;0;55,709166;9,535555
1708;"Vejle";"no";0;0;0;55,709166;9,535555
1709;"Vejle";"no";0;0;0;55,709166;9,535555
1710;"Vejle";"no";0;0;0;55,709166;9,535555
1711;"Vejle";"no";0;0;0;55,709166;9,535555
1712;"Vejle";"no";0;0;0;55,709166;9,535555
1713;"Vejle";"no";0;0;0;55,709166;9,535555
1714;"Vejle";"no";0;0;0;55,709166;9,535555
1715;"Vejle";"no";0;0;0;55,709166;9,535555
1716;"Vejle";"no";0;0;0;55,709166;9,535555
1717;"Vejle";"no";0;0;0;55,709166;9,535555
1718;"Vejle";"no";0;0;0;55,709166;9,535555
1719;"Vejle";"no";0;0;0;55,709166;9,535555
1720;"Vejle";"no";0;0;0;55,709166;9,535555
1721;"Vejle";"no";0;0;0;55,709166;9,535555
1722;"Vejle";"no";0;0;0;55,709166;9,535555
1723;"Vejle";"no";0;0;0;55,709166;9,535555
1724;"Vejle";"no";0;0;0;55,709166;9,535555
1725;"Vejle";"no";0;0;0;55,709166;9,535555
1726;"Vejle";"no";0;0;0;55,709166;9,535555
1727;"Vejle";"no";0;0;0;55,709166;9,535555
1728;"Vejle";"no";0;0;0;55,709166;9,535555
1729;"Vejle";"no";0;0;0;55,709166;9,535555
1730;"Vejle";"no";0;0;0;55,709166;9,535555
1731;"Vejle";"no";0;0;0;55,709166;9,535555
1732;"Vejle";"no";0;0;0;55,709166;9,535555
1733;"Vejle";"no";0;0;0;55,709166;9,535555
1734;"Vejle";"no";0;0;0;55,709166;9,535555
1735;"Vejle";"no";0;0;0;55,709166;9,535555
1736;"Vejle";"no";0;0;0;55,709166;9,535555
1737;"Vejle";"no";0;0;0;55,709166;9,535555
1738;"Vejle";"no";0;0;0;55,709166;9,535555
1739;"Vejle";"no";0;0;0;55,709166;9,535555
1740;"Vejle";"no";0;0;0;55,709166;9,535555
1741;"Vejle";"no";0;0;0;55,709166;9,535555
1742;"Vejle";"no";0;0;0;55,709166;9,535555
1743;"Vejle";"no";0;0;0;55,709166;9,535555
1744;"Vejle";"no";0;0;0;55,709166;9,535555
1745;"Vejle";"no";0;0;0;55,709166;9,535555
1746;"Vejle";"no";0;0;0;55,709166;9,535555
1747;"Vejle";"no";0;0;0;55,709166;9,535555
1748;"Vejle";"no";0;0;0;55,709166;9,535555
1749;"Vejle";"no";0;0;0;55,709166;9,535555
1750;"Vejle";"no";0;0;0;55,709166;9,535555
1751;"Vejle";"no";0;0;0;55,709166;9,535555
1752;"Vejle";"no";0;0;0;55,709166;9,535555
1753;"Vejle";"no";0;0;0;55,709166;9,535555
1754;"Vejle";"no";0;0;0;55,709166;9,535555
1755;"Vejle";"no";0;0;0;55,709166;9,535555
1756;"Vejle";"no";0;0;0;55,709166;9,535555
1757;"Vejle";"no";0;0;0;55,709166;9,535555
1758;"Vejle";"no";0;0;0;55,709166;9,535555
1759;"Vejle";"no";0;0;0;55,709166;9,535555
1760;"Vejle";"no";0;0;0;55,709166;9,535555
1761;"Vejle";"no";0;0;0;55,709166;9,535555
1762;"Vejle";"no";0;0;0;55,709166;9,535555
1763;"Vejle";"no";0;0;0;55,709166;9,535555
1764;"Vejle";"no";0;0;0;55,709166;9,535555
1765;"Vejle";"no";0;0;0;55,709166;9,535555
1766;"Vejle";"no";0;0;0;55,709166;9,535555
1767;"Vejle";"no";0;0;0;55,709166;9,535555
1768;"Vejle";"no";0;0;0;55,709166;9,535555
1769;"Vejle";"no";0;0;0;55,709166;9,535555
1770;"Vejle";"no";0;0;0;55,709166;9,535555
1771;"Vejle";"no";0;0;0;55,709166;9,535555
1772;"Vejle";"no";0;0;0;55,709166;9,535555
1773;"Vejle";"no";0;0;0;55,709166;9,535555
1774;"Vejle";"no";0;0;0;55,709166;9,535555
1775;"Vejle";"no";0;0;0;55,709166;9,535555
1776;"Vejle";"no";0;0;0;55,709166;9,535555
1777;"Vejle";"no";0;0;0;55,709166;9,535555
1778;"Vejle";"no";0;0;0;55,709166;9,535555
1779;"Vejle";"no";0;0;0;55,709166;9,535555
1780;"Vejle";"no";0;0;0;55,709166;9,535555
1781;"Vejle";"no";0;0;0;55,709166;9,535555
1782;"Vejle";"no";0;0;0;55,709166;9,535555
1783;"Vejle";"no";0;0;0;55,709166;9,535555
1784;"Vejle";"no";0;0;0;55,709166;9,535555
1785;"Vejle";"no";1;0;1;55,709166;9,535555
1786;"Vejle";"no";0;0;0;55,709166;9,535555
1787;"Vejle";"no";0;0;0;55,709166;9,535555
1788;"Vejle";"no";0;0;0;55,709166;9,535555
1789;"Vejle";"no";0;0;0;55,709166;9,535555
1790;"Vejle";"no";0;0;0;55,709166;9,535555
1791;"Vejle";"no";0;0;0;55,709166;9,535555
1792;"Vejle";"no";0;0;0;55,709166;9,535555
1793;"Vejle";"no";0;0;0;55,709166;9,535555
1794;"Vejle";"no";0;0;0;55,709166;9,535555
1795;"Vejle";"no";0;0;0;55,709166;9,535555
1796;"Vejle";"no";0;0;0;55,709166;9,535555
1797;"Vejle";"no";0;0;0;55,709166;9,535555
1798;"Vejle";"no";0;0;0;55,709166;9,535555
1799;"Vejle";"no";0;0;0;55,709166;9,535555
1800;"Vejle";"no";0;0;0;55,709166;9,535555
1801;"Vejle";"no";0;0;0;55,709166;9,535555
1802;"Vejle";"no";0;0;0;55,709166;9,535555
1803;"Vejle";"no";4;4;8;55,709166;9,535555
1804;"Vejle";"no";0;0;0;55,709166;9,535555
1805;"Vejle";"no";0;0;0;55,709166;9,535555
1806;"Vejle";"no";1;0;1;55,709166;9,535555
1807;"Vejle";"no";0;0;0;55,709166;9,535555
1808;"Vejle";"no";0;0;0;55,709166;9,535555
1809;"Vejle";"no";0;0;0;55,709166;9,535555
1810;"Vejle";"no";0;0;0;55,709166;9,535555
1811;"Vejle";"no";0;0;0;55,709166;9,535555
1812;"Vejle";"no";0;0;0;55,709166;9,535555
1813;"Vejle";"no";0;0;0;55,709166;9,535555
1814;"Vejle";"no";0;0;0;55,709166;9,535555
1815;"Vejle";"no";2;0;2;55,709166;9,535555
1816;"Vejle";"no";0;0;0;55,709166;9,535555
1817;"Vejle";"no";1;0;1;55,709166;9,535555
1818;"Vejle";"no";3;2;5;55,709166;9,535555
1819;"Vejle";"no";8;0;8;55,709166;9,535555
1820;"Vejle";"no";1;0;1;55,709166;9,535555
1821;"Vejle";"no";0;1;1;55,709166;9,535555
1822;"Vejle";"no";0;0;0;55,709166;9,535555
1823;"Vejle";"no";0;0;0;55,709166;9,535555
1824;"Vejle";"no";0;0;0;55,709166;9,535555
1825;"Vejle";"no";0;1;1;55,709166;9,535555
1826;"Vejle";"no";0;1;1;55,709166;9,535555
1827;"Vejle";"no";4;1;5;55,709166;9,535555
1828;"Vejle";"no";2;0;2;55,709166;9,535555
1829;"Vejle";"no";0;0;0;55,709166;9,535555
1830;"Vejle";"no";5;1;6;55,709166;9,535555
1831;"Vejle";"no";7;3;10;55,709166;9,535555
1832;"Vejle";"no";0;2;2;55,709166;9,535555
1833;"Vejle";"no";1;1;2;55,709166;9,535555
1834;"Vejle";"no";2;2;4;55,709166;9,535555
1835;"Vejle";"no";1;0;1;55,709166;9,535555
1836;"Vejle";"no";3;0;3;55,709166;9,535555
1837;"Vejle";"no";1;1;2;55,709166;9,535555
1838;"Vejle";"no";2;2;4;55,709166;9,535555
1839;"Vejle";"no";0;1;1;55,709166;9,535555
1840;"Vejle";"no";3;0;3;55,709166;9,535555
1841;"Vejle";"no";2;0;2;55,709166;9,535555
1842;"Vejle";"no";4;1;5;55,709166;9,535555
1843;"Vejle";"no";2;3;5;55,709166;9,535555
1844;"Vejle";"no";0;2;2;55,709166;9,535555
1845;"Vejle";"no";4;5;9;55,709166;9,535555
1846;"Vejle";"no";4;5;9;55,709166;9,535555
1847;"Vejle";"no";9;11;20;55,709166;9,535555
1848;"Vejle";"no";9;7;16;55,709166;9,535555
1849;"Vejle";"no";4;2;6;55,709166;9,535555
1850;"Vejle";"no";6;4;10;55,709166;9,535555
1851;"Vejle";"no";9;7;16;55,709166;9,535555
1852;"Vejle";"no";6;5;11;55,709166;9,535555
1853;"Vejle";"no";10;2;12;55,709166;9,535555
1854;"Vejle";"no";16;2;18;55,709166;9,535555
1855;"Vejle";"no";3;5;8;55,709166;9,535555
1856;"Vejle";"no";17;9;26;55,709166;9,535555
1857;"Vejle";"no";0;0;0;55,709166;9,535555
1634;"Hammermøllen";"no";0;0;0;56,066666;12,566666
1635;"Hammermøllen";"no";0;0;0;56,066666;12,566666
1636;"Hammermøllen";"no";0;0;0;56,066666;12,566666
1637;"Hammermøllen";"no";0;0;0;56,066666;12,566666
1638;"Hammermøllen";"no";0;0;0;56,066666;12,566666
1639;"Hammermøllen";"no";0;1;1;56,066666;12,566666
1640;"Hammermøllen";"no";0;0;0;56,066666;12,566666
1641;"Hammermøllen";"no";0;0;0;56,066666;12,566666
1642;"Hammermøllen";"no";0;0;0;56,066666;12,566666
1643;"Hammermøllen";"no";0;0;0;56,066666;12,566666
1644;"Hammermøllen";"no";0;0;0;56,066666;12,566666
1645;"Hammermøllen";"no";0;0;0;56,066666;12,566666
1646;"Hammermøllen";"no";0;0;0;56,066666;12,566666
1647;"Hammermøllen";"no";0;0;0;56,066666;12,566666
1648;"Hammermøllen";"no";0;0;0;56,066666;12,566666
1649;"Hammermøllen";"no";0;0;0;56,066666;12,566666
1650;"Hammermøllen";"no";0;0;0;56,066666;12,566666
1651;"Hammermøllen";"no";0;0;0;56,066666;12,566666
1652;"Hammermøllen";"no";0;0;0;56,066666;12,566666
1653;"Hammermøllen";"no";0;0;0;56,066666;12,566666
1654;"Hammermøllen";"no";0;0;0;56,066666;12,566666
1655;"Hammermøllen";"no";0;0;0;56,066666;12,566666
1656;"Hammermøllen";"no";0;0;0;56,066666;12,566666
1657;"Hammermøllen";"no";0;0;0;56,066666;12,566666
1658;"Hammermøllen";"no";0;0;0;56,066666;12,566666
1659;"Hammermøllen";"no";0;0;0;56,066666;12,566666
1660;"Hammermøllen";"no";0;0;0;56,066666;12,566666
1661;"Hammermøllen";"no";0;0;0;56,066666;12,566666
1662;"Hammermøllen";"no";0;0;0;56,066666;12,566666
1663;"Hammermøllen";"no";0;0;0;56,066666;12,566666
1664;"Hammermøllen";"no";0;0;0;56,066666;12,566666
1665;"Hammermøllen";"no";0;0;0;56,066666;12,566666
1666;"Hammermøllen";"no";0;0;0;56,066666;12,566666
1667;"Hammermøllen";"no";0;0;0;56,066666;12,566666
1668;"Hammermøllen";"no";0;0;0;56,066666;12,566666
1669;"Hammermøllen";"no";0;0;0;56,066666;12,566666
1670;"Hammermøllen";"no";0;0;0;56,066666;12,566666
1671;"Hammermøllen";"no";0;0;0;56,066666;12,566666
1672;"Hammermøllen";"no";0;0;0;56,066666;12,566666
1673;"Hammermøllen";"no";0;0;0;56,066666;12,566666
1674;"Hammermøllen";"no";0;0;0;56,066666;12,566666
1675;"Hammermøllen";"no";0;0;0;56,066666;12,566666
1676;"Hammermøllen";"no";0;0;0;56,066666;12,566666
1677;"Hammermøllen";"no";0;0;0;56,066666;12,566666
1678;"Hammermøllen";"no";0;0;0;56,066666;12,566666
1679;"Hammermøllen";"no";0;0;0;56,066666;12,566666
1680;"Hammermøllen";"no";0;0;0;56,066666;12,566666
1681;"Hammermøllen";"no";0;0;0;56,066666;12,566666
1682;"Hammermøllen";"no";0;0;0;56,066666;12,566666
1683;"Hammermøllen";"no";0;0;0;56,066666;12,566666
1684;"Hammermøllen";"no";0;0;0;56,066666;12,566666
1685;"Hammermøllen";"no";0;0;0;56,066666;12,566666
1686;"Hammermøllen";"no";0;0;0;56,066666;12,566666
1687;"Hammermøllen";"no";0;0;0;56,066666;12,566666
1688;"Hammermøllen";"no";0;0;0;56,066666;12,566666
1689;"Hammermøllen";"no";0;0;0;56,066666;12,566666
1690;"Hammermøllen";"no";0;0;0;56,066666;12,566666
1691;"Hammermøllen";"no";0;0;0;56,066666;12,566666
1692;"Hammermøllen";"no";0;0;0;56,066666;12,566666
1693;"Hammermøllen";"no";0;0;0;56,066666;12,566666
1694;"Hammermøllen";"no";0;0;0;56,066666;12,566666
1695;"Hammermøllen";"no";0;0;0;56,066666;12,566666
1696;"Hammermøllen";"no";0;0;0;56,066666;12,566666
1697;"Hammermøllen";"no";0;0;0;56,066666;12,566666
1698;"Hammermøllen";"no";0;0;0;56,066666;12,566666
1699;"Hammermøllen";"no";0;0;0;56,066666;12,566666
1700;"Hammermøllen";"no";0;0;0;56,066666;12,566666
1701;"Hammermøllen";"no";0;0;0;56,066666;12,566666
1702;"Hammermøllen";"no";0;0;0;56,066666;12,566666
1703;"Hammermøllen";"no";0;0;0;56,066666;12,566666
1704;"Hammermøllen";"no";0;0;0;56,066666;12,566666
1705;"Hammermøllen";"no";0;0;0;56,066666;12,566666
1706;"Hammermøllen";"no";0;0;0;56,066666;12,566666
1707;"Hammermøllen";"no";0;0;0;56,066666;12,566666
1708;"Hammermøllen";"no";0;0;0;56,066666;12,566666
1709;"Hammermøllen";"no";0;0;0;56,066666;12,566666
1710;"Hammermøllen";"no";0;0;0;56,066666;12,566666
1711;"Hammermøllen";"no";0;0;0;56,066666;12,566666
1712;"Hammermøllen";"no";0;0;0;56,066666;12,566666
1713;"Hammermøllen";"no";0;0;0;56,066666;12,566666
1714;"Hammermøllen";"no";0;0;0;56,066666;12,566666
1715;"Hammermøllen";"no";0;0;0;56,066666;12,566666
1716;"Hammermøllen";"no";0;0;0;56,066666;12,566666
1717;"Hammermøllen";"no";0;0;0;56,066666;12,566666
1718;"Hammermøllen";"no";0;0;0;56,066666;12,566666
1719;"Hammermøllen";"no";0;0;0;56,066666;12,566666
1720;"Hammermøllen";"no";0;0;0;56,066666;12,566666
1721;"Hammermøllen";"no";0;0;0;56,066666;12,566666
1722;"Hammermøllen";"no";0;0;0;56,066666;12,566666
1723;"Hammermøllen";"no";0;0;0;56,066666;12,566666
1724;"Hammermøllen";"no";0;0;0;56,066666;12,566666
1725;"Hammermøllen";"no";0;0;0;56,066666;12,566666
1726;"Hammermøllen";"no";0;0;0;56,066666;12,566666
1727;"Hammermøllen";"no";0;0;0;56,066666;12,566666
1728;"Hammermøllen";"no";0;0;0;56,066666;12,566666
1729;"Hammermøllen";"no";0;0;0;56,066666;12,566666
1730;"Hammermøllen";"no";0;0;0;56,066666;12,566666
1731;"Hammermøllen";"no";0;0;0;56,066666;12,566666
1732;"Hammermøllen";"no";0;0;0;56,066666;12,566666
1733;"Hammermøllen";"no";0;0;0;56,066666;12,566666
1734;"Hammermøllen";"no";0;0;0;56,066666;12,566666
1735;"Hammermøllen";"no";0;0;0;56,066666;12,566666
1736;"Hammermøllen";"no";0;0;0;56,066666;12,566666
1737;"Hammermøllen";"no";0;0;0;56,066666;12,566666
1738;"Hammermøllen";"no";0;0;0;56,066666;12,566666
1739;"Hammermøllen";"no";0;0;0;56,066666;12,566666
1740;"Hammermøllen";"no";0;0;0;56,066666;12,566666
1741;"Hammermøllen";"no";0;0;0;56,066666;12,566666
1742;"Hammermøllen";"no";0;0;0;56,066666;12,566666
1743;"Hammermøllen";"no";0;1;1;56,066666;12,566666
1744;"Hammermøllen";"no";0;0;0;56,066666;12,566666
1745;"Hammermøllen";"no";0;0;0;56,066666;12,566666
1746;"Hammermøllen";"no";0;0;0;56,066666;12,566666
1747;"Hammermøllen";"no";0;0;0;56,066666;12,566666
1748;"Hammermøllen";"no";0;0;0;56,066666;12,566666
1749;"Hammermøllen";"no";0;0;0;56,066666;12,566666
1750;"Hammermøllen";"no";0;0;0;56,066666;12,566666
1751;"Hammermøllen";"no";0;0;0;56,066666;12,566666
1752;"Hammermøllen";"no";0;0;0;56,066666;12,566666
1753;"Hammermøllen";"no";0;0;0;56,066666;12,566666
1754;"Hammermøllen";"no";0;0;0;56,066666;12,566666
1755;"Hammermøllen";"no";0;0;0;56,066666;12,566666
1756;"Hammermøllen";"no";0;0;0;56,066666;12,566666
1757;"Hammermøllen";"no";0;0;0;56,066666;12,566666
1758;"Hammermøllen";"no";0;0;0;56,066666;12,566666
1759;"Hammermøllen";"no";0;0;0;56,066666;12,566666
1760;"Hammermøllen";"no";0;0;0;56,066666;12,566666
1761;"Hammermøllen";"no";0;0;0;56,066666;12,566666
1762;"Hammermøllen";"no";0;0;0;56,066666;12,566666
1763;"Hammermøllen";"no";0;0;0;56,066666;12,566666
1764;"Hammermøllen";"no";0;0;0;56,066666;12,566666
1765;"Hammermøllen";"no";0;0;0;56,066666;12,566666
1766;"Hammermøllen";"no";0;0;0;56,066666;12,566666
1767;"Hammermøllen";"no";0;0;0;56,066666;12,566666
1768;"Hammermøllen";"no";0;0;0;56,066666;12,566666
1769;"Hammermøllen";"no";0;0;0;56,066666;12,566666
1770;"Hammermøllen";"no";0;0;0;56,066666;12,566666
1771;"Hammermøllen";"no";0;0;0;56,066666;12,566666
1772;"Hammermøllen";"no";0;0;0;56,066666;12,566666
1773;"Hammermøllen";"no";0;0;0;56,066666;12,566666
1774;"Hammermøllen";"no";0;1;1;56,066666;12,566666
1775;"Hammermøllen";"no";0;0;0;56,066666;12,566666
1776;"Hammermøllen";"no";0;0;0;56,066666;12,566666
1777;"Hammermøllen";"no";0;0;0;56,066666;12,566666
1778;"Hammermøllen";"no";0;0;0;56,066666;12,566666
1779;"Hammermøllen";"no";0;1;1;56,066666;12,566666
1780;"Hammermøllen";"no";0;1;1;56,066666;12,566666
1781;"Hammermøllen";"no";0;0;0;56,066666;12,566666
1782;"Hammermøllen";"no";0;1;1;56,066666;12,566666
1783;"Hammermøllen";"no";0;0;0;56,066666;12,566666
1784;"Hammermøllen";"no";0;0;0;56,066666;12,566666
1785;"Hammermøllen";"no";0;0;0;56,066666;12,566666
1786;"Hammermøllen";"no";0;0;0;56,066666;12,566666
1787;"Hammermøllen";"no";0;0;0;56,066666;12,566666
1788;"Hammermøllen";"no";0;0;0;56,066666;12,566666
1789;"Hammermøllen";"no";0;0;0;56,066666;12,566666
1790;"Hammermøllen";"no";0;0;0;56,066666;12,566666
1791;"Hammermøllen";"no";0;1;1;56,066666;12,566666
1792;"Hammermøllen";"no";0;1;1;56,066666;12,566666
1793;"Hammermøllen";"no";1;2;3;56,066666;12,566666
1794;"Hammermøllen";"no";0;0;0;56,066666;12,566666
1795;"Hammermøllen";"no";0;0;0;56,066666;12,566666
1796;"Hammermøllen";"no";0;0;0;56,066666;12,566666
1797;"Hammermøllen";"no";0;0;0;56,066666;12,566666
1798;"Hammermøllen";"no";0;0;0;56,066666;12,566666
1799;"Hammermøllen";"no";0;0;0;56,066666;12,566666
1800;"Hammermøllen";"no";0;0;0;56,066666;12,566666
1801;"Hammermøllen";"no";0;0;0;56,066666;12,566666
1802;"Hammermøllen";"no";0;0;0;56,066666;12,566666
1803;"Hammermøllen";"no";0;0;0;56,066666;12,566666
1804;"Hammermøllen";"no";0;0;0;56,066666;12,566666
1805;"Hammermøllen";"no";0;0;0;56,066666;12,566666
1806;"Hammermøllen";"no";0;0;0;56,066666;12,566666
1807;"Hammermøllen";"no";0;1;1;56,066666;12,566666
1808;"Hammermøllen";"no";0;0;0;56,066666;12,566666
1809;"Hammermøllen";"no";0;0;0;56,066666;12,566666
1810;"Hammermøllen";"no";0;2;2;56,066666;12,566666
1811;"Hammermøllen";"no";0;0;0;56,066666;12,566666
1812;"Hammermøllen";"no";0;0;0;56,066666;12,566666
1813;"Hammermøllen";"no";0;0;0;56,066666;12,566666
1814;"Hammermøllen";"no";0;0;0;56,066666;12,566666
1815;"Hammermøllen";"no";0;1;1;56,066666;12,566666
1816;"Hammermøllen";"no";0;0;0;56,066666;12,566666
1817;"Hammermøllen";"no";0;0;0;56,066666;12,566666
1818;"Hammermøllen";"no";0;0;0;56,066666;12,566666
1819;"Hammermøllen";"no";0;0;0;56,066666;12,566666
1820;"Hammermøllen";"no";0;0;0;56,066666;12,566666
1821;"Hammermøllen";"no";0;0;0;56,066666;12,566666
1822;"Hammermøllen";"no";0;0;0;56,066666;12,566666
1823;"Hammermøllen";"no";1;0;1;56,066666;12,566666
1824;"Hammermøllen";"no";0;0;0;56,066666;12,566666
1825;"Hammermøllen";"no";0;0;0;56,066666;12,566666
1826;"Hammermøllen";"no";1;0;1;56,066666;12,566666
1827;"Hammermøllen";"no";0;0;0;56,066666;12,566666
1828;"Hammermøllen";"no";1;0;1;56,066666;12,566666
1829;"Hammermøllen";"no";0;0;0;56,066666;12,566666
1830;"Hammermøllen";"no";0;0;0;56,066666;12,566666
1831;"Hammermøllen";"no";0;0;0;56,066666;12,566666
1832;"Hammermøllen";"no";0;0;0;56,066666;12,566666
1833;"Hammermøllen";"no";1;0;1;56,066666;12,566666
1834;"Hammermøllen";"no";0;0;0;56,066666;12,566666
1835;"Hammermøllen";"no";0;0;0;56,066666;12,566666
1836;"Hammermøllen";"no";1;0;1;56,066666;12,566666
1837;"Hammermøllen";"no";0;0;0;56,066666;12,566666
1838;"Hammermøllen";"no";0;0;0;56,066666;12,566666
1839;"Hammermøllen";"no";0;0;0;56,066666;12,566666
1840;"Hammermøllen";"no";0;0;0;56,066666;12,566666
1841;"Hammermøllen";"no";0;0;0;56,066666;12,566666
1842;"Hammermøllen";"no";0;0;0;56,066666;12,566666
1843;"Hammermøllen";"no";0;0;0;56,066666;12,566666
1844;"Hammermøllen";"no";0;0;0;56,066666;12,566666
1845;"Hammermøllen";"no";0;1;1;56,066666;12,566666
1846;"Hammermøllen";"no";0;0;0;56,066666;12,566666
1847;"Hammermøllen";"no";0;0;0;56,066666;12,566666
1848;"Hammermøllen";"no";0;0;0;56,066666;12,566666
1849;"Hammermøllen";"no";0;0;0;56,066666;12,566666
1850;"Hammermøllen";"no";1;2;3;56,066666;12,566666
1851;"Hammermøllen";"no";0;0;0;56,066666;12,566666
1852;"Hammermøllen";"no";0;0;0;56,066666;12,566666
1853;"Hammermøllen";"no";0;0;0;56,066666;12,566666
1854;"Hammermøllen";"no";0;0;0;56,066666;12,566666
1855;"Hammermøllen";"no";0;0;0;56,066666;12,566666
1856;"Hammermøllen";"no";1;0;1;56,066666;12,566666
1857;"Hammermøllen";"no";0;0;0;56,066666;12,566666
1634;"Tisvilde";"no";0;0;0;56,06155;12,087744
1635;"Tisvilde";"no";0;0;0;56,06155;12,087744
1636;"Tisvilde";"no";0;0;0;56,06155;12,087744
1637;"Tisvilde";"no";0;0;0;56,06155;12,087744
1638;"Tisvilde";"no";0;0;0;56,06155;12,087744
1639;"Tisvilde";"no";0;0;0;56,06155;12,087744
1640;"Tisvilde";"no";0;0;0;56,06155;12,087744
1641;"Tisvilde";"no";0;0;0;56,06155;12,087744
1642;"Tisvilde";"no";0;0;0;56,06155;12,087744
1643;"Tisvilde";"no";0;0;0;56,06155;12,087744
1644;"Tisvilde";"no";0;0;0;56,06155;12,087744
1645;"Tisvilde";"no";0;0;0;56,06155;12,087744
1646;"Tisvilde";"no";0;0;0;56,06155;12,087744
1647;"Tisvilde";"no";0;0;0;56,06155;12,087744
1648;"Tisvilde";"no";0;0;0;56,06155;12,087744
1649;"Tisvilde";"no";0;0;0;56,06155;12,087744
1650;"Tisvilde";"no";0;0;0;56,06155;12,087744
1651;"Tisvilde";"no";0;0;0;56,06155;12,087744
1652;"Tisvilde";"no";0;0;0;56,06155;12,087744
1653;"Tisvilde";"no";0;0;0;56,06155;12,087744
1654;"Tisvilde";"no";0;0;0;56,06155;12,087744
1655;"Tisvilde";"no";0;0;0;56,06155;12,087744
1656;"Tisvilde";"no";0;0;0;56,06155;12,087744
1657;"Tisvilde";"no";0;0;0;56,06155;12,087744
1658;"Tisvilde";"no";0;0;0;56,06155;12,087744
1659;"Tisvilde";"no";0;0;0;56,06155;12,087744
1660;"Tisvilde";"no";0;0;0;56,06155;12,087744
1661;"Tisvilde";"no";0;0;0;56,06155;12,087744
1662;"Tisvilde";"no";0;0;0;56,06155;12,087744
1663;"Tisvilde";"no";0;0;0;56,06155;12,087744
1664;"Tisvilde";"no";0;0;0;56,06155;12,087744
1665;"Tisvilde";"no";0;0;0;56,06155;12,087744
1666;"Tisvilde";"no";0;0;0;56,06155;12,087744
1667;"Tisvilde";"no";0;0;0;56,06155;12,087744
1668;"Tisvilde";"no";0;0;0;56,06155;12,087744
1669;"Tisvilde";"no";0;0;0;56,06155;12,087744
1670;"Tisvilde";"no";0;0;0;56,06155;12,087744
1671;"Tisvilde";"no";0;0;0;56,06155;12,087744
1672;"Tisvilde";"no";0;0;0;56,06155;12,087744
1673;"Tisvilde";"no";0;0;0;56,06155;12,087744
1674;"Tisvilde";"no";0;0;0;56,06155;12,087744
1675;"Tisvilde";"no";0;0;0;56,06155;12,087744
1676;"Tisvilde";"no";0;0;0;56,06155;12,087744
1677;"Tisvilde";"no";0;0;0;56,06155;12,087744
1678;"Tisvilde";"no";0;0;0;56,06155;12,087744
1679;"Tisvilde";"no";0;0;0;56,06155;12,087744
1680;"Tisvilde";"no";0;0;0;56,06155;12,087744
1681;"Tisvilde";"no";0;0;0;56,06155;12,087744
1682;"Tisvilde";"no";0;0;0;56,06155;12,087744
1683;"Tisvilde";"no";0;0;0;56,06155;12,087744
1684;"Tisvilde";"no";0;0;0;56,06155;12,087744
1685;"Tisvilde";"no";0;0;0;56,06155;12,087744
1686;"Tisvilde";"no";0;0;0;56,06155;12,087744
1687;"Tisvilde";"no";0;0;0;56,06155;12,087744
1688;"Tisvilde";"no";0;0;0;56,06155;12,087744
1689;"Tisvilde";"no";0;0;0;56,06155;12,087744
1690;"Tisvilde";"no";0;0;0;56,06155;12,087744
1691;"Tisvilde";"no";0;0;0;56,06155;12,087744
1692;"Tisvilde";"no";0;0;0;56,06155;12,087744
1693;"Tisvilde";"no";0;0;0;56,06155;12,087744
1694;"Tisvilde";"no";0;0;0;56,06155;12,087744
1695;"Tisvilde";"no";0;0;0;56,06155;12,087744
1696;"Tisvilde";"no";0;0;0;56,06155;12,087744
1697;"Tisvilde";"no";0;0;0;56,06155;12,087744
1698;"Tisvilde";"no";0;0;0;56,06155;12,087744
1699;"Tisvilde";"no";0;0;0;56,06155;12,087744
1700;"Tisvilde";"no";0;0;0;56,06155;12,087744
1701;"Tisvilde";"no";0;0;0;56,06155;12,087744
1702;"Tisvilde";"no";0;0;0;56,06155;12,087744
1703;"Tisvilde";"no";0;0;0;56,06155;12,087744
1704;"Tisvilde";"no";0;0;0;56,06155;12,087744
1705;"Tisvilde";"no";0;0;0;56,06155;12,087744
1706;"Tisvilde";"no";0;0;0;56,06155;12,087744
1707;"Tisvilde";"no";0;0;0;56,06155;12,087744
1708;"Tisvilde";"no";0;0;0;56,06155;12,087744
1709;"Tisvilde";"no";0;0;0;56,06155;12,087744
1710;"Tisvilde";"no";0;0;0;56,06155;12,087744
1711;"Tisvilde";"no";0;0;0;56,06155;12,087744
1712;"Tisvilde";"no";0;0;0;56,06155;12,087744
1713;"Tisvilde";"no";0;0;0;56,06155;12,087744
1714;"Tisvilde";"no";0;0;0;56,06155;12,087744
1715;"Tisvilde";"no";0;0;0;56,06155;12,087744
1716;"Tisvilde";"no";0;0;0;56,06155;12,087744
1717;"Tisvilde";"no";0;0;0;56,06155;12,087744
1718;"Tisvilde";"no";0;0;0;56,06155;12,087744
1719;"Tisvilde";"no";0;0;0;56,06155;12,087744
1720;"Tisvilde";"no";0;0;0;56,06155;12,087744
1721;"Tisvilde";"no";0;0;0;56,06155;12,087744
1722;"Tisvilde";"no";0;0;0;56,06155;12,087744
1723;"Tisvilde";"no";0;0;0;56,06155;12,087744
1724;"Tisvilde";"no";0;0;0;56,06155;12,087744
1725;"Tisvilde";"no";0;0;0;56,06155;12,087744
1726;"Tisvilde";"no";0;0;0;56,06155;12,087744
1727;"Tisvilde";"no";0;0;0;56,06155;12,087744
1728;"Tisvilde";"no";0;0;0;56,06155;12,087744
1729;"Tisvilde";"no";0;0;0;56,06155;12,087744
1730;"Tisvilde";"no";0;0;0;56,06155;12,087744
1731;"Tisvilde";"no";0;0;0;56,06155;12,087744
1732;"Tisvilde";"no";0;0;0;56,06155;12,087744
1733;"Tisvilde";"no";0;0;0;56,06155;12,087744
1734;"Tisvilde";"no";0;0;0;56,06155;12,087744
1735;"Tisvilde";"no";0;0;0;56,06155;12,087744
1736;"Tisvilde";"no";0;0;0;56,06155;12,087744
1737;"Tisvilde";"no";0;0;0;56,06155;12,087744
1738;"Tisvilde";"no";0;0;0;56,06155;12,087744
1739;"Tisvilde";"no";0;0;0;56,06155;12,087744
1740;"Tisvilde";"no";0;0;0;56,06155;12,087744
1741;"Tisvilde";"no";0;0;0;56,06155;12,087744
1742;"Tisvilde";"no";0;0;0;56,06155;12,087744
1743;"Tisvilde";"no";0;0;0;56,06155;12,087744
1744;"Tisvilde";"no";0;0;0;56,06155;12,087744
1745;"Tisvilde";"no";0;0;0;56,06155;12,087744
1746;"Tisvilde";"no";0;0;0;56,06155;12,087744
1747;"Tisvilde";"no";0;0;0;56,06155;12,087744
1748;"Tisvilde";"no";0;0;0;56,06155;12,087744
1749;"Tisvilde";"no";0;0;0;56,06155;12,087744
1750;"Tisvilde";"no";0;0;0;56,06155;12,087744
1751;"Tisvilde";"no";0;0;0;56,06155;12,087744
1752;"Tisvilde";"no";0;0;0;56,06155;12,087744
1753;"Tisvilde";"no";0;0;0;56,06155;12,087744
1754;"Tisvilde";"no";0;0;0;56,06155;12,087744
1755;"Tisvilde";"no";0;0;0;56,06155;12,087744
1756;"Tisvilde";"no";0;0;0;56,06155;12,087744
1757;"Tisvilde";"no";0;0;0;56,06155;12,087744
1758;"Tisvilde";"no";0;0;0;56,06155;12,087744
1759;"Tisvilde";"no";0;0;0;56,06155;12,087744
1760;"Tisvilde";"no";0;0;0;56,06155;12,087744
1761;"Tisvilde";"no";0;0;0;56,06155;12,087744
1762;"Tisvilde";"no";0;0;0;56,06155;12,087744
1763;"Tisvilde";"no";0;0;0;56,06155;12,087744
1764;"Tisvilde";"no";0;0;0;56,06155;12,087744
1765;"Tisvilde";"no";0;0;0;56,06155;12,087744
1766;"Tisvilde";"no";0;0;0;56,06155;12,087744
1767;"Tisvilde";"no";0;0;0;56,06155;12,087744
1768;"Tisvilde";"no";0;0;0;56,06155;12,087744
1769;"Tisvilde";"no";0;0;0;56,06155;12,087744
1770;"Tisvilde";"no";0;0;0;56,06155;12,087744
1771;"Tisvilde";"no";0;0;0;56,06155;12,087744
1772;"Tisvilde";"no";0;0;0;56,06155;12,087744
1773;"Tisvilde";"no";0;0;0;56,06155;12,087744
1774;"Tisvilde";"no";0;0;0;56,06155;12,087744
1775;"Tisvilde";"no";0;0;0;56,06155;12,087744
1776;"Tisvilde";"no";0;0;0;56,06155;12,087744
1777;"Tisvilde";"no";0;0;0;56,06155;12,087744
1778;"Tisvilde";"no";0;0;0;56,06155;12,087744
1779;"Tisvilde";"no";0;0;0;56,06155;12,087744
1780;"Tisvilde";"no";0;0;0;56,06155;12,087744
1781;"Tisvilde";"no";0;0;0;56,06155;12,087744
1782;"Tisvilde";"no";0;0;0;56,06155;12,087744
1783;"Tisvilde";"no";0;0;0;56,06155;12,087744
1784;"Tisvilde";"no";0;0;0;56,06155;12,087744
1785;"Tisvilde";"no";0;0;0;56,06155;12,087744
1786;"Tisvilde";"no";0;0;0;56,06155;12,087744
1787;"Tisvilde";"no";0;0;0;56,06155;12,087744
1788;"Tisvilde";"no";0;0;0;56,06155;12,087744
1789;"Tisvilde";"no";0;0;0;56,06155;12,087744
1790;"Tisvilde";"no";0;0;0;56,06155;12,087744
1791;"Tisvilde";"no";0;0;0;56,06155;12,087744
1792;"Tisvilde";"no";0;0;0;56,06155;12,087744
1793;"Tisvilde";"no";0;0;0;56,06155;12,087744
1794;"Tisvilde";"no";0;0;0;56,06155;12,087744
1795;"Tisvilde";"no";0;0;0;56,06155;12,087744
1796;"Tisvilde";"no";0;0;0;56,06155;12,087744
1797;"Tisvilde";"no";0;0;0;56,06155;12,087744
1798;"Tisvilde";"no";0;0;0;56,06155;12,087744
1799;"Tisvilde";"no";0;0;0;56,06155;12,087744
1800;"Tisvilde";"no";0;0;0;56,06155;12,087744
1801;"Tisvilde";"no";0;0;0;56,06155;12,087744
1802;"Tisvilde";"no";1;0;1;56,06155;12,087744
1803;"Tisvilde";"no";0;0;0;56,06155;12,087744
1804;"Tisvilde";"no";0;0;0;56,06155;12,087744
1805;"Tisvilde";"no";0;0;0;56,06155;12,087744
1806;"Tisvilde";"no";0;0;0;56,06155;12,087744
1807;"Tisvilde";"no";0;0;0;56,06155;12,087744
1808;"Tisvilde";"no";0;0;0;56,06155;12,087744
1809;"Tisvilde";"no";0;0;0;56,06155;12,087744
1810;"Tisvilde";"no";0;0;0;56,06155;12,087744
1811;"Tisvilde";"no";0;0;0;56,06155;12,087744
1812;"Tisvilde";"no";0;0;0;56,06155;12,087744
1813;"Tisvilde";"no";0;0;0;56,06155;12,087744
1814;"Tisvilde";"no";0;0;0;56,06155;12,087744
1815;"Tisvilde";"no";0;0;0;56,06155;12,087744
1816;"Tisvilde";"no";0;0;0;56,06155;12,087744
1817;"Tisvilde";"no";0;0;0;56,06155;12,087744
1818;"Tisvilde";"no";0;0;0;56,06155;12,087744
1819;"Tisvilde";"no";0;0;0;56,06155;12,087744
1820;"Tisvilde";"no";0;0;0;56,06155;12,087744
1821;"Tisvilde";"no";0;0;0;56,06155;12,087744
1822;"Tisvilde";"no";0;0;0;56,06155;12,087744
1823;"Tisvilde";"no";0;0;0;56,06155;12,087744
1824;"Tisvilde";"no";0;0;0;56,06155;12,087744
1825;"Tisvilde";"no";0;0;0;56,06155;12,087744
1826;"Tisvilde";"no";0;0;0;56,06155;12,087744
1827;"Tisvilde";"no";0;0;0;56,06155;12,087744
1828;"Tisvilde";"no";0;0;0;56,06155;12,087744
1829;"Tisvilde";"no";0;0;0;56,06155;12,087744
1830;"Tisvilde";"no";0;0;0;56,06155;12,087744
1831;"Tisvilde";"no";0;0;0;56,06155;12,087744
1832;"Tisvilde";"no";0;0;0;56,06155;12,087744
1833;"Tisvilde";"no";0;0;0;56,06155;12,087744
1834;"Tisvilde";"no";0;0;0;56,06155;12,087744
1835;"Tisvilde";"no";0;0;0;56,06155;12,087744
1836;"Tisvilde";"no";0;0;0;56,06155;12,087744
1837;"Tisvilde";"no";0;0;0;56,06155;12,087744
1838;"Tisvilde";"no";0;0;0;56,06155;12,087744
1839;"Tisvilde";"no";0;0;0;56,06155;12,087744
1840;"Tisvilde";"no";0;0;0;56,06155;12,087744
1841;"Tisvilde";"no";0;0;0;56,06155;12,087744
1842;"Tisvilde";"no";0;0;0;56,06155;12,087744
1843;"Tisvilde";"no";0;0;0;56,06155;12,087744
1844;"Tisvilde";"no";0;0;0;56,06155;12,087744
1845;"Tisvilde";"no";0;0;0;56,06155;12,087744
1846;"Tisvilde";"no";0;0;0;56,06155;12,087744
1847;"Tisvilde";"no";0;0;0;56,06155;12,087744
1848;"Tisvilde";"no";0;0;0;56,06155;12,087744
1849;"Tisvilde";"no";0;0;0;56,06155;12,087744
1850;"Tisvilde";"no";0;0;0;56,06155;12,087744
1851;"Tisvilde";"no";0;0;0;56,06155;12,087744
1852;"Tisvilde";"no";0;0;0;56,06155;12,087744
1853;"Tisvilde";"no";0;0;0;56,06155;12,087744
1854;"Tisvilde";"no";0;0;0;56,06155;12,087744
1855;"Tisvilde";"no";0;0;0;56,06155;12,087744
1856;"Tisvilde";"no";0;0;0;56,06155;12,087744
1857;"Tisvilde";"no";0;0;0;56,06155;12,087744
1634;"Sønderho";"no";0;0;0;55,35;8,475
1635;"Sønderho";"no";0;0;0;55,35;8,475
1636;"Sønderho";"no";0;0;0;55,35;8,475
1637;"Sønderho";"no";0;0;0;55,35;8,475
1638;"Sønderho";"no";0;0;0;55,35;8,475
1639;"Sønderho";"no";0;0;0;55,35;8,475
1640;"Sønderho";"no";0;0;0;55,35;8,475
1641;"Sønderho";"no";0;0;0;55,35;8,475
1642;"Sønderho";"no";0;0;0;55,35;8,475
1643;"Sønderho";"no";0;0;0;55,35;8,475
1644;"Sønderho";"no";0;0;0;55,35;8,475
1645;"Sønderho";"no";0;0;0;55,35;8,475
1646;"Sønderho";"no";0;0;0;55,35;8,475
1647;"Sønderho";"no";0;0;0;55,35;8,475
1648;"Sønderho";"no";0;0;0;55,35;8,475
1649;"Sønderho";"no";0;0;0;55,35;8,475
1650;"Sønderho";"no";0;0;0;55,35;8,475
1651;"Sønderho";"no";0;0;0;55,35;8,475
1652;"Sønderho";"no";0;0;0;55,35;8,475
1653;"Sønderho";"no";0;0;0;55,35;8,475
1654;"Sønderho";"no";0;0;0;55,35;8,475
1655;"Sønderho";"no";0;0;0;55,35;8,475
1656;"Sønderho";"no";0;0;0;55,35;8,475
1657;"Sønderho";"no";0;0;0;55,35;8,475
1658;"Sønderho";"no";0;0;0;55,35;8,475
1659;"Sønderho";"no";0;0;0;55,35;8,475
1660;"Sønderho";"no";0;0;0;55,35;8,475
1661;"Sønderho";"no";0;0;0;55,35;8,475
1662;"Sønderho";"no";0;0;0;55,35;8,475
1663;"Sønderho";"no";0;0;0;55,35;8,475
1664;"Sønderho";"no";0;0;0;55,35;8,475
1665;"Sønderho";"no";0;0;0;55,35;8,475
1666;"Sønderho";"no";0;0;0;55,35;8,475
1667;"Sønderho";"no";0;0;0;55,35;8,475
1668;"Sønderho";"no";0;0;0;55,35;8,475
1669;"Sønderho";"no";0;0;0;55,35;8,475
1670;"Sønderho";"no";0;0;0;55,35;8,475
1671;"Sønderho";"no";0;0;0;55,35;8,475
1672;"Sønderho";"no";0;0;0;55,35;8,475
1673;"Sønderho";"no";0;0;0;55,35;8,475
1674;"Sønderho";"no";0;0;0;55,35;8,475
1675;"Sønderho";"no";0;0;0;55,35;8,475
1676;"Sønderho";"no";0;0;0;55,35;8,475
1677;"Sønderho";"no";0;0;0;55,35;8,475
1678;"Sønderho";"no";0;0;0;55,35;8,475
1679;"Sønderho";"no";0;0;0;55,35;8,475
1680;"Sønderho";"no";0;0;0;55,35;8,475
1681;"Sønderho";"no";0;0;0;55,35;8,475
1682;"Sønderho";"no";0;0;0;55,35;8,475
1683;"Sønderho";"no";0;0;0;55,35;8,475
1684;"Sønderho";"no";0;0;0;55,35;8,475
1685;"Sønderho";"no";0;0;0;55,35;8,475
1686;"Sønderho";"no";0;0;0;55,35;8,475
1687;"Sønderho";"no";0;0;0;55,35;8,475
1688;"Sønderho";"no";0;0;0;55,35;8,475
1689;"Sønderho";"no";0;0;0;55,35;8,475
1690;"Sønderho";"no";0;0;0;55,35;8,475
1691;"Sønderho";"no";0;0;0;55,35;8,475
1692;"Sønderho";"no";0;0;0;55,35;8,475
1693;"Sønderho";"no";0;0;0;55,35;8,475
1694;"Sønderho";"no";0;0;0;55,35;8,475
1695;"Sønderho";"no";0;0;0;55,35;8,475
1696;"Sønderho";"no";0;0;0;55,35;8,475
1697;"Sønderho";"no";0;0;0;55,35;8,475
1698;"Sønderho";"no";0;0;0;55,35;8,475
1699;"Sønderho";"no";0;0;0;55,35;8,475
1700;"Sønderho";"no";0;0;0;55,35;8,475
1701;"Sønderho";"no";0;0;0;55,35;8,475
1702;"Sønderho";"no";0;0;0;55,35;8,475
1703;"Sønderho";"no";0;0;0;55,35;8,475
1704;"Sønderho";"no";0;0;0;55,35;8,475
1705;"Sønderho";"no";0;0;0;55,35;8,475
1706;"Sønderho";"no";0;0;0;55,35;8,475
1707;"Sønderho";"no";0;0;0;55,35;8,475
1708;"Sønderho";"no";0;0;0;55,35;8,475
1709;"Sønderho";"no";0;0;0;55,35;8,475
1710;"Sønderho";"no";0;0;0;55,35;8,475
1711;"Sønderho";"no";0;0;0;55,35;8,475
1712;"Sønderho";"no";0;0;0;55,35;8,475
1713;"Sønderho";"no";0;0;0;55,35;8,475
1714;"Sønderho";"no";0;0;0;55,35;8,475
1715;"Sønderho";"no";0;0;0;55,35;8,475
1716;"Sønderho";"no";0;0;0;55,35;8,475
1717;"Sønderho";"no";0;0;0;55,35;8,475
1718;"Sønderho";"no";0;0;0;55,35;8,475
1719;"Sønderho";"no";0;0;0;55,35;8,475
1720;"Sønderho";"no";0;0;0;55,35;8,475
1721;"Sønderho";"no";0;0;0;55,35;8,475
1722;"Sønderho";"no";0;0;0;55,35;8,475
1723;"Sønderho";"no";0;0;0;55,35;8,475
1724;"Sønderho";"no";0;0;0;55,35;8,475
1725;"Sønderho";"no";0;0;0;55,35;8,475
1726;"Sønderho";"no";0;0;0;55,35;8,475
1727;"Sønderho";"no";0;0;0;55,35;8,475
1728;"Sønderho";"no";0;0;0;55,35;8,475
1729;"Sønderho";"no";0;0;0;55,35;8,475
1730;"Sønderho";"no";0;0;0;55,35;8,475
1731;"Sønderho";"no";0;0;0;55,35;8,475
1732;"Sønderho";"no";0;0;0;55,35;8,475
1733;"Sønderho";"no";0;0;0;55,35;8,475
1734;"Sønderho";"no";0;0;0;55,35;8,475
1735;"Sønderho";"no";0;0;0;55,35;8,475
1736;"Sønderho";"no";0;0;0;55,35;8,475
1737;"Sønderho";"no";0;0;0;55,35;8,475
1738;"Sønderho";"no";0;0;0;55,35;8,475
1739;"Sønderho";"no";0;0;0;55,35;8,475
1740;"Sønderho";"no";0;0;0;55,35;8,475
1741;"Sønderho";"no";0;0;0;55,35;8,475
1742;"Sønderho";"no";0;0;0;55,35;8,475
1743;"Sønderho";"no";0;0;0;55,35;8,475
1744;"Sønderho";"no";0;0;0;55,35;8,475
1745;"Sønderho";"no";0;0;0;55,35;8,475
1746;"Sønderho";"no";0;0;0;55,35;8,475
1747;"Sønderho";"no";0;0;0;55,35;8,475
1748;"Sønderho";"no";0;0;0;55,35;8,475
1749;"Sønderho";"no";0;0;0;55,35;8,475
1750;"Sønderho";"no";0;0;0;55,35;8,475
1751;"Sønderho";"no";0;0;0;55,35;8,475
1752;"Sønderho";"no";0;0;0;55,35;8,475
1753;"Sønderho";"no";0;0;0;55,35;8,475
1754;"Sønderho";"no";0;0;0;55,35;8,475
1755;"Sønderho";"no";0;0;0;55,35;8,475
1756;"Sønderho";"no";0;0;0;55,35;8,475
1757;"Sønderho";"no";0;0;0;55,35;8,475
1758;"Sønderho";"no";0;0;0;55,35;8,475
1759;"Sønderho";"no";0;0;0;55,35;8,475
1760;"Sønderho";"no";0;0;0;55,35;8,475
1761;"Sønderho";"no";0;0;0;55,35;8,475
1762;"Sønderho";"no";0;0;0;55,35;8,475
1763;"Sønderho";"no";0;0;0;55,35;8,475
1764;"Sønderho";"no";0;0;0;55,35;8,475
1765;"Sønderho";"no";0;0;0;55,35;8,475
1766;"Sønderho";"no";0;0;0;55,35;8,475
1767;"Sønderho";"no";0;0;0;55,35;8,475
1768;"Sønderho";"no";0;0;0;55,35;8,475
1769;"Sønderho";"no";0;0;0;55,35;8,475
1770;"Sønderho";"no";0;0;0;55,35;8,475
1771;"Sønderho";"no";0;0;0;55,35;8,475
1772;"Sønderho";"no";0;0;0;55,35;8,475
1773;"Sønderho";"no";0;0;0;55,35;8,475
1774;"Sønderho";"no";0;0;0;55,35;8,475
1775;"Sønderho";"no";0;0;0;55,35;8,475
1776;"Sønderho";"no";0;0;0;55,35;8,475
1777;"Sønderho";"no";0;0;0;55,35;8,475
1778;"Sønderho";"no";0;0;0;55,35;8,475
1779;"Sønderho";"no";0;0;0;55,35;8,475
1780;"Sønderho";"no";0;0;0;55,35;8,475
1781;"Sønderho";"no";0;0;0;55,35;8,475
1782;"Sønderho";"no";0;0;0;55,35;8,475
1783;"Sønderho";"no";0;0;0;55,35;8,475
1784;"Sønderho";"no";0;0;0;55,35;8,475
1785;"Sønderho";"no";0;0;0;55,35;8,475
1786;"Sønderho";"no";0;0;0;55,35;8,475
1787;"Sønderho";"no";0;0;0;55,35;8,475
1788;"Sønderho";"no";0;0;0;55,35;8,475
1789;"Sønderho";"no";0;0;0;55,35;8,475
1790;"Sønderho";"no";0;0;0;55,35;8,475
1791;"Sønderho";"no";0;0;0;55,35;8,475
1792;"Sønderho";"no";0;0;0;55,35;8,475
1793;"Sønderho";"no";0;0;0;55,35;8,475
1794;"Sønderho";"no";0;0;0;55,35;8,475
1795;"Sønderho";"no";0;0;0;55,35;8,475
1796;"Sønderho";"no";0;0;0;55,35;8,475
1797;"Sønderho";"no";0;0;0;55,35;8,475
1798;"Sønderho";"no";0;0;0;55,35;8,475
1799;"Sønderho";"no";0;0;0;55,35;8,475
1800;"Sønderho";"no";0;0;0;55,35;8,475
1801;"Sønderho";"no";0;0;0;55,35;8,475
1802;"Sønderho";"no";0;0;0;55,35;8,475
1803;"Sønderho";"no";1;0;1;55,35;8,475
1804;"Sønderho";"no";0;0;0;55,35;8,475
1805;"Sønderho";"no";0;0;0;55,35;8,475
1806;"Sønderho";"no";0;0;0;55,35;8,475
1807;"Sønderho";"no";0;0;0;55,35;8,475
1808;"Sønderho";"no";0;0;0;55,35;8,475
1809;"Sønderho";"no";0;0;0;55,35;8,475
1810;"Sønderho";"no";0;0;0;55,35;8,475
1811;"Sønderho";"no";0;0;0;55,35;8,475
1812;"Sønderho";"no";0;0;0;55,35;8,475
1813;"Sønderho";"no";0;0;0;55,35;8,475
1814;"Sønderho";"no";0;0;0;55,35;8,475
1815;"Sønderho";"no";0;0;0;55,35;8,475
1816;"Sønderho";"no";0;0;0;55,35;8,475
1817;"Sønderho";"no";0;0;0;55,35;8,475
1818;"Sønderho";"no";0;0;0;55,35;8,475
1819;"Sønderho";"no";0;0;0;55,35;8,475
1820;"Sønderho";"no";0;0;0;55,35;8,475
1821;"Sønderho";"no";0;0;0;55,35;8,475
1822;"Sønderho";"no";0;0;0;55,35;8,475
1823;"Sønderho";"no";0;0;0;55,35;8,475
1824;"Sønderho";"no";0;0;0;55,35;8,475
1825;"Sønderho";"no";0;0;0;55,35;8,475
1826;"Sønderho";"no";0;0;0;55,35;8,475
1827;"Sønderho";"no";0;0;0;55,35;8,475
1828;"Sønderho";"no";0;0;0;55,35;8,475
1829;"Sønderho";"no";0;0;0;55,35;8,475
1830;"Sønderho";"no";0;0;0;55,35;8,475
1831;"Sønderho";"no";0;0;0;55,35;8,475
1832;"Sønderho";"no";0;0;0;55,35;8,475
1833;"Sønderho";"no";0;0;0;55,35;8,475
1834;"Sønderho";"no";0;0;0;55,35;8,475
1835;"Sønderho";"no";0;0;0;55,35;8,475
1836;"Sønderho";"no";0;0;0;55,35;8,475
1837;"Sønderho";"no";0;0;0;55,35;8,475
1838;"Sønderho";"no";0;0;0;55,35;8,475
1839;"Sønderho";"no";0;0;0;55,35;8,475
1840;"Sønderho";"no";0;0;0;55,35;8,475
1841;"Sønderho";"no";0;0;0;55,35;8,475
1842;"Sønderho";"no";0;0;0;55,35;8,475
1843;"Sønderho";"no";1;0;1;55,35;8,475
1844;"Sønderho";"no";0;0;0;55,35;8,475
1845;"Sønderho";"no";0;0;0;55,35;8,475
1846;"Sønderho";"no";0;0;0;55,35;8,475
1847;"Sønderho";"no";0;0;0;55,35;8,475
1848;"Sønderho";"no";0;0;0;55,35;8,475
1849;"Sønderho";"no";1;0;1;55,35;8,475
1850;"Sønderho";"no";0;0;0;55,35;8,475
1851;"Sønderho";"no";1;0;1;55,35;8,475
1852;"Sønderho";"no";1;0;1;55,35;8,475
1853;"Sønderho";"no";0;0;0;55,35;8,475
1854;"Sønderho";"no";0;0;0;55,35;8,475
1855;"Sønderho";"no";1;0;1;55,35;8,475
1856;"Sønderho";"no";0;0;0;55,35;8,475
1857;"Sønderho";"no";0;0;0;55,35;8,475
1634;"Wejby";"no";0;0;0;56,063888;12,141666
1635;"Wejby";"no";0;0;0;56,063888;12,141666
1636;"Wejby";"no";0;0;0;56,063888;12,141666
1637;"Wejby";"no";0;0;0;56,063888;12,141666
1638;"Wejby";"no";0;0;0;56,063888;12,141666
1639;"Wejby";"no";0;0;0;56,063888;12,141666
1640;"Wejby";"no";0;0;0;56,063888;12,141666
1641;"Wejby";"no";0;0;0;56,063888;12,141666
1642;"Wejby";"no";0;0;0;56,063888;12,141666
1643;"Wejby";"no";0;0;0;56,063888;12,141666
1644;"Wejby";"no";0;0;0;56,063888;12,141666
1645;"Wejby";"no";0;0;0;56,063888;12,141666
1646;"Wejby";"no";0;0;0;56,063888;12,141666
1647;"Wejby";"no";0;0;0;56,063888;12,141666
1648;"Wejby";"no";0;0;0;56,063888;12,141666
1649;"Wejby";"no";0;0;0;56,063888;12,141666
1650;"Wejby";"no";0;0;0;56,063888;12,141666
1651;"Wejby";"no";0;0;0;56,063888;12,141666
1652;"Wejby";"no";0;0;0;56,063888;12,141666
1653;"Wejby";"no";0;0;0;56,063888;12,141666
1654;"Wejby";"no";0;0;0;56,063888;12,141666
1655;"Wejby";"no";0;0;0;56,063888;12,141666
1656;"Wejby";"no";0;0;0;56,063888;12,141666
1657;"Wejby";"no";0;0;0;56,063888;12,141666
1658;"Wejby";"no";0;0;0;56,063888;12,141666
1659;"Wejby";"no";0;0;0;56,063888;12,141666
1660;"Wejby";"no";0;0;0;56,063888;12,141666
1661;"Wejby";"no";0;0;0;56,063888;12,141666
1662;"Wejby";"no";0;0;0;56,063888;12,141666
1663;"Wejby";"no";0;0;0;56,063888;12,141666
1664;"Wejby";"no";0;0;0;56,063888;12,141666
1665;"Wejby";"no";0;0;0;56,063888;12,141666
1666;"Wejby";"no";0;0;0;56,063888;12,141666
1667;"Wejby";"no";0;0;0;56,063888;12,141666
1668;"Wejby";"no";0;0;0;56,063888;12,141666
1669;"Wejby";"no";0;0;0;56,063888;12,141666
1670;"Wejby";"no";0;0;0;56,063888;12,141666
1671;"Wejby";"no";0;0;0;56,063888;12,141666
1672;"Wejby";"no";0;0;0;56,063888;12,141666
1673;"Wejby";"no";0;0;0;56,063888;12,141666
1674;"Wejby";"no";0;0;0;56,063888;12,141666
1675;"Wejby";"no";0;0;0;56,063888;12,141666
1676;"Wejby";"no";0;0;0;56,063888;12,141666
1677;"Wejby";"no";0;0;0;56,063888;12,141666
1678;"Wejby";"no";0;0;0;56,063888;12,141666
1679;"Wejby";"no";0;0;0;56,063888;12,141666
1680;"Wejby";"no";0;0;0;56,063888;12,141666
1681;"Wejby";"no";0;0;0;56,063888;12,141666
1682;"Wejby";"no";0;0;0;56,063888;12,141666
1683;"Wejby";"no";0;0;0;56,063888;12,141666
1684;"Wejby";"no";0;0;0;56,063888;12,141666
1685;"Wejby";"no";0;0;0;56,063888;12,141666
1686;"Wejby";"no";0;0;0;56,063888;12,141666
1687;"Wejby";"no";0;0;0;56,063888;12,141666
1688;"Wejby";"no";0;0;0;56,063888;12,141666
1689;"Wejby";"no";0;0;0;56,063888;12,141666
1690;"Wejby";"no";0;0;0;56,063888;12,141666
1691;"Wejby";"no";0;0;0;56,063888;12,141666
1692;"Wejby";"no";0;0;0;56,063888;12,141666
1693;"Wejby";"no";0;0;0;56,063888;12,141666
1694;"Wejby";"no";0;0;0;56,063888;12,141666
1695;"Wejby";"no";0;0;0;56,063888;12,141666
1696;"Wejby";"no";0;0;0;56,063888;12,141666
1697;"Wejby";"no";0;0;0;56,063888;12,141666
1698;"Wejby";"no";0;0;0;56,063888;12,141666
1699;"Wejby";"no";0;0;0;56,063888;12,141666
1700;"Wejby";"no";0;0;0;56,063888;12,141666
1701;"Wejby";"no";0;0;0;56,063888;12,141666
1702;"Wejby";"no";0;0;0;56,063888;12,141666
1703;"Wejby";"no";0;0;0;56,063888;12,141666
1704;"Wejby";"no";0;0;0;56,063888;12,141666
1705;"Wejby";"no";0;0;0;56,063888;12,141666
1706;"Wejby";"no";0;0;0;56,063888;12,141666
1707;"Wejby";"no";0;0;0;56,063888;12,141666
1708;"Wejby";"no";0;0;0;56,063888;12,141666
1709;"Wejby";"no";0;0;0;56,063888;12,141666
1710;"Wejby";"no";0;0;0;56,063888;12,141666
1711;"Wejby";"no";0;0;0;56,063888;12,141666
1712;"Wejby";"no";0;0;0;56,063888;12,141666
1713;"Wejby";"no";0;0;0;56,063888;12,141666
1714;"Wejby";"no";0;0;0;56,063888;12,141666
1715;"Wejby";"no";0;0;0;56,063888;12,141666
1716;"Wejby";"no";0;0;0;56,063888;12,141666
1717;"Wejby";"no";0;0;0;56,063888;12,141666
1718;"Wejby";"no";0;0;0;56,063888;12,141666
1719;"Wejby";"no";0;0;0;56,063888;12,141666
1720;"Wejby";"no";0;0;0;56,063888;12,141666
1721;"Wejby";"no";0;0;0;56,063888;12,141666
1722;"Wejby";"no";0;0;0;56,063888;12,141666
1723;"Wejby";"no";0;0;0;56,063888;12,141666
1724;"Wejby";"no";0;0;0;56,063888;12,141666
1725;"Wejby";"no";0;0;0;56,063888;12,141666
1726;"Wejby";"no";0;0;0;56,063888;12,141666
1727;"Wejby";"no";0;0;0;56,063888;12,141666
1728;"Wejby";"no";0;0;0;56,063888;12,141666
1729;"Wejby";"no";0;0;0;56,063888;12,141666
1730;"Wejby";"no";0;0;0;56,063888;12,141666
1731;"Wejby";"no";0;0;0;56,063888;12,141666
1732;"Wejby";"no";0;0;0;56,063888;12,141666
1733;"Wejby";"no";0;0;0;56,063888;12,141666
1734;"Wejby";"no";0;0;0;56,063888;12,141666
1735;"Wejby";"no";0;0;0;56,063888;12,141666
1736;"Wejby";"no";0;0;0;56,063888;12,141666
1737;"Wejby";"no";0;0;0;56,063888;12,141666
1738;"Wejby";"no";0;0;0;56,063888;12,141666
1739;"Wejby";"no";0;0;0;56,063888;12,141666
1740;"Wejby";"no";0;0;0;56,063888;12,141666
1741;"Wejby";"no";0;0;0;56,063888;12,141666
1742;"Wejby";"no";0;0;0;56,063888;12,141666
1743;"Wejby";"no";0;0;0;56,063888;12,141666
1744;"Wejby";"no";0;0;0;56,063888;12,141666
1745;"Wejby";"no";0;0;0;56,063888;12,141666
1746;"Wejby";"no";0;0;0;56,063888;12,141666
1747;"Wejby";"no";0;0;0;56,063888;12,141666
1748;"Wejby";"no";0;0;0;56,063888;12,141666
1749;"Wejby";"no";0;0;0;56,063888;12,141666
1750;"Wejby";"no";0;0;0;56,063888;12,141666
1751;"Wejby";"no";0;0;0;56,063888;12,141666
1752;"Wejby";"no";0;0;0;56,063888;12,141666
1753;"Wejby";"no";0;0;0;56,063888;12,141666
1754;"Wejby";"no";0;0;0;56,063888;12,141666
1755;"Wejby";"no";0;0;0;56,063888;12,141666
1756;"Wejby";"no";0;0;0;56,063888;12,141666
1757;"Wejby";"no";0;0;0;56,063888;12,141666
1758;"Wejby";"no";0;0;0;56,063888;12,141666
1759;"Wejby";"no";0;0;0;56,063888;12,141666
1760;"Wejby";"no";0;0;0;56,063888;12,141666
1761;"Wejby";"no";0;0;0;56,063888;12,141666
1762;"Wejby";"no";0;0;0;56,063888;12,141666
1763;"Wejby";"no";0;0;0;56,063888;12,141666
1764;"Wejby";"no";0;0;0;56,063888;12,141666
1765;"Wejby";"no";0;0;0;56,063888;12,141666
1766;"Wejby";"no";0;0;0;56,063888;12,141666
1767;"Wejby";"no";0;0;0;56,063888;12,141666
1768;"Wejby";"no";0;0;0;56,063888;12,141666
1769;"Wejby";"no";0;0;0;56,063888;12,141666
1770;"Wejby";"no";0;0;0;56,063888;12,141666
1771;"Wejby";"no";0;0;0;56,063888;12,141666
1772;"Wejby";"no";0;0;0;56,063888;12,141666
1773;"Wejby";"no";0;0;0;56,063888;12,141666
1774;"Wejby";"no";0;0;0;56,063888;12,141666
1775;"Wejby";"no";0;0;0;56,063888;12,141666
1776;"Wejby";"no";0;0;0;56,063888;12,141666
1777;"Wejby";"no";0;0;0;56,063888;12,141666
1778;"Wejby";"no";0;0;0;56,063888;12,141666
1779;"Wejby";"no";0;0;0;56,063888;12,141666
1780;"Wejby";"no";0;0;0;56,063888;12,141666
1781;"Wejby";"no";0;0;0;56,063888;12,141666
1782;"Wejby";"no";0;0;0;56,063888;12,141666
1783;"Wejby";"no";0;0;0;56,063888;12,141666
1784;"Wejby";"no";0;0;0;56,063888;12,141666
1785;"Wejby";"no";0;0;0;56,063888;12,141666
1786;"Wejby";"no";0;0;0;56,063888;12,141666
1787;"Wejby";"no";0;0;0;56,063888;12,141666
1788;"Wejby";"no";0;0;0;56,063888;12,141666
1789;"Wejby";"no";0;0;0;56,063888;12,141666
1790;"Wejby";"no";0;0;0;56,063888;12,141666
1791;"Wejby";"no";0;0;0;56,063888;12,141666
1792;"Wejby";"no";0;0;0;56,063888;12,141666
1793;"Wejby";"no";0;0;0;56,063888;12,141666
1794;"Wejby";"no";0;0;0;56,063888;12,141666
1795;"Wejby";"no";0;0;0;56,063888;12,141666
1796;"Wejby";"no";0;0;0;56,063888;12,141666
1797;"Wejby";"no";0;0;0;56,063888;12,141666
1798;"Wejby";"no";0;0;0;56,063888;12,141666
1799;"Wejby";"no";0;0;0;56,063888;12,141666
1800;"Wejby";"no";0;0;0;56,063888;12,141666
1801;"Wejby";"no";0;0;0;56,063888;12,141666
1802;"Wejby";"no";0;0;0;56,063888;12,141666
1803;"Wejby";"no";1;0;1;56,063888;12,141666
1804;"Wejby";"no";0;0;0;56,063888;12,141666
1805;"Wejby";"no";0;0;0;56,063888;12,141666
1806;"Wejby";"no";0;0;0;56,063888;12,141666
1807;"Wejby";"no";0;0;0;56,063888;12,141666
1808;"Wejby";"no";0;0;0;56,063888;12,141666
1809;"Wejby";"no";0;0;0;56,063888;12,141666
1810;"Wejby";"no";0;0;0;56,063888;12,141666
1811;"Wejby";"no";0;0;0;56,063888;12,141666
1812;"Wejby";"no";0;0;0;56,063888;12,141666
1813;"Wejby";"no";0;0;0;56,063888;12,141666
1814;"Wejby";"no";0;0;0;56,063888;12,141666
1815;"Wejby";"no";0;0;0;56,063888;12,141666
1816;"Wejby";"no";0;0;0;56,063888;12,141666
1817;"Wejby";"no";0;0;0;56,063888;12,141666
1818;"Wejby";"no";0;0;0;56,063888;12,141666
1819;"Wejby";"no";0;0;0;56,063888;12,141666
1820;"Wejby";"no";0;0;0;56,063888;12,141666
1821;"Wejby";"no";0;0;0;56,063888;12,141666
1822;"Wejby";"no";0;0;0;56,063888;12,141666
1823;"Wejby";"no";0;0;0;56,063888;12,141666
1824;"Wejby";"no";0;0;0;56,063888;12,141666
1825;"Wejby";"no";0;0;0;56,063888;12,141666
1826;"Wejby";"no";0;0;0;56,063888;12,141666
1827;"Wejby";"no";0;0;0;56,063888;12,141666
1828;"Wejby";"no";0;0;0;56,063888;12,141666
1829;"Wejby";"no";0;0;0;56,063888;12,141666
1830;"Wejby";"no";0;0;0;56,063888;12,141666
1831;"Wejby";"no";0;0;0;56,063888;12,141666
1832;"Wejby";"no";0;0;0;56,063888;12,141666
1833;"Wejby";"no";0;0;0;56,063888;12,141666
1834;"Wejby";"no";0;0;0;56,063888;12,141666
1835;"Wejby";"no";0;0;0;56,063888;12,141666
1836;"Wejby";"no";0;0;0;56,063888;12,141666
1837;"Wejby";"no";0;0;0;56,063888;12,141666
1838;"Wejby";"no";0;0;0;56,063888;12,141666
1839;"Wejby";"no";0;0;0;56,063888;12,141666
1840;"Wejby";"no";0;0;0;56,063888;12,141666
1841;"Wejby";"no";0;0;0;56,063888;12,141666
1842;"Wejby";"no";0;0;0;56,063888;12,141666
1843;"Wejby";"no";0;0;0;56,063888;12,141666
1844;"Wejby";"no";0;0;0;56,063888;12,141666
1845;"Wejby";"no";0;0;0;56,063888;12,141666
1846;"Wejby";"no";0;0;0;56,063888;12,141666
1847;"Wejby";"no";0;0;0;56,063888;12,141666
1848;"Wejby";"no";0;0;0;56,063888;12,141666
1849;"Wejby";"no";0;0;0;56,063888;12,141666
1850;"Wejby";"no";0;0;0;56,063888;12,141666
1851;"Wejby";"no";0;0;0;56,063888;12,141666
1852;"Wejby";"no";0;0;0;56,063888;12,141666
1853;"Wejby";"no";0;0;0;56,063888;12,141666
1854;"Wejby";"no";0;0;0;56,063888;12,141666
1855;"Wejby";"no";0;0;0;56,063888;12,141666
1856;"Wejby";"no";0;0;0;56,063888;12,141666
1857;"Wejby";"no";0;0;0;56,063888;12,141666
1634;"Frederiksværk";"no";0;0;0;55,970555;12,0225
1635;"Frederiksværk";"no";0;0;0;55,970555;12,0225
1636;"Frederiksværk";"no";0;0;0;55,970555;12,0225
1637;"Frederiksværk";"no";0;0;0;55,970555;12,0225
1638;"Frederiksværk";"no";0;0;0;55,970555;12,0225
1639;"Frederiksværk";"no";0;0;0;55,970555;12,0225
1640;"Frederiksværk";"no";0;0;0;55,970555;12,0225
1641;"Frederiksværk";"no";0;0;0;55,970555;12,0225
1642;"Frederiksværk";"no";0;0;0;55,970555;12,0225
1643;"Frederiksværk";"no";0;0;0;55,970555;12,0225
1644;"Frederiksværk";"no";0;0;0;55,970555;12,0225
1645;"Frederiksværk";"no";0;0;0;55,970555;12,0225
1646;"Frederiksværk";"no";0;0;0;55,970555;12,0225
1647;"Frederiksværk";"no";0;0;0;55,970555;12,0225
1648;"Frederiksværk";"no";0;0;0;55,970555;12,0225
1649;"Frederiksværk";"no";0;0;0;55,970555;12,0225
1650;"Frederiksværk";"no";0;0;0;55,970555;12,0225
1651;"Frederiksværk";"no";0;0;0;55,970555;12,0225
1652;"Frederiksværk";"no";0;0;0;55,970555;12,0225
1653;"Frederiksværk";"no";0;0;0;55,970555;12,0225
1654;"Frederiksværk";"no";0;0;0;55,970555;12,0225
1655;"Frederiksværk";"no";0;0;0;55,970555;12,0225
1656;"Frederiksværk";"no";0;0;0;55,970555;12,0225
1657;"Frederiksværk";"no";0;0;0;55,970555;12,0225
1658;"Frederiksværk";"no";0;0;0;55,970555;12,0225
1659;"Frederiksværk";"no";0;0;0;55,970555;12,0225
1660;"Frederiksværk";"no";0;0;0;55,970555;12,0225
1661;"Frederiksværk";"no";0;0;0;55,970555;12,0225
1662;"Frederiksværk";"no";0;0;0;55,970555;12,0225
1663;"Frederiksværk";"no";0;0;0;55,970555;12,0225
1664;"Frederiksværk";"no";0;0;0;55,970555;12,0225
1665;"Frederiksværk";"no";0;0;0;55,970555;12,0225
1666;"Frederiksværk";"no";0;0;0;55,970555;12,0225
1667;"Frederiksværk";"no";0;0;0;55,970555;12,0225
1668;"Frederiksværk";"no";0;0;0;55,970555;12,0225
1669;"Frederiksværk";"no";0;0;0;55,970555;12,0225
1670;"Frederiksværk";"no";0;0;0;55,970555;12,0225
1671;"Frederiksværk";"no";0;0;0;55,970555;12,0225
1672;"Frederiksværk";"no";0;0;0;55,970555;12,0225
1673;"Frederiksværk";"no";0;0;0;55,970555;12,0225
1674;"Frederiksværk";"no";0;0;0;55,970555;12,0225
1675;"Frederiksværk";"no";0;0;0;55,970555;12,0225
1676;"Frederiksværk";"no";0;0;0;55,970555;12,0225
1677;"Frederiksværk";"no";0;0;0;55,970555;12,0225
1678;"Frederiksværk";"no";0;0;0;55,970555;12,0225
1679;"Frederiksværk";"no";0;0;0;55,970555;12,0225
1680;"Frederiksværk";"no";0;0;0;55,970555;12,0225
1681;"Frederiksværk";"no";0;0;0;55,970555;12,0225
1682;"Frederiksværk";"no";0;0;0;55,970555;12,0225
1683;"Frederiksværk";"no";0;0;0;55,970555;12,0225
1684;"Frederiksværk";"no";0;0;0;55,970555;12,0225
1685;"Frederiksværk";"no";0;0;0;55,970555;12,0225
1686;"Frederiksværk";"no";0;0;0;55,970555;12,0225
1687;"Frederiksværk";"no";0;0;0;55,970555;12,0225
1688;"Frederiksværk";"no";0;0;0;55,970555;12,0225
1689;"Frederiksværk";"no";0;0;0;55,970555;12,0225
1690;"Frederiksværk";"no";0;0;0;55,970555;12,0225
1691;"Frederiksværk";"no";0;0;0;55,970555;12,0225
1692;"Frederiksværk";"no";0;0;0;55,970555;12,0225
1693;"Frederiksværk";"no";0;0;0;55,970555;12,0225
1694;"Frederiksværk";"no";0;0;0;55,970555;12,0225
1695;"Frederiksværk";"no";0;0;0;55,970555;12,0225
1696;"Frederiksværk";"no";0;0;0;55,970555;12,0225
1697;"Frederiksværk";"no";0;0;0;55,970555;12,0225
1698;"Frederiksværk";"no";0;0;0;55,970555;12,0225
1699;"Frederiksværk";"no";0;0;0;55,970555;12,0225
1700;"Frederiksværk";"no";0;0;0;55,970555;12,0225
1701;"Frederiksværk";"no";0;0;0;55,970555;12,0225
1702;"Frederiksværk";"no";0;0;0;55,970555;12,0225
1703;"Frederiksværk";"no";0;0;0;55,970555;12,0225
1704;"Frederiksværk";"no";0;0;0;55,970555;12,0225
1705;"Frederiksværk";"no";0;0;0;55,970555;12,0225
1706;"Frederiksværk";"no";0;0;0;55,970555;12,0225
1707;"Frederiksværk";"no";0;0;0;55,970555;12,0225
1708;"Frederiksværk";"no";0;0;0;55,970555;12,0225
1709;"Frederiksværk";"no";0;0;0;55,970555;12,0225
1710;"Frederiksværk";"no";0;0;0;55,970555;12,0225
1711;"Frederiksværk";"no";0;0;0;55,970555;12,0225
1712;"Frederiksværk";"no";0;0;0;55,970555;12,0225
1713;"Frederiksværk";"no";0;0;0;55,970555;12,0225
1714;"Frederiksværk";"no";0;0;0;55,970555;12,0225
1715;"Frederiksværk";"no";0;0;0;55,970555;12,0225
1716;"Frederiksværk";"no";0;0;0;55,970555;12,0225
1717;"Frederiksværk";"no";0;0;0;55,970555;12,0225
1718;"Frederiksværk";"no";0;0;0;55,970555;12,0225
1719;"Frederiksværk";"no";0;0;0;55,970555;12,0225
1720;"Frederiksværk";"no";0;0;0;55,970555;12,0225
1721;"Frederiksværk";"no";0;0;0;55,970555;12,0225
1722;"Frederiksværk";"no";0;0;0;55,970555;12,0225
1723;"Frederiksværk";"no";0;0;0;55,970555;12,0225
1724;"Frederiksværk";"no";0;0;0;55,970555;12,0225
1725;"Frederiksværk";"no";0;0;0;55,970555;12,0225
1726;"Frederiksværk";"no";0;0;0;55,970555;12,0225
1727;"Frederiksværk";"no";0;0;0;55,970555;12,0225
1728;"Frederiksværk";"no";0;0;0;55,970555;12,0225
1729;"Frederiksværk";"no";0;0;0;55,970555;12,0225
1730;"Frederiksværk";"no";0;0;0;55,970555;12,0225
1731;"Frederiksværk";"no";0;0;0;55,970555;12,0225
1732;"Frederiksværk";"no";0;0;0;55,970555;12,0225
1733;"Frederiksværk";"no";0;0;0;55,970555;12,0225
1734;"Frederiksværk";"no";0;0;0;55,970555;12,0225
1735;"Frederiksværk";"no";0;0;0;55,970555;12,0225
1736;"Frederiksværk";"no";0;0;0;55,970555;12,0225
1737;"Frederiksværk";"no";0;0;0;55,970555;12,0225
1738;"Frederiksværk";"no";0;0;0;55,970555;12,0225
1739;"Frederiksværk";"no";0;0;0;55,970555;12,0225
1740;"Frederiksværk";"no";0;0;0;55,970555;12,0225
1741;"Frederiksværk";"no";0;0;0;55,970555;12,0225
1742;"Frederiksværk";"no";0;0;0;55,970555;12,0225
1743;"Frederiksværk";"no";0;0;0;55,970555;12,0225
1744;"Frederiksværk";"no";0;0;0;55,970555;12,0225
1745;"Frederiksværk";"no";0;0;0;55,970555;12,0225
1746;"Frederiksværk";"no";0;0;0;55,970555;12,0225
1747;"Frederiksværk";"no";0;0;0;55,970555;12,0225
1748;"Frederiksværk";"no";0;0;0;55,970555;12,0225
1749;"Frederiksværk";"no";0;0;0;55,970555;12,0225
1750;"Frederiksværk";"no";0;0;0;55,970555;12,0225
1751;"Frederiksværk";"no";0;0;0;55,970555;12,0225
1752;"Frederiksværk";"no";0;0;0;55,970555;12,0225
1753;"Frederiksværk";"no";0;0;0;55,970555;12,0225
1754;"Frederiksværk";"no";0;0;0;55,970555;12,0225
1755;"Frederiksværk";"no";0;0;0;55,970555;12,0225
1756;"Frederiksværk";"no";0;0;0;55,970555;12,0225
1757;"Frederiksværk";"no";0;0;0;55,970555;12,0225
1758;"Frederiksværk";"no";0;0;0;55,970555;12,0225
1759;"Frederiksværk";"no";0;0;0;55,970555;12,0225
1760;"Frederiksværk";"no";0;0;0;55,970555;12,0225
1761;"Frederiksværk";"no";0;0;0;55,970555;12,0225
1762;"Frederiksværk";"no";0;0;0;55,970555;12,0225
1763;"Frederiksværk";"no";0;0;0;55,970555;12,0225
1764;"Frederiksværk";"no";0;0;0;55,970555;12,0225
1765;"Frederiksværk";"no";0;1;1;55,970555;12,0225
1766;"Frederiksværk";"no";0;0;0;55,970555;12,0225
1767;"Frederiksværk";"no";0;0;0;55,970555;12,0225
1768;"Frederiksværk";"no";0;0;0;55,970555;12,0225
1769;"Frederiksværk";"no";0;0;0;55,970555;12,0225
1770;"Frederiksværk";"no";0;1;1;55,970555;12,0225
1771;"Frederiksværk";"no";0;0;0;55,970555;12,0225
1772;"Frederiksværk";"no";0;0;0;55,970555;12,0225
1773;"Frederiksværk";"no";0;0;0;55,970555;12,0225
1774;"Frederiksværk";"no";0;0;0;55,970555;12,0225
1775;"Frederiksværk";"no";0;0;0;55,970555;12,0225
1776;"Frederiksværk";"no";0;0;0;55,970555;12,0225
1777;"Frederiksværk";"no";0;0;0;55,970555;12,0225
1778;"Frederiksværk";"no";0;0;0;55,970555;12,0225
1779;"Frederiksværk";"no";0;0;0;55,970555;12,0225
1780;"Frederiksværk";"no";0;0;0;55,970555;12,0225
1781;"Frederiksværk";"no";0;0;0;55,970555;12,0225
1782;"Frederiksværk";"no";0;0;0;55,970555;12,0225
1783;"Frederiksværk";"no";0;0;0;55,970555;12,0225
1784;"Frederiksværk";"no";0;0;0;55,970555;12,0225
1785;"Frederiksværk";"no";0;0;0;55,970555;12,0225
1786;"Frederiksværk";"no";0;0;0;55,970555;12,0225
1787;"Frederiksværk";"no";0;2;2;55,970555;12,0225
1788;"Frederiksværk";"no";0;0;0;55,970555;12,0225
1789;"Frederiksværk";"no";0;0;0;55,970555;12,0225
1790;"Frederiksværk";"no";0;1;1;55,970555;12,0225
1791;"Frederiksværk";"no";0;0;0;55,970555;12,0225
1792;"Frederiksværk";"no";0;0;0;55,970555;12,0225
1793;"Frederiksværk";"no";0;0;0;55,970555;12,0225
1794;"Frederiksværk";"no";0;2;2;55,970555;12,0225
1795;"Frederiksværk";"no";0;0;0;55,970555;12,0225
1796;"Frederiksværk";"no";0;0;0;55,970555;12,0225
1797;"Frederiksværk";"no";0;0;0;55,970555;12,0225
1798;"Frederiksværk";"no";0;0;0;55,970555;12,0225
1799;"Frederiksværk";"no";0;0;0;55,970555;12,0225
1800;"Frederiksværk";"no";0;1;1;55,970555;12,0225
1801;"Frederiksværk";"no";0;1;1;55,970555;12,0225
1802;"Frederiksværk";"no";0;0;0;55,970555;12,0225
1803;"Frederiksværk";"no";0;0;0;55,970555;12,0225
1804;"Frederiksværk";"no";0;0;0;55,970555;12,0225
1805;"Frederiksværk";"no";0;1;1;55,970555;12,0225
1806;"Frederiksværk";"no";0;2;2;55,970555;12,0225
1807;"Frederiksværk";"no";2;1;3;55,970555;12,0225
1808;"Frederiksværk";"no";0;0;0;55,970555;12,0225
1809;"Frederiksværk";"no";0;0;0;55,970555;12,0225
1810;"Frederiksværk";"no";0;0;0;55,970555;12,0225
1811;"Frederiksværk";"no";0;0;0;55,970555;12,0225
1812;"Frederiksværk";"no";0;3;3;55,970555;12,0225
1813;"Frederiksværk";"no";0;1;1;55,970555;12,0225
1814;"Frederiksværk";"no";0;0;0;55,970555;12,0225
1815;"Frederiksværk";"no";0;1;1;55,970555;12,0225
1816;"Frederiksværk";"no";0;0;0;55,970555;12,0225
1817;"Frederiksværk";"no";0;0;0;55,970555;12,0225
1818;"Frederiksværk";"no";0;0;0;55,970555;12,0225
1819;"Frederiksværk";"no";0;1;1;55,970555;12,0225
1820;"Frederiksværk";"no";0;0;0;55,970555;12,0225
1821;"Frederiksværk";"no";0;3;3;55,970555;12,0225
1822;"Frederiksværk";"no";0;0;0;55,970555;12,0225
1823;"Frederiksværk";"no";0;0;0;55,970555;12,0225
1824;"Frederiksværk";"no";0;0;0;55,970555;12,0225
1825;"Frederiksværk";"no";0;0;0;55,970555;12,0225
1826;"Frederiksværk";"no";0;0;0;55,970555;12,0225
1827;"Frederiksværk";"no";0;0;0;55,970555;12,0225
1828;"Frederiksværk";"no";0;0;0;55,970555;12,0225
1829;"Frederiksværk";"no";0;0;0;55,970555;12,0225
1830;"Frederiksværk";"no";0;2;2;55,970555;12,0225
1831;"Frederiksværk";"no";0;0;0;55,970555;12,0225
1832;"Frederiksværk";"no";0;0;0;55,970555;12,0225
1833;"Frederiksværk";"no";0;0;0;55,970555;12,0225
1834;"Frederiksværk";"no";0;0;0;55,970555;12,0225
1835;"Frederiksværk";"no";0;0;0;55,970555;12,0225
1836;"Frederiksværk";"no";0;0;0;55,970555;12,0225
1837;"Frederiksværk";"no";0;0;0;55,970555;12,0225
1838;"Frederiksværk";"no";0;0;0;55,970555;12,0225
1839;"Frederiksværk";"no";0;1;1;55,970555;12,0225
1840;"Frederiksværk";"no";1;2;3;55,970555;12,0225
1841;"Frederiksværk";"no";0;0;0;55,970555;12,0225
1842;"Frederiksværk";"no";2;0;2;55,970555;12,0225
1843;"Frederiksværk";"no";0;0;0;55,970555;12,0225
1844;"Frederiksværk";"no";0;0;0;55,970555;12,0225
1845;"Frederiksværk";"no";0;1;1;55,970555;12,0225
1846;"Frederiksværk";"no";3;2;5;55,970555;12,0225
1847;"Frederiksværk";"no";7;0;7;55,970555;12,0225
1848;"Frederiksværk";"no";1;0;1;55,970555;12,0225
1849;"Frederiksværk";"no";4;1;5;55,970555;12,0225
1850;"Frederiksværk";"no";1;0;1;55,970555;12,0225
1851;"Frederiksværk";"no";2;0;2;55,970555;12,0225
1852;"Frederiksværk";"no";2;2;4;55,970555;12,0225
1853;"Frederiksværk";"no";5;2;7;55,970555;12,0225
1854;"Frederiksværk";"no";2;0;2;55,970555;12,0225
1855;"Frederiksværk";"no";7;0;7;55,970555;12,0225
1856;"Frederiksværk";"no";0;1;1;55,970555;12,0225
1857;"Frederiksværk";"no";0;0;0;55,970555;12,0225
1634;"Vedbæk";"no";0;0;0;55,85;12,566666
1635;"Vedbæk";"no";0;0;0;55,85;12,566666
1636;"Vedbæk";"no";0;0;0;55,85;12,566666
1637;"Vedbæk";"no";0;0;0;55,85;12,566666
1638;"Vedbæk";"no";0;0;0;55,85;12,566666
1639;"Vedbæk";"no";0;0;0;55,85;12,566666
1640;"Vedbæk";"no";0;0;0;55,85;12,566666
1641;"Vedbæk";"no";0;0;0;55,85;12,566666
1642;"Vedbæk";"no";0;0;0;55,85;12,566666
1643;"Vedbæk";"no";0;0;0;55,85;12,566666
1644;"Vedbæk";"no";0;0;0;55,85;12,566666
1645;"Vedbæk";"no";0;0;0;55,85;12,566666
1646;"Vedbæk";"no";0;0;0;55,85;12,566666
1647;"Vedbæk";"no";0;0;0;55,85;12,566666
1648;"Vedbæk";"no";0;0;0;55,85;12,566666
1649;"Vedbæk";"no";0;0;0;55,85;12,566666
1650;"Vedbæk";"no";0;0;0;55,85;12,566666
1651;"Vedbæk";"no";0;0;0;55,85;12,566666
1652;"Vedbæk";"no";0;0;0;55,85;12,566666
1653;"Vedbæk";"no";0;0;0;55,85;12,566666
1654;"Vedbæk";"no";0;0;0;55,85;12,566666
1655;"Vedbæk";"no";0;0;0;55,85;12,566666
1656;"Vedbæk";"no";0;0;0;55,85;12,566666
1657;"Vedbæk";"no";0;0;0;55,85;12,566666
1658;"Vedbæk";"no";0;0;0;55,85;12,566666
1659;"Vedbæk";"no";0;0;0;55,85;12,566666
1660;"Vedbæk";"no";0;0;0;55,85;12,566666
1661;"Vedbæk";"no";0;0;0;55,85;12,566666
1662;"Vedbæk";"no";0;0;0;55,85;12,566666
1663;"Vedbæk";"no";0;0;0;55,85;12,566666
1664;"Vedbæk";"no";0;0;0;55,85;12,566666
1665;"Vedbæk";"no";0;0;0;55,85;12,566666
1666;"Vedbæk";"no";0;0;0;55,85;12,566666
1667;"Vedbæk";"no";0;0;0;55,85;12,566666
1668;"Vedbæk";"no";0;0;0;55,85;12,566666
1669;"Vedbæk";"no";0;0;0;55,85;12,566666
1670;"Vedbæk";"no";0;0;0;55,85;12,566666
1671;"Vedbæk";"no";0;0;0;55,85;12,566666
1672;"Vedbæk";"no";0;0;0;55,85;12,566666
1673;"Vedbæk";"no";0;0;0;55,85;12,566666
1674;"Vedbæk";"no";0;0;0;55,85;12,566666
1675;"Vedbæk";"no";0;0;0;55,85;12,566666
1676;"Vedbæk";"no";0;0;0;55,85;12,566666
1677;"Vedbæk";"no";0;0;0;55,85;12,566666
1678;"Vedbæk";"no";0;0;0;55,85;12,566666
1679;"Vedbæk";"no";0;0;0;55,85;12,566666
1680;"Vedbæk";"no";0;0;0;55,85;12,566666
1681;"Vedbæk";"no";0;0;0;55,85;12,566666
1682;"Vedbæk";"no";0;0;0;55,85;12,566666
1683;"Vedbæk";"no";0;0;0;55,85;12,566666
1684;"Vedbæk";"no";0;0;0;55,85;12,566666
1685;"Vedbæk";"no";0;0;0;55,85;12,566666
1686;"Vedbæk";"no";0;0;0;55,85;12,566666
1687;"Vedbæk";"no";0;0;0;55,85;12,566666
1688;"Vedbæk";"no";0;0;0;55,85;12,566666
1689;"Vedbæk";"no";0;0;0;55,85;12,566666
1690;"Vedbæk";"no";0;0;0;55,85;12,566666
1691;"Vedbæk";"no";0;0;0;55,85;12,566666
1692;"Vedbæk";"no";0;0;0;55,85;12,566666
1693;"Vedbæk";"no";0;0;0;55,85;12,566666
1694;"Vedbæk";"no";0;0;0;55,85;12,566666
1695;"Vedbæk";"no";0;0;0;55,85;12,566666
1696;"Vedbæk";"no";0;0;0;55,85;12,566666
1697;"Vedbæk";"no";0;0;0;55,85;12,566666
1698;"Vedbæk";"no";0;0;0;55,85;12,566666
1699;"Vedbæk";"no";0;0;0;55,85;12,566666
1700;"Vedbæk";"no";0;0;0;55,85;12,566666
1701;"Vedbæk";"no";0;0;0;55,85;12,566666
1702;"Vedbæk";"no";0;0;0;55,85;12,566666
1703;"Vedbæk";"no";0;0;0;55,85;12,566666
1704;"Vedbæk";"no";0;0;0;55,85;12,566666
1705;"Vedbæk";"no";0;0;0;55,85;12,566666
1706;"Vedbæk";"no";0;0;0;55,85;12,566666
1707;"Vedbæk";"no";0;0;0;55,85;12,566666
1708;"Vedbæk";"no";0;0;0;55,85;12,566666
1709;"Vedbæk";"no";0;0;0;55,85;12,566666
1710;"Vedbæk";"no";0;0;0;55,85;12,566666
1711;"Vedbæk";"no";0;0;0;55,85;12,566666
1712;"Vedbæk";"no";0;0;0;55,85;12,566666
1713;"Vedbæk";"no";0;0;0;55,85;12,566666
1714;"Vedbæk";"no";0;0;0;55,85;12,566666
1715;"Vedbæk";"no";0;0;0;55,85;12,566666
1716;"Vedbæk";"no";0;0;0;55,85;12,566666
1717;"Vedbæk";"no";0;0;0;55,85;12,566666
1718;"Vedbæk";"no";0;0;0;55,85;12,566666
1719;"Vedbæk";"no";0;0;0;55,85;12,566666
1720;"Vedbæk";"no";0;0;0;55,85;12,566666
1721;"Vedbæk";"no";0;0;0;55,85;12,566666
1722;"Vedbæk";"no";0;0;0;55,85;12,566666
1723;"Vedbæk";"no";0;0;0;55,85;12,566666
1724;"Vedbæk";"no";0;0;0;55,85;12,566666
1725;"Vedbæk";"no";0;0;0;55,85;12,566666
1726;"Vedbæk";"no";0;0;0;55,85;12,566666
1727;"Vedbæk";"no";0;0;0;55,85;12,566666
1728;"Vedbæk";"no";0;0;0;55,85;12,566666
1729;"Vedbæk";"no";0;0;0;55,85;12,566666
1730;"Vedbæk";"no";0;0;0;55,85;12,566666
1731;"Vedbæk";"no";0;0;0;55,85;12,566666
1732;"Vedbæk";"no";0;0;0;55,85;12,566666
1733;"Vedbæk";"no";0;0;0;55,85;12,566666
1734;"Vedbæk";"no";0;0;0;55,85;12,566666
1735;"Vedbæk";"no";0;0;0;55,85;12,566666
1736;"Vedbæk";"no";0;0;0;55,85;12,566666
1737;"Vedbæk";"no";0;0;0;55,85;12,566666
1738;"Vedbæk";"no";0;0;0;55,85;12,566666
1739;"Vedbæk";"no";0;0;0;55,85;12,566666
1740;"Vedbæk";"no";0;0;0;55,85;12,566666
1741;"Vedbæk";"no";0;0;0;55,85;12,566666
1742;"Vedbæk";"no";0;0;0;55,85;12,566666
1743;"Vedbæk";"no";0;0;0;55,85;12,566666
1744;"Vedbæk";"no";0;0;0;55,85;12,566666
1745;"Vedbæk";"no";0;0;0;55,85;12,566666
1746;"Vedbæk";"no";0;0;0;55,85;12,566666
1747;"Vedbæk";"no";0;0;0;55,85;12,566666
1748;"Vedbæk";"no";0;0;0;55,85;12,566666
1749;"Vedbæk";"no";0;0;0;55,85;12,566666
1750;"Vedbæk";"no";0;0;0;55,85;12,566666
1751;"Vedbæk";"no";0;0;0;55,85;12,566666
1752;"Vedbæk";"no";0;0;0;55,85;12,566666
1753;"Vedbæk";"no";0;0;0;55,85;12,566666
1754;"Vedbæk";"no";0;0;0;55,85;12,566666
1755;"Vedbæk";"no";0;0;0;55,85;12,566666
1756;"Vedbæk";"no";0;0;0;55,85;12,566666
1757;"Vedbæk";"no";0;0;0;55,85;12,566666
1758;"Vedbæk";"no";0;0;0;55,85;12,566666
1759;"Vedbæk";"no";0;0;0;55,85;12,566666
1760;"Vedbæk";"no";0;0;0;55,85;12,566666
1761;"Vedbæk";"no";0;0;0;55,85;12,566666
1762;"Vedbæk";"no";0;0;0;55,85;12,566666
1763;"Vedbæk";"no";0;0;0;55,85;12,566666
1764;"Vedbæk";"no";0;0;0;55,85;12,566666
1765;"Vedbæk";"no";0;0;0;55,85;12,566666
1766;"Vedbæk";"no";0;0;0;55,85;12,566666
1767;"Vedbæk";"no";0;0;0;55,85;12,566666
1768;"Vedbæk";"no";0;0;0;55,85;12,566666
1769;"Vedbæk";"no";0;0;0;55,85;12,566666
1770;"Vedbæk";"no";0;0;0;55,85;12,566666
1771;"Vedbæk";"no";0;0;0;55,85;12,566666
1772;"Vedbæk";"no";0;0;0;55,85;12,566666
1773;"Vedbæk";"no";0;0;0;55,85;12,566666
1774;"Vedbæk";"no";0;0;0;55,85;12,566666
1775;"Vedbæk";"no";0;0;0;55,85;12,566666
1776;"Vedbæk";"no";0;0;0;55,85;12,566666
1777;"Vedbæk";"no";0;0;0;55,85;12,566666
1778;"Vedbæk";"no";0;0;0;55,85;12,566666
1779;"Vedbæk";"no";0;0;0;55,85;12,566666
1780;"Vedbæk";"no";0;0;0;55,85;12,566666
1781;"Vedbæk";"no";0;0;0;55,85;12,566666
1782;"Vedbæk";"no";0;0;0;55,85;12,566666
1783;"Vedbæk";"no";0;0;0;55,85;12,566666
1784;"Vedbæk";"no";0;0;0;55,85;12,566666
1785;"Vedbæk";"no";0;0;0;55,85;12,566666
1786;"Vedbæk";"no";0;0;0;55,85;12,566666
1787;"Vedbæk";"no";0;0;0;55,85;12,566666
1788;"Vedbæk";"no";0;0;0;55,85;12,566666
1789;"Vedbæk";"no";0;0;0;55,85;12,566666
1790;"Vedbæk";"no";0;0;0;55,85;12,566666
1791;"Vedbæk";"no";0;0;0;55,85;12,566666
1792;"Vedbæk";"no";0;0;0;55,85;12,566666
1793;"Vedbæk";"no";0;0;0;55,85;12,566666
1794;"Vedbæk";"no";0;0;0;55,85;12,566666
1795;"Vedbæk";"no";0;0;0;55,85;12,566666
1796;"Vedbæk";"no";0;0;0;55,85;12,566666
1797;"Vedbæk";"no";0;0;0;55,85;12,566666
1798;"Vedbæk";"no";0;0;0;55,85;12,566666
1799;"Vedbæk";"no";0;0;0;55,85;12,566666
1800;"Vedbæk";"no";0;0;0;55,85;12,566666
1801;"Vedbæk";"no";0;0;0;55,85;12,566666
1802;"Vedbæk";"no";0;0;0;55,85;12,566666
1803;"Vedbæk";"no";0;0;0;55,85;12,566666
1804;"Vedbæk";"no";0;0;0;55,85;12,566666
1805;"Vedbæk";"no";0;0;0;55,85;12,566666
1806;"Vedbæk";"no";0;0;0;55,85;12,566666
1807;"Vedbæk";"no";0;0;0;55,85;12,566666
1808;"Vedbæk";"no";0;0;0;55,85;12,566666
1809;"Vedbæk";"no";0;0;0;55,85;12,566666
1810;"Vedbæk";"no";0;0;0;55,85;12,566666
1811;"Vedbæk";"no";0;0;0;55,85;12,566666
1812;"Vedbæk";"no";1;0;1;55,85;12,566666
1813;"Vedbæk";"no";0;0;0;55,85;12,566666
1814;"Vedbæk";"no";0;0;0;55,85;12,566666
1815;"Vedbæk";"no";1;0;1;55,85;12,566666
1816;"Vedbæk";"no";1;0;1;55,85;12,566666
1817;"Vedbæk";"no";0;0;0;55,85;12,566666
1818;"Vedbæk";"no";1;0;1;55,85;12,566666
1819;"Vedbæk";"no";0;0;0;55,85;12,566666
1820;"Vedbæk";"no";0;0;0;55,85;12,566666
1821;"Vedbæk";"no";1;0;1;55,85;12,566666
1822;"Vedbæk";"no";1;0;1;55,85;12,566666
1823;"Vedbæk";"no";4;1;5;55,85;12,566666
1824;"Vedbæk";"no";3;0;3;55,85;12,566666
1825;"Vedbæk";"no";3;0;3;55,85;12,566666
1826;"Vedbæk";"no";8;0;8;55,85;12,566666
1827;"Vedbæk";"no";5;2;7;55,85;12,566666
1828;"Vedbæk";"no";5;1;6;55,85;12,566666
1829;"Vedbæk";"no";4;0;4;55,85;12,566666
1830;"Vedbæk";"no";6;6;12;55,85;12,566666
1831;"Vedbæk";"no";4;4;8;55,85;12,566666
1832;"Vedbæk";"no";4;0;4;55,85;12,566666
1833;"Vedbæk";"no";5;2;7;55,85;12,566666
1834;"Vedbæk";"no";5;0;5;55,85;12,566666
1835;"Vedbæk";"no";3;1;4;55,85;12,566666
1836;"Vedbæk";"no";7;1;8;55,85;12,566666
1837;"Vedbæk";"no";4;1;5;55,85;12,566666
1838;"Vedbæk";"no";3;6;9;55,85;12,566666
1839;"Vedbæk";"no";3;5;8;55,85;12,566666
1840;"Vedbæk";"no";4;3;7;55,85;12,566666
1841;"Vedbæk";"no";4;5;9;55,85;12,566666
1842;"Vedbæk";"no";4;3;7;55,85;12,566666
1843;"Vedbæk";"no";3;4;7;55,85;12,566666
1844;"Vedbæk";"no";2;5;7;55,85;12,566666
1845;"Vedbæk";"no";4;5;9;55,85;12,566666
1846;"Vedbæk";"no";4;4;8;55,85;12,566666
1847;"Vedbæk";"no";0;5;5;55,85;12,566666
1848;"Vedbæk";"no";3;3;6;55,85;12,566666
1849;"Vedbæk";"no";2;4;6;55,85;12,566666
1850;"Vedbæk";"no";0;0;0;55,85;12,566666
1851;"Vedbæk";"no";1;0;1;55,85;12,566666
1852;"Vedbæk";"no";1;0;1;55,85;12,566666
1853;"Vedbæk";"no";0;0;0;55,85;12,566666
1854;"Vedbæk";"no";8;0;8;55,85;12,566666
1855;"Vedbæk";"no";2;0;2;55,85;12,566666
1856;"Vedbæk";"no";2;0;2;55,85;12,566666
1857;"Vedbæk";"no";0;0;0;55,85;12,566666
1634;"Kastrup";"no";0;0;0;55,609579;12,606499
1635;"Kastrup";"no";0;0;0;55,609579;12,606499
1636;"Kastrup";"no";0;0;0;55,609579;12,606499
1637;"Kastrup";"no";0;0;0;55,609579;12,606499
1638;"Kastrup";"no";0;0;0;55,609579;12,606499
1639;"Kastrup";"no";0;0;0;55,609579;12,606499
1640;"Kastrup";"no";0;0;0;55,609579;12,606499
1641;"Kastrup";"no";0;0;0;55,609579;12,606499
1642;"Kastrup";"no";0;0;0;55,609579;12,606499
1643;"Kastrup";"no";0;0;0;55,609579;12,606499
1644;"Kastrup";"no";0;0;0;55,609579;12,606499
1645;"Kastrup";"no";0;0;0;55,609579;12,606499
1646;"Kastrup";"no";0;0;0;55,609579;12,606499
1647;"Kastrup";"no";0;0;0;55,609579;12,606499
1648;"Kastrup";"no";0;0;0;55,609579;12,606499
1649;"Kastrup";"no";0;0;0;55,609579;12,606499
1650;"Kastrup";"no";0;0;0;55,609579;12,606499
1651;"Kastrup";"no";0;0;0;55,609579;12,606499
1652;"Kastrup";"no";0;0;0;55,609579;12,606499
1653;"Kastrup";"no";0;0;0;55,609579;12,606499
1654;"Kastrup";"no";0;0;0;55,609579;12,606499
1655;"Kastrup";"no";0;0;0;55,609579;12,606499
1656;"Kastrup";"no";0;0;0;55,609579;12,606499
1657;"Kastrup";"no";0;0;0;55,609579;12,606499
1658;"Kastrup";"no";0;0;0;55,609579;12,606499
1659;"Kastrup";"no";0;0;0;55,609579;12,606499
1660;"Kastrup";"no";0;0;0;55,609579;12,606499
1661;"Kastrup";"no";0;0;0;55,609579;12,606499
1662;"Kastrup";"no";0;0;0;55,609579;12,606499
1663;"Kastrup";"no";0;0;0;55,609579;12,606499
1664;"Kastrup";"no";0;0;0;55,609579;12,606499
1665;"Kastrup";"no";0;0;0;55,609579;12,606499
1666;"Kastrup";"no";0;0;0;55,609579;12,606499
1667;"Kastrup";"no";0;0;0;55,609579;12,606499
1668;"Kastrup";"no";0;0;0;55,609579;12,606499
1669;"Kastrup";"no";0;0;0;55,609579;12,606499
1670;"Kastrup";"no";0;0;0;55,609579;12,606499
1671;"Kastrup";"no";0;0;0;55,609579;12,606499
1672;"Kastrup";"no";0;0;0;55,609579;12,606499
1673;"Kastrup";"no";0;0;0;55,609579;12,606499
1674;"Kastrup";"no";0;0;0;55,609579;12,606499
1675;"Kastrup";"no";0;0;0;55,609579;12,606499
1676;"Kastrup";"no";0;0;0;55,609579;12,606499
1677;"Kastrup";"no";0;0;0;55,609579;12,606499
1678;"Kastrup";"no";0;0;0;55,609579;12,606499
1679;"Kastrup";"no";0;0;0;55,609579;12,606499
1680;"Kastrup";"no";0;0;0;55,609579;12,606499
1681;"Kastrup";"no";0;0;0;55,609579;12,606499
1682;"Kastrup";"no";0;0;0;55,609579;12,606499
1683;"Kastrup";"no";0;0;0;55,609579;12,606499
1684;"Kastrup";"no";0;0;0;55,609579;12,606499
1685;"Kastrup";"no";0;0;0;55,609579;12,606499
1686;"Kastrup";"no";0;0;0;55,609579;12,606499
1687;"Kastrup";"no";0;0;0;55,609579;12,606499
1688;"Kastrup";"no";0;0;0;55,609579;12,606499
1689;"Kastrup";"no";0;0;0;55,609579;12,606499
1690;"Kastrup";"no";0;0;0;55,609579;12,606499
1691;"Kastrup";"no";0;0;0;55,609579;12,606499
1692;"Kastrup";"no";0;0;0;55,609579;12,606499
1693;"Kastrup";"no";0;0;0;55,609579;12,606499
1694;"Kastrup";"no";0;0;0;55,609579;12,606499
1695;"Kastrup";"no";0;0;0;55,609579;12,606499
1696;"Kastrup";"no";0;0;0;55,609579;12,606499
1697;"Kastrup";"no";0;0;0;55,609579;12,606499
1698;"Kastrup";"no";0;0;0;55,609579;12,606499
1699;"Kastrup";"no";0;0;0;55,609579;12,606499
1700;"Kastrup";"no";0;0;0;55,609579;12,606499
1701;"Kastrup";"no";0;0;0;55,609579;12,606499
1702;"Kastrup";"no";0;0;0;55,609579;12,606499
1703;"Kastrup";"no";0;0;0;55,609579;12,606499
1704;"Kastrup";"no";0;0;0;55,609579;12,606499
1705;"Kastrup";"no";0;0;0;55,609579;12,606499
1706;"Kastrup";"no";0;0;0;55,609579;12,606499
1707;"Kastrup";"no";0;0;0;55,609579;12,606499
1708;"Kastrup";"no";0;0;0;55,609579;12,606499
1709;"Kastrup";"no";0;0;0;55,609579;12,606499
1710;"Kastrup";"no";0;0;0;55,609579;12,606499
1711;"Kastrup";"no";0;0;0;55,609579;12,606499
1712;"Kastrup";"no";0;0;0;55,609579;12,606499
1713;"Kastrup";"no";0;0;0;55,609579;12,606499
1714;"Kastrup";"no";0;0;0;55,609579;12,606499
1715;"Kastrup";"no";0;0;0;55,609579;12,606499
1716;"Kastrup";"no";0;0;0;55,609579;12,606499
1717;"Kastrup";"no";0;0;0;55,609579;12,606499
1718;"Kastrup";"no";0;0;0;55,609579;12,606499
1719;"Kastrup";"no";0;0;0;55,609579;12,606499
1720;"Kastrup";"no";0;0;0;55,609579;12,606499
1721;"Kastrup";"no";0;0;0;55,609579;12,606499
1722;"Kastrup";"no";0;0;0;55,609579;12,606499
1723;"Kastrup";"no";0;0;0;55,609579;12,606499
1724;"Kastrup";"no";0;0;0;55,609579;12,606499
1725;"Kastrup";"no";0;0;0;55,609579;12,606499
1726;"Kastrup";"no";0;0;0;55,609579;12,606499
1727;"Kastrup";"no";0;0;0;55,609579;12,606499
1728;"Kastrup";"no";0;0;0;55,609579;12,606499
1729;"Kastrup";"no";0;0;0;55,609579;12,606499
1730;"Kastrup";"no";0;0;0;55,609579;12,606499
1731;"Kastrup";"no";0;0;0;55,609579;12,606499
1732;"Kastrup";"no";0;0;0;55,609579;12,606499
1733;"Kastrup";"no";0;0;0;55,609579;12,606499
1734;"Kastrup";"no";0;0;0;55,609579;12,606499
1735;"Kastrup";"no";0;0;0;55,609579;12,606499
1736;"Kastrup";"no";0;0;0;55,609579;12,606499
1737;"Kastrup";"no";0;0;0;55,609579;12,606499
1738;"Kastrup";"no";0;0;0;55,609579;12,606499
1739;"Kastrup";"no";0;0;0;55,609579;12,606499
1740;"Kastrup";"no";0;0;0;55,609579;12,606499
1741;"Kastrup";"no";0;0;0;55,609579;12,606499
1742;"Kastrup";"no";0;0;0;55,609579;12,606499
1743;"Kastrup";"no";0;0;0;55,609579;12,606499
1744;"Kastrup";"no";0;0;0;55,609579;12,606499
1745;"Kastrup";"no";0;0;0;55,609579;12,606499
1746;"Kastrup";"no";0;0;0;55,609579;12,606499
1747;"Kastrup";"no";0;0;0;55,609579;12,606499
1748;"Kastrup";"no";0;0;0;55,609579;12,606499
1749;"Kastrup";"no";0;0;0;55,609579;12,606499
1750;"Kastrup";"no";0;0;0;55,609579;12,606499
1751;"Kastrup";"no";0;0;0;55,609579;12,606499
1752;"Kastrup";"no";0;0;0;55,609579;12,606499
1753;"Kastrup";"no";0;0;0;55,609579;12,606499
1754;"Kastrup";"no";0;0;0;55,609579;12,606499
1755;"Kastrup";"no";0;0;0;55,609579;12,606499
1756;"Kastrup";"no";0;0;0;55,609579;12,606499
1757;"Kastrup";"no";0;0;0;55,609579;12,606499
1758;"Kastrup";"no";0;0;0;55,609579;12,606499
1759;"Kastrup";"no";0;0;0;55,609579;12,606499
1760;"Kastrup";"no";0;0;0;55,609579;12,606499
1761;"Kastrup";"no";0;0;0;55,609579;12,606499
1762;"Kastrup";"no";0;0;0;55,609579;12,606499
1763;"Kastrup";"no";0;0;0;55,609579;12,606499
1764;"Kastrup";"no";0;0;0;55,609579;12,606499
1765;"Kastrup";"no";0;0;0;55,609579;12,606499
1766;"Kastrup";"no";0;0;0;55,609579;12,606499
1767;"Kastrup";"no";0;0;0;55,609579;12,606499
1768;"Kastrup";"no";0;0;0;55,609579;12,606499
1769;"Kastrup";"no";0;0;0;55,609579;12,606499
1770;"Kastrup";"no";0;0;0;55,609579;12,606499
1771;"Kastrup";"no";0;0;0;55,609579;12,606499
1772;"Kastrup";"no";0;0;0;55,609579;12,606499
1773;"Kastrup";"no";0;0;0;55,609579;12,606499
1774;"Kastrup";"no";0;0;0;55,609579;12,606499
1775;"Kastrup";"no";0;0;0;55,609579;12,606499
1776;"Kastrup";"no";0;0;0;55,609579;12,606499
1777;"Kastrup";"no";0;0;0;55,609579;12,606499
1778;"Kastrup";"no";0;0;0;55,609579;12,606499
1779;"Kastrup";"no";0;0;0;55,609579;12,606499
1780;"Kastrup";"no";0;0;0;55,609579;12,606499
1781;"Kastrup";"no";0;0;0;55,609579;12,606499
1782;"Kastrup";"no";0;0;0;55,609579;12,606499
1783;"Kastrup";"no";0;0;0;55,609579;12,606499
1784;"Kastrup";"no";0;0;0;55,609579;12,606499
1785;"Kastrup";"no";0;0;0;55,609579;12,606499
1786;"Kastrup";"no";0;0;0;55,609579;12,606499
1787;"Kastrup";"no";0;0;0;55,609579;12,606499
1788;"Kastrup";"no";0;0;0;55,609579;12,606499
1789;"Kastrup";"no";0;0;0;55,609579;12,606499
1790;"Kastrup";"no";0;0;0;55,609579;12,606499
1791;"Kastrup";"no";0;0;0;55,609579;12,606499
1792;"Kastrup";"no";0;0;0;55,609579;12,606499
1793;"Kastrup";"no";0;0;0;55,609579;12,606499
1794;"Kastrup";"no";0;1;1;55,609579;12,606499
1795;"Kastrup";"no";0;0;0;55,609579;12,606499
1796;"Kastrup";"no";0;1;1;55,609579;12,606499
1797;"Kastrup";"no";0;0;0;55,609579;12,606499
1798;"Kastrup";"no";0;0;0;55,609579;12,606499
1799;"Kastrup";"no";0;0;0;55,609579;12,606499
1800;"Kastrup";"no";0;0;0;55,609579;12,606499
1801;"Kastrup";"no";0;0;0;55,609579;12,606499
1802;"Kastrup";"no";0;0;0;55,609579;12,606499
1803;"Kastrup";"no";0;0;0;55,609579;12,606499
1804;"Kastrup";"no";0;0;0;55,609579;12,606499
1805;"Kastrup";"no";0;0;0;55,609579;12,606499
1806;"Kastrup";"no";0;0;0;55,609579;12,606499
1807;"Kastrup";"no";0;0;0;55,609579;12,606499
1808;"Kastrup";"no";0;0;0;55,609579;12,606499
1809;"Kastrup";"no";0;0;0;55,609579;12,606499
1810;"Kastrup";"no";0;0;0;55,609579;12,606499
1811;"Kastrup";"no";0;0;0;55,609579;12,606499
1812;"Kastrup";"no";0;0;0;55,609579;12,606499
1813;"Kastrup";"no";0;0;0;55,609579;12,606499
1814;"Kastrup";"no";0;0;0;55,609579;12,606499
1815;"Kastrup";"no";0;0;0;55,609579;12,606499
1816;"Kastrup";"no";0;0;0;55,609579;12,606499
1817;"Kastrup";"no";0;0;0;55,609579;12,606499
1818;"Kastrup";"no";0;0;0;55,609579;12,606499
1819;"Kastrup";"no";0;0;0;55,609579;12,606499
1820;"Kastrup";"no";0;0;0;55,609579;12,606499
1821;"Kastrup";"no";0;0;0;55,609579;12,606499
1822;"Kastrup";"no";0;0;0;55,609579;12,606499
1823;"Kastrup";"no";0;0;0;55,609579;12,606499
1824;"Kastrup";"no";0;2;2;55,609579;12,606499
1825;"Kastrup";"no";1;33;34;55,609579;12,606499
1826;"Kastrup";"no";0;53;53;55,609579;12,606499
1827;"Kastrup";"no";1;31;32;55,609579;12,606499
1828;"Kastrup";"no";0;11;11;55,609579;12,606499
1829;"Kastrup";"no";0;33;33;55,609579;12,606499
1830;"Kastrup";"no";1;45;46;55,609579;12,606499
1831;"Kastrup";"no";0;15;15;55,609579;12,606499
1832;"Kastrup";"no";0;10;10;55,609579;12,606499
1833;"Kastrup";"no";0;8;8;55,609579;12,606499
1834;"Kastrup";"no";0;4;4;55,609579;12,606499
1835;"Kastrup";"no";0;6;6;55,609579;12,606499
1836;"Kastrup";"no";0;6;6;55,609579;12,606499
1837;"Kastrup";"no";0;15;15;55,609579;12,606499
1838;"Kastrup";"no";0;9;9;55,609579;12,606499
1839;"Kastrup";"no";0;6;6;55,609579;12,606499
1840;"Kastrup";"no";0;5;5;55,609579;12,606499
1841;"Kastrup";"no";0;3;3;55,609579;12,606499
1842;"Kastrup";"no";0;2;2;55,609579;12,606499
1843;"Kastrup";"no";0;5;5;55,609579;12,606499
1844;"Kastrup";"no";1;0;1;55,609579;12,606499
1845;"Kastrup";"no";0;2;2;55,609579;12,606499
1846;"Kastrup";"no";0;2;2;55,609579;12,606499
1847;"Kastrup";"no";0;6;6;55,609579;12,606499
1848;"Kastrup";"no";0;8;8;55,609579;12,606499
1849;"Kastrup";"no";0;6;6;55,609579;12,606499
1850;"Kastrup";"no";0;11;11;55,609579;12,606499
1851;"Kastrup";"no";0;12;12;55,609579;12,606499
1852;"Kastrup";"no";0;15;15;55,609579;12,606499
1853;"Kastrup";"no";0;14;14;55,609579;12,606499
1854;"Kastrup";"no";0;16;16;55,609579;12,606499
1855;"Kastrup";"no";1;18;19;55,609579;12,606499
1856;"Kastrup";"no";2;14;16;55,609579;12,606499
1857;"Kastrup";"no";0;2;2;55,609579;12,606499
1634;"Vestermark";"no";0;0;0;54,898333;11,648888
1635;"Vestermark";"no";0;0;0;54,898333;11,648888
1636;"Vestermark";"no";0;0;0;54,898333;11,648888
1637;"Vestermark";"no";0;0;0;54,898333;11,648888
1638;"Vestermark";"no";0;0;0;54,898333;11,648888
1639;"Vestermark";"no";0;0;0;54,898333;11,648888
1640;"Vestermark";"no";0;0;0;54,898333;11,648888
1641;"Vestermark";"no";0;0;0;54,898333;11,648888
1642;"Vestermark";"no";0;0;0;54,898333;11,648888
1643;"Vestermark";"no";0;0;0;54,898333;11,648888
1644;"Vestermark";"no";0;0;0;54,898333;11,648888
1645;"Vestermark";"no";0;0;0;54,898333;11,648888
1646;"Vestermark";"no";0;0;0;54,898333;11,648888
1647;"Vestermark";"no";0;0;0;54,898333;11,648888
1648;"Vestermark";"no";0;0;0;54,898333;11,648888
1649;"Vestermark";"no";0;0;0;54,898333;11,648888
1650;"Vestermark";"no";0;0;0;54,898333;11,648888
1651;"Vestermark";"no";0;0;0;54,898333;11,648888
1652;"Vestermark";"no";0;0;0;54,898333;11,648888
1653;"Vestermark";"no";0;0;0;54,898333;11,648888
1654;"Vestermark";"no";0;0;0;54,898333;11,648888
1655;"Vestermark";"no";0;0;0;54,898333;11,648888
1656;"Vestermark";"no";0;0;0;54,898333;11,648888
1657;"Vestermark";"no";0;0;0;54,898333;11,648888
1658;"Vestermark";"no";0;0;0;54,898333;11,648888
1659;"Vestermark";"no";0;0;0;54,898333;11,648888
1660;"Vestermark";"no";0;0;0;54,898333;11,648888
1661;"Vestermark";"no";0;0;0;54,898333;11,648888
1662;"Vestermark";"no";0;0;0;54,898333;11,648888
1663;"Vestermark";"no";0;0;0;54,898333;11,648888
1664;"Vestermark";"no";0;0;0;54,898333;11,648888
1665;"Vestermark";"no";0;0;0;54,898333;11,648888
1666;"Vestermark";"no";0;0;0;54,898333;11,648888
1667;"Vestermark";"no";0;0;0;54,898333;11,648888
1668;"Vestermark";"no";0;0;0;54,898333;11,648888
1669;"Vestermark";"no";0;0;0;54,898333;11,648888
1670;"Vestermark";"no";0;0;0;54,898333;11,648888
1671;"Vestermark";"no";0;0;0;54,898333;11,648888
1672;"Vestermark";"no";0;0;0;54,898333;11,648888
1673;"Vestermark";"no";0;0;0;54,898333;11,648888
1674;"Vestermark";"no";0;0;0;54,898333;11,648888
1675;"Vestermark";"no";0;0;0;54,898333;11,648888
1676;"Vestermark";"no";0;0;0;54,898333;11,648888
1677;"Vestermark";"no";0;0;0;54,898333;11,648888
1678;"Vestermark";"no";0;0;0;54,898333;11,648888
1679;"Vestermark";"no";0;0;0;54,898333;11,648888
1680;"Vestermark";"no";0;0;0;54,898333;11,648888
1681;"Vestermark";"no";0;0;0;54,898333;11,648888
1682;"Vestermark";"no";0;0;0;54,898333;11,648888
1683;"Vestermark";"no";0;0;0;54,898333;11,648888
1684;"Vestermark";"no";0;0;0;54,898333;11,648888
1685;"Vestermark";"no";0;0;0;54,898333;11,648888
1686;"Vestermark";"no";0;0;0;54,898333;11,648888
1687;"Vestermark";"no";0;0;0;54,898333;11,648888
1688;"Vestermark";"no";0;0;0;54,898333;11,648888
1689;"Vestermark";"no";0;0;0;54,898333;11,648888
1690;"Vestermark";"no";0;0;0;54,898333;11,648888
1691;"Vestermark";"no";0;0;0;54,898333;11,648888
1692;"Vestermark";"no";0;0;0;54,898333;11,648888
1693;"Vestermark";"no";0;0;0;54,898333;11,648888
1694;"Vestermark";"no";0;0;0;54,898333;11,648888
1695;"Vestermark";"no";0;0;0;54,898333;11,648888
1696;"Vestermark";"no";0;0;0;54,898333;11,648888
1697;"Vestermark";"no";0;0;0;54,898333;11,648888
1698;"Vestermark";"no";0;0;0;54,898333;11,648888
1699;"Vestermark";"no";0;0;0;54,898333;11,648888
1700;"Vestermark";"no";0;0;0;54,898333;11,648888
1701;"Vestermark";"no";0;0;0;54,898333;11,648888
1702;"Vestermark";"no";0;0;0;54,898333;11,648888
1703;"Vestermark";"no";0;0;0;54,898333;11,648888
1704;"Vestermark";"no";0;0;0;54,898333;11,648888
1705;"Vestermark";"no";0;0;0;54,898333;11,648888
1706;"Vestermark";"no";0;0;0;54,898333;11,648888
1707;"Vestermark";"no";0;0;0;54,898333;11,648888
1708;"Vestermark";"no";0;0;0;54,898333;11,648888
1709;"Vestermark";"no";0;0;0;54,898333;11,648888
1710;"Vestermark";"no";0;0;0;54,898333;11,648888
1711;"Vestermark";"no";0;0;0;54,898333;11,648888
1712;"Vestermark";"no";0;0;0;54,898333;11,648888
1713;"Vestermark";"no";0;0;0;54,898333;11,648888
1714;"Vestermark";"no";0;0;0;54,898333;11,648888
1715;"Vestermark";"no";0;0;0;54,898333;11,648888
1716;"Vestermark";"no";0;0;0;54,898333;11,648888
1717;"Vestermark";"no";0;0;0;54,898333;11,648888
1718;"Vestermark";"no";0;0;0;54,898333;11,648888
1719;"Vestermark";"no";0;0;0;54,898333;11,648888
1720;"Vestermark";"no";0;0;0;54,898333;11,648888
1721;"Vestermark";"no";0;0;0;54,898333;11,648888
1722;"Vestermark";"no";0;0;0;54,898333;11,648888
1723;"Vestermark";"no";0;0;0;54,898333;11,648888
1724;"Vestermark";"no";0;0;0;54,898333;11,648888
1725;"Vestermark";"no";0;0;0;54,898333;11,648888
1726;"Vestermark";"no";0;0;0;54,898333;11,648888
1727;"Vestermark";"no";0;0;0;54,898333;11,648888
1728;"Vestermark";"no";0;0;0;54,898333;11,648888
1729;"Vestermark";"no";0;0;0;54,898333;11,648888
1730;"Vestermark";"no";0;0;0;54,898333;11,648888
1731;"Vestermark";"no";0;0;0;54,898333;11,648888
1732;"Vestermark";"no";0;0;0;54,898333;11,648888
1733;"Vestermark";"no";0;0;0;54,898333;11,648888
1734;"Vestermark";"no";0;0;0;54,898333;11,648888
1735;"Vestermark";"no";0;0;0;54,898333;11,648888
1736;"Vestermark";"no";0;0;0;54,898333;11,648888
1737;"Vestermark";"no";0;0;0;54,898333;11,648888
1738;"Vestermark";"no";0;0;0;54,898333;11,648888
1739;"Vestermark";"no";0;0;0;54,898333;11,648888
1740;"Vestermark";"no";0;0;0;54,898333;11,648888
1741;"Vestermark";"no";0;0;0;54,898333;11,648888
1742;"Vestermark";"no";0;0;0;54,898333;11,648888
1743;"Vestermark";"no";0;0;0;54,898333;11,648888
1744;"Vestermark";"no";0;0;0;54,898333;11,648888
1745;"Vestermark";"no";0;0;0;54,898333;11,648888
1746;"Vestermark";"no";0;0;0;54,898333;11,648888
1747;"Vestermark";"no";0;0;0;54,898333;11,648888
1748;"Vestermark";"no";0;0;0;54,898333;11,648888
1749;"Vestermark";"no";0;0;0;54,898333;11,648888
1750;"Vestermark";"no";0;0;0;54,898333;11,648888
1751;"Vestermark";"no";0;0;0;54,898333;11,648888
1752;"Vestermark";"no";0;0;0;54,898333;11,648888
1753;"Vestermark";"no";0;0;0;54,898333;11,648888
1754;"Vestermark";"no";0;0;0;54,898333;11,648888
1755;"Vestermark";"no";0;0;0;54,898333;11,648888
1756;"Vestermark";"no";0;0;0;54,898333;11,648888
1757;"Vestermark";"no";0;0;0;54,898333;11,648888
1758;"Vestermark";"no";0;0;0;54,898333;11,648888
1759;"Vestermark";"no";0;0;0;54,898333;11,648888
1760;"Vestermark";"no";0;0;0;54,898333;11,648888
1761;"Vestermark";"no";0;0;0;54,898333;11,648888
1762;"Vestermark";"no";0;0;0;54,898333;11,648888
1763;"Vestermark";"no";0;0;0;54,898333;11,648888
1764;"Vestermark";"no";0;0;0;54,898333;11,648888
1765;"Vestermark";"no";0;0;0;54,898333;11,648888
1766;"Vestermark";"no";0;0;0;54,898333;11,648888
1767;"Vestermark";"no";0;0;0;54,898333;11,648888
1768;"Vestermark";"no";0;0;0;54,898333;11,648888
1769;"Vestermark";"no";0;0;0;54,898333;11,648888
1770;"Vestermark";"no";0;0;0;54,898333;11,648888
1771;"Vestermark";"no";0;0;0;54,898333;11,648888
1772;"Vestermark";"no";0;0;0;54,898333;11,648888
1773;"Vestermark";"no";0;0;0;54,898333;11,648888
1774;"Vestermark";"no";0;0;0;54,898333;11,648888
1775;"Vestermark";"no";0;0;0;54,898333;11,648888
1776;"Vestermark";"no";0;0;0;54,898333;11,648888
1777;"Vestermark";"no";0;0;0;54,898333;11,648888
1778;"Vestermark";"no";0;0;0;54,898333;11,648888
1779;"Vestermark";"no";0;0;0;54,898333;11,648888
1780;"Vestermark";"no";0;0;0;54,898333;11,648888
1781;"Vestermark";"no";0;0;0;54,898333;11,648888
1782;"Vestermark";"no";0;0;0;54,898333;11,648888
1783;"Vestermark";"no";0;0;0;54,898333;11,648888
1784;"Vestermark";"no";0;0;0;54,898333;11,648888
1785;"Vestermark";"no";0;0;0;54,898333;11,648888
1786;"Vestermark";"no";0;0;0;54,898333;11,648888
1787;"Vestermark";"no";0;0;0;54,898333;11,648888
1788;"Vestermark";"no";0;0;0;54,898333;11,648888
1789;"Vestermark";"no";0;0;0;54,898333;11,648888
1790;"Vestermark";"no";0;0;0;54,898333;11,648888
1791;"Vestermark";"no";0;0;0;54,898333;11,648888
1792;"Vestermark";"no";0;0;0;54,898333;11,648888
1793;"Vestermark";"no";0;0;0;54,898333;11,648888
1794;"Vestermark";"no";0;0;0;54,898333;11,648888
1795;"Vestermark";"no";0;0;0;54,898333;11,648888
1796;"Vestermark";"no";0;0;0;54,898333;11,648888
1797;"Vestermark";"no";0;0;0;54,898333;11,648888
1798;"Vestermark";"no";0;0;0;54,898333;11,648888
1799;"Vestermark";"no";0;0;0;54,898333;11,648888
1800;"Vestermark";"no";0;0;0;54,898333;11,648888
1801;"Vestermark";"no";0;0;0;54,898333;11,648888
1802;"Vestermark";"no";0;0;0;54,898333;11,648888
1803;"Vestermark";"no";0;0;0;54,898333;11,648888
1804;"Vestermark";"no";0;0;0;54,898333;11,648888
1805;"Vestermark";"no";0;0;0;54,898333;11,648888
1806;"Vestermark";"no";0;0;0;54,898333;11,648888
1807;"Vestermark";"no";0;0;0;54,898333;11,648888
1808;"Vestermark";"no";0;0;0;54,898333;11,648888
1809;"Vestermark";"no";0;0;0;54,898333;11,648888
1810;"Vestermark";"no";0;0;0;54,898333;11,648888
1811;"Vestermark";"no";0;0;0;54,898333;11,648888
1812;"Vestermark";"no";0;0;0;54,898333;11,648888
1813;"Vestermark";"no";0;0;0;54,898333;11,648888
1814;"Vestermark";"no";0;0;0;54,898333;11,648888
1815;"Vestermark";"no";0;0;0;54,898333;11,648888
1816;"Vestermark";"no";0;0;0;54,898333;11,648888
1817;"Vestermark";"no";0;0;0;54,898333;11,648888
1818;"Vestermark";"no";0;0;0;54,898333;11,648888
1819;"Vestermark";"no";0;0;0;54,898333;11,648888
1820;"Vestermark";"no";0;0;0;54,898333;11,648888
1821;"Vestermark";"no";0;0;0;54,898333;11,648888
1822;"Vestermark";"no";0;0;0;54,898333;11,648888
1823;"Vestermark";"no";0;0;0;54,898333;11,648888
1824;"Vestermark";"no";0;0;0;54,898333;11,648888
1825;"Vestermark";"no";1;0;1;54,898333;11,648888
1826;"Vestermark";"no";0;0;0;54,898333;11,648888
1827;"Vestermark";"no";0;0;0;54,898333;11,648888
1828;"Vestermark";"no";0;0;0;54,898333;11,648888
1829;"Vestermark";"no";0;0;0;54,898333;11,648888
1830;"Vestermark";"no";0;0;0;54,898333;11,648888
1831;"Vestermark";"no";0;0;0;54,898333;11,648888
1832;"Vestermark";"no";0;0;0;54,898333;11,648888
1833;"Vestermark";"no";0;0;0;54,898333;11,648888
1834;"Vestermark";"no";0;0;0;54,898333;11,648888
1835;"Vestermark";"no";0;0;0;54,898333;11,648888
1836;"Vestermark";"no";0;0;0;54,898333;11,648888
1837;"Vestermark";"no";0;0;0;54,898333;11,648888
1838;"Vestermark";"no";0;0;0;54,898333;11,648888
1839;"Vestermark";"no";0;0;0;54,898333;11,648888
1840;"Vestermark";"no";0;0;0;54,898333;11,648888
1841;"Vestermark";"no";0;0;0;54,898333;11,648888
1842;"Vestermark";"no";0;0;0;54,898333;11,648888
1843;"Vestermark";"no";0;0;0;54,898333;11,648888
1844;"Vestermark";"no";0;0;0;54,898333;11,648888
1845;"Vestermark";"no";0;0;0;54,898333;11,648888
1846;"Vestermark";"no";0;0;0;54,898333;11,648888
1847;"Vestermark";"no";0;0;0;54,898333;11,648888
1848;"Vestermark";"no";0;0;0;54,898333;11,648888
1849;"Vestermark";"no";0;0;0;54,898333;11,648888
1850;"Vestermark";"no";0;0;0;54,898333;11,648888
1851;"Vestermark";"no";0;0;0;54,898333;11,648888
1852;"Vestermark";"no";0;0;0;54,898333;11,648888
1853;"Vestermark";"no";0;0;0;54,898333;11,648888
1854;"Vestermark";"no";0;0;0;54,898333;11,648888
1855;"Vestermark";"no";0;0;0;54,898333;11,648888
1856;"Vestermark";"no";0;0;0;54,898333;11,648888
1857;"Vestermark";"no";0;0;0;54,898333;11,648888
1634;"Nordby";"no";0;0;0;55,445833;8,397777
1635;"Nordby";"no";0;0;0;55,445833;8,397777
1636;"Nordby";"no";0;0;0;55,445833;8,397777
1637;"Nordby";"no";0;0;0;55,445833;8,397777
1638;"Nordby";"no";0;0;0;55,445833;8,397777
1639;"Nordby";"no";0;0;0;55,445833;8,397777
1640;"Nordby";"no";0;0;0;55,445833;8,397777
1641;"Nordby";"no";0;0;0;55,445833;8,397777
1642;"Nordby";"no";0;0;0;55,445833;8,397777
1643;"Nordby";"no";0;0;0;55,445833;8,397777
1644;"Nordby";"no";0;0;0;55,445833;8,397777
1645;"Nordby";"no";0;0;0;55,445833;8,397777
1646;"Nordby";"no";0;0;0;55,445833;8,397777
1647;"Nordby";"no";0;0;0;55,445833;8,397777
1648;"Nordby";"no";0;0;0;55,445833;8,397777
1649;"Nordby";"no";0;0;0;55,445833;8,397777
1650;"Nordby";"no";0;0;0;55,445833;8,397777
1651;"Nordby";"no";0;0;0;55,445833;8,397777
1652;"Nordby";"no";0;0;0;55,445833;8,397777
1653;"Nordby";"no";0;0;0;55,445833;8,397777
1654;"Nordby";"no";0;0;0;55,445833;8,397777
1655;"Nordby";"no";0;0;0;55,445833;8,397777
1656;"Nordby";"no";0;0;0;55,445833;8,397777
1657;"Nordby";"no";0;0;0;55,445833;8,397777
1658;"Nordby";"no";0;0;0;55,445833;8,397777
1659;"Nordby";"no";0;0;0;55,445833;8,397777
1660;"Nordby";"no";0;0;0;55,445833;8,397777
1661;"Nordby";"no";0;0;0;55,445833;8,397777
1662;"Nordby";"no";0;0;0;55,445833;8,397777
1663;"Nordby";"no";0;0;0;55,445833;8,397777
1664;"Nordby";"no";0;0;0;55,445833;8,397777
1665;"Nordby";"no";0;0;0;55,445833;8,397777
1666;"Nordby";"no";0;0;0;55,445833;8,397777
1667;"Nordby";"no";0;0;0;55,445833;8,397777
1668;"Nordby";"no";0;0;0;55,445833;8,397777
1669;"Nordby";"no";0;0;0;55,445833;8,397777
1670;"Nordby";"no";0;0;0;55,445833;8,397777
1671;"Nordby";"no";0;0;0;55,445833;8,397777
1672;"Nordby";"no";0;0;0;55,445833;8,397777
1673;"Nordby";"no";0;0;0;55,445833;8,397777
1674;"Nordby";"no";0;0;0;55,445833;8,397777
1675;"Nordby";"no";0;0;0;55,445833;8,397777
1676;"Nordby";"no";0;0;0;55,445833;8,397777
1677;"Nordby";"no";0;0;0;55,445833;8,397777
1678;"Nordby";"no";0;0;0;55,445833;8,397777
1679;"Nordby";"no";0;0;0;55,445833;8,397777
1680;"Nordby";"no";0;0;0;55,445833;8,397777
1681;"Nordby";"no";0;0;0;55,445833;8,397777
1682;"Nordby";"no";0;0;0;55,445833;8,397777
1683;"Nordby";"no";0;0;0;55,445833;8,397777
1684;"Nordby";"no";0;0;0;55,445833;8,397777
1685;"Nordby";"no";0;0;0;55,445833;8,397777
1686;"Nordby";"no";0;0;0;55,445833;8,397777
1687;"Nordby";"no";0;0;0;55,445833;8,397777
1688;"Nordby";"no";0;0;0;55,445833;8,397777
1689;"Nordby";"no";0;0;0;55,445833;8,397777
1690;"Nordby";"no";0;0;0;55,445833;8,397777
1691;"Nordby";"no";0;0;0;55,445833;8,397777
1692;"Nordby";"no";0;0;0;55,445833;8,397777
1693;"Nordby";"no";0;0;0;55,445833;8,397777
1694;"Nordby";"no";0;0;0;55,445833;8,397777
1695;"Nordby";"no";0;0;0;55,445833;8,397777
1696;"Nordby";"no";0;0;0;55,445833;8,397777
1697;"Nordby";"no";0;0;0;55,445833;8,397777
1698;"Nordby";"no";0;0;0;55,445833;8,397777
1699;"Nordby";"no";0;0;0;55,445833;8,397777
1700;"Nordby";"no";0;0;0;55,445833;8,397777
1701;"Nordby";"no";0;0;0;55,445833;8,397777
1702;"Nordby";"no";0;0;0;55,445833;8,397777
1703;"Nordby";"no";0;0;0;55,445833;8,397777
1704;"Nordby";"no";0;0;0;55,445833;8,397777
1705;"Nordby";"no";0;0;0;55,445833;8,397777
1706;"Nordby";"no";0;0;0;55,445833;8,397777
1707;"Nordby";"no";0;0;0;55,445833;8,397777
1708;"Nordby";"no";0;0;0;55,445833;8,397777
1709;"Nordby";"no";0;0;0;55,445833;8,397777
1710;"Nordby";"no";0;0;0;55,445833;8,397777
1711;"Nordby";"no";0;0;0;55,445833;8,397777
1712;"Nordby";"no";0;0;0;55,445833;8,397777
1713;"Nordby";"no";0;0;0;55,445833;8,397777
1714;"Nordby";"no";0;0;0;55,445833;8,397777
1715;"Nordby";"no";0;0;0;55,445833;8,397777
1716;"Nordby";"no";0;0;0;55,445833;8,397777
1717;"Nordby";"no";0;0;0;55,445833;8,397777
1718;"Nordby";"no";0;0;0;55,445833;8,397777
1719;"Nordby";"no";0;0;0;55,445833;8,397777
1720;"Nordby";"no";0;0;0;55,445833;8,397777
1721;"Nordby";"no";0;0;0;55,445833;8,397777
1722;"Nordby";"no";0;0;0;55,445833;8,397777
1723;"Nordby";"no";0;0;0;55,445833;8,397777
1724;"Nordby";"no";0;0;0;55,445833;8,397777
1725;"Nordby";"no";0;0;0;55,445833;8,397777
1726;"Nordby";"no";0;0;0;55,445833;8,397777
1727;"Nordby";"no";0;0;0;55,445833;8,397777
1728;"Nordby";"no";0;0;0;55,445833;8,397777
1729;"Nordby";"no";0;0;0;55,445833;8,397777
1730;"Nordby";"no";0;0;0;55,445833;8,397777
1731;"Nordby";"no";0;0;0;55,445833;8,397777
1732;"Nordby";"no";0;0;0;55,445833;8,397777
1733;"Nordby";"no";0;0;0;55,445833;8,397777
1734;"Nordby";"no";0;0;0;55,445833;8,397777
1735;"Nordby";"no";0;0;0;55,445833;8,397777
1736;"Nordby";"no";0;0;0;55,445833;8,397777
1737;"Nordby";"no";0;0;0;55,445833;8,397777
1738;"Nordby";"no";0;0;0;55,445833;8,397777
1739;"Nordby";"no";0;0;0;55,445833;8,397777
1740;"Nordby";"no";0;0;0;55,445833;8,397777
1741;"Nordby";"no";0;0;0;55,445833;8,397777
1742;"Nordby";"no";0;0;0;55,445833;8,397777
1743;"Nordby";"no";0;0;0;55,445833;8,397777
1744;"Nordby";"no";0;0;0;55,445833;8,397777
1745;"Nordby";"no";0;0;0;55,445833;8,397777
1746;"Nordby";"no";0;0;0;55,445833;8,397777
1747;"Nordby";"no";0;0;0;55,445833;8,397777
1748;"Nordby";"no";0;0;0;55,445833;8,397777
1749;"Nordby";"no";0;0;0;55,445833;8,397777
1750;"Nordby";"no";0;0;0;55,445833;8,397777
1751;"Nordby";"no";0;0;0;55,445833;8,397777
1752;"Nordby";"no";0;0;0;55,445833;8,397777
1753;"Nordby";"no";0;0;0;55,445833;8,397777
1754;"Nordby";"no";0;0;0;55,445833;8,397777
1755;"Nordby";"no";0;0;0;55,445833;8,397777
1756;"Nordby";"no";0;0;0;55,445833;8,397777
1757;"Nordby";"no";0;0;0;55,445833;8,397777
1758;"Nordby";"no";0;0;0;55,445833;8,397777
1759;"Nordby";"no";0;0;0;55,445833;8,397777
1760;"Nordby";"no";0;0;0;55,445833;8,397777
1761;"Nordby";"no";0;0;0;55,445833;8,397777
1762;"Nordby";"no";0;0;0;55,445833;8,397777
1763;"Nordby";"no";0;0;0;55,445833;8,397777
1764;"Nordby";"no";0;0;0;55,445833;8,397777
1765;"Nordby";"no";0;0;0;55,445833;8,397777
1766;"Nordby";"no";0;0;0;55,445833;8,397777
1767;"Nordby";"no";0;0;0;55,445833;8,397777
1768;"Nordby";"no";0;0;0;55,445833;8,397777
1769;"Nordby";"no";0;0;0;55,445833;8,397777
1770;"Nordby";"no";0;0;0;55,445833;8,397777
1771;"Nordby";"no";0;0;0;55,445833;8,397777
1772;"Nordby";"no";0;0;0;55,445833;8,397777
1773;"Nordby";"no";0;0;0;55,445833;8,397777
1774;"Nordby";"no";0;0;0;55,445833;8,397777
1775;"Nordby";"no";0;0;0;55,445833;8,397777
1776;"Nordby";"no";0;0;0;55,445833;8,397777
1777;"Nordby";"no";0;0;0;55,445833;8,397777
1778;"Nordby";"no";0;0;0;55,445833;8,397777
1779;"Nordby";"no";0;0;0;55,445833;8,397777
1780;"Nordby";"no";0;0;0;55,445833;8,397777
1781;"Nordby";"no";0;0;0;55,445833;8,397777
1782;"Nordby";"no";0;0;0;55,445833;8,397777
1783;"Nordby";"no";0;0;0;55,445833;8,397777
1784;"Nordby";"no";0;0;0;55,445833;8,397777
1785;"Nordby";"no";0;0;0;55,445833;8,397777
1786;"Nordby";"no";0;0;0;55,445833;8,397777
1787;"Nordby";"no";0;0;0;55,445833;8,397777
1788;"Nordby";"no";0;0;0;55,445833;8,397777
1789;"Nordby";"no";0;0;0;55,445833;8,397777
1790;"Nordby";"no";0;0;0;55,445833;8,397777
1791;"Nordby";"no";0;0;0;55,445833;8,397777
1792;"Nordby";"no";0;0;0;55,445833;8,397777
1793;"Nordby";"no";0;0;0;55,445833;8,397777
1794;"Nordby";"no";0;0;0;55,445833;8,397777
1795;"Nordby";"no";0;0;0;55,445833;8,397777
1796;"Nordby";"no";0;0;0;55,445833;8,397777
1797;"Nordby";"no";0;0;0;55,445833;8,397777
1798;"Nordby";"no";0;0;0;55,445833;8,397777
1799;"Nordby";"no";0;0;0;55,445833;8,397777
1800;"Nordby";"no";0;0;0;55,445833;8,397777
1801;"Nordby";"no";0;0;0;55,445833;8,397777
1802;"Nordby";"no";0;0;0;55,445833;8,397777
1803;"Nordby";"no";0;0;0;55,445833;8,397777
1804;"Nordby";"no";0;0;0;55,445833;8,397777
1805;"Nordby";"no";0;0;0;55,445833;8,397777
1806;"Nordby";"no";0;0;0;55,445833;8,397777
1807;"Nordby";"no";0;0;0;55,445833;8,397777
1808;"Nordby";"no";0;0;0;55,445833;8,397777
1809;"Nordby";"no";0;0;0;55,445833;8,397777
1810;"Nordby";"no";0;0;0;55,445833;8,397777
1811;"Nordby";"no";0;0;0;55,445833;8,397777
1812;"Nordby";"no";0;0;0;55,445833;8,397777
1813;"Nordby";"no";0;0;0;55,445833;8,397777
1814;"Nordby";"no";0;0;0;55,445833;8,397777
1815;"Nordby";"no";0;0;0;55,445833;8,397777
1816;"Nordby";"no";0;0;0;55,445833;8,397777
1817;"Nordby";"no";0;0;0;55,445833;8,397777
1818;"Nordby";"no";0;0;0;55,445833;8,397777
1819;"Nordby";"no";0;0;0;55,445833;8,397777
1820;"Nordby";"no";0;0;0;55,445833;8,397777
1821;"Nordby";"no";0;0;0;55,445833;8,397777
1822;"Nordby";"no";0;0;0;55,445833;8,397777
1823;"Nordby";"no";0;0;0;55,445833;8,397777
1824;"Nordby";"no";0;0;0;55,445833;8,397777
1825;"Nordby";"no";0;0;0;55,445833;8,397777
1826;"Nordby";"no";0;0;0;55,445833;8,397777
1827;"Nordby";"no";0;0;0;55,445833;8,397777
1828;"Nordby";"no";0;0;0;55,445833;8,397777
1829;"Nordby";"no";0;0;0;55,445833;8,397777
1830;"Nordby";"no";1;0;1;55,445833;8,397777
1831;"Nordby";"no";0;0;0;55,445833;8,397777
1832;"Nordby";"no";0;0;0;55,445833;8,397777
1833;"Nordby";"no";0;0;0;55,445833;8,397777
1834;"Nordby";"no";0;0;0;55,445833;8,397777
1835;"Nordby";"no";0;0;0;55,445833;8,397777
1836;"Nordby";"no";0;0;0;55,445833;8,397777
1837;"Nordby";"no";0;0;0;55,445833;8,397777
1838;"Nordby";"no";0;0;0;55,445833;8,397777
1839;"Nordby";"no";0;0;0;55,445833;8,397777
1840;"Nordby";"no";0;0;0;55,445833;8,397777
1841;"Nordby";"no";0;0;0;55,445833;8,397777
1842;"Nordby";"no";0;0;0;55,445833;8,397777
1843;"Nordby";"no";0;0;0;55,445833;8,397777
1844;"Nordby";"no";0;0;0;55,445833;8,397777
1845;"Nordby";"no";0;0;0;55,445833;8,397777
1846;"Nordby";"no";0;0;0;55,445833;8,397777
1847;"Nordby";"no";0;0;0;55,445833;8,397777
1848;"Nordby";"no";0;0;0;55,445833;8,397777
1849;"Nordby";"no";0;0;0;55,445833;8,397777
1850;"Nordby";"no";0;0;0;55,445833;8,397777
1851;"Nordby";"no";0;0;0;55,445833;8,397777
1852;"Nordby";"no";0;0;0;55,445833;8,397777
1853;"Nordby";"no";0;0;0;55,445833;8,397777
1854;"Nordby";"no";0;0;0;55,445833;8,397777
1855;"Nordby";"no";0;0;0;55,445833;8,397777
1856;"Nordby";"no";0;0;0;55,445833;8,397777
1857;"Nordby";"no";0;0;0;55,445833;8,397777
1634;"Ålsgårde";"no";0;0;0;56,075555;12,539722
1635;"Ålsgårde";"no";0;0;0;56,075555;12,539722
1636;"Ålsgårde";"no";0;0;0;56,075555;12,539722
1637;"Ålsgårde";"no";0;0;0;56,075555;12,539722
1638;"Ålsgårde";"no";0;0;0;56,075555;12,539722
1639;"Ålsgårde";"no";0;0;0;56,075555;12,539722
1640;"Ålsgårde";"no";0;0;0;56,075555;12,539722
1641;"Ålsgårde";"no";0;0;0;56,075555;12,539722
1642;"Ålsgårde";"no";0;0;0;56,075555;12,539722
1643;"Ålsgårde";"no";0;0;0;56,075555;12,539722
1644;"Ålsgårde";"no";0;0;0;56,075555;12,539722
1645;"Ålsgårde";"no";0;0;0;56,075555;12,539722
1646;"Ålsgårde";"no";0;0;0;56,075555;12,539722
1647;"Ålsgårde";"no";0;0;0;56,075555;12,539722
1648;"Ålsgårde";"no";0;0;0;56,075555;12,539722
1649;"Ålsgårde";"no";0;0;0;56,075555;12,539722
1650;"Ålsgårde";"no";0;0;0;56,075555;12,539722
1651;"Ålsgårde";"no";0;0;0;56,075555;12,539722
1652;"Ålsgårde";"no";0;0;0;56,075555;12,539722
1653;"Ålsgårde";"no";0;0;0;56,075555;12,539722
1654;"Ålsgårde";"no";0;0;0;56,075555;12,539722
1655;"Ålsgårde";"no";0;0;0;56,075555;12,539722
1656;"Ålsgårde";"no";0;0;0;56,075555;12,539722
1657;"Ålsgårde";"no";0;0;0;56,075555;12,539722
1658;"Ålsgårde";"no";0;0;0;56,075555;12,539722
1659;"Ålsgårde";"no";0;0;0;56,075555;12,539722
1660;"Ålsgårde";"no";0;0;0;56,075555;12,539722
1661;"Ålsgårde";"no";0;0;0;56,075555;12,539722
1662;"Ålsgårde";"no";0;0;0;56,075555;12,539722
1663;"Ålsgårde";"no";0;0;0;56,075555;12,539722
1664;"Ålsgårde";"no";0;0;0;56,075555;12,539722
1665;"Ålsgårde";"no";0;0;0;56,075555;12,539722
1666;"Ålsgårde";"no";0;0;0;56,075555;12,539722
1667;"Ålsgårde";"no";0;0;0;56,075555;12,539722
1668;"Ålsgårde";"no";0;0;0;56,075555;12,539722
1669;"Ålsgårde";"no";0;0;0;56,075555;12,539722
1670;"Ålsgårde";"no";0;0;0;56,075555;12,539722
1671;"Ålsgårde";"no";0;0;0;56,075555;12,539722
1672;"Ålsgårde";"no";0;0;0;56,075555;12,539722
1673;"Ålsgårde";"no";0;0;0;56,075555;12,539722
1674;"Ålsgårde";"no";0;0;0;56,075555;12,539722
1675;"Ålsgårde";"no";0;0;0;56,075555;12,539722
1676;"Ålsgårde";"no";0;0;0;56,075555;12,539722
1677;"Ålsgårde";"no";0;0;0;56,075555;12,539722
1678;"Ålsgårde";"no";0;0;0;56,075555;12,539722
1679;"Ålsgårde";"no";0;0;0;56,075555;12,539722
1680;"Ålsgårde";"no";0;0;0;56,075555;12,539722
1681;"Ålsgårde";"no";0;0;0;56,075555;12,539722
1682;"Ålsgårde";"no";0;0;0;56,075555;12,539722
1683;"Ålsgårde";"no";0;0;0;56,075555;12,539722
1684;"Ålsgårde";"no";0;0;0;56,075555;12,539722
1685;"Ålsgårde";"no";0;0;0;56,075555;12,539722
1686;"Ålsgårde";"no";0;0;0;56,075555;12,539722
1687;"Ålsgårde";"no";0;0;0;56,075555;12,539722
1688;"Ålsgårde";"no";0;0;0;56,075555;12,539722
1689;"Ålsgårde";"no";0;0;0;56,075555;12,539722
1690;"Ålsgårde";"no";0;0;0;56,075555;12,539722
1691;"Ålsgårde";"no";0;0;0;56,075555;12,539722
1692;"Ålsgårde";"no";0;0;0;56,075555;12,539722
1693;"Ålsgårde";"no";0;0;0;56,075555;12,539722
1694;"Ålsgårde";"no";0;0;0;56,075555;12,539722
1695;"Ålsgårde";"no";0;0;0;56,075555;12,539722
1696;"Ålsgårde";"no";0;0;0;56,075555;12,539722
1697;"Ålsgårde";"no";0;0;0;56,075555;12,539722
1698;"Ålsgårde";"no";0;0;0;56,075555;12,539722
1699;"Ålsgårde";"no";0;0;0;56,075555;12,539722
1700;"Ålsgårde";"no";0;0;0;56,075555;12,539722
1701;"Ålsgårde";"no";0;0;0;56,075555;12,539722
1702;"Ålsgårde";"no";0;0;0;56,075555;12,539722
1703;"Ålsgårde";"no";0;0;0;56,075555;12,539722
1704;"Ålsgårde";"no";0;0;0;56,075555;12,539722
1705;"Ålsgårde";"no";0;0;0;56,075555;12,539722
1706;"Ålsgårde";"no";0;0;0;56,075555;12,539722
1707;"Ålsgårde";"no";0;0;0;56,075555;12,539722
1708;"Ålsgårde";"no";0;0;0;56,075555;12,539722
1709;"Ålsgårde";"no";0;0;0;56,075555;12,539722
1710;"Ålsgårde";"no";0;0;0;56,075555;12,539722
1711;"Ålsgårde";"no";0;0;0;56,075555;12,539722
1712;"Ålsgårde";"no";0;0;0;56,075555;12,539722
1713;"Ålsgårde";"no";0;0;0;56,075555;12,539722
1714;"Ålsgårde";"no";0;0;0;56,075555;12,539722
1715;"Ålsgårde";"no";0;0;0;56,075555;12,539722
1716;"Ålsgårde";"no";0;0;0;56,075555;12,539722
1717;"Ålsgårde";"no";0;0;0;56,075555;12,539722
1718;"Ålsgårde";"no";0;0;0;56,075555;12,539722
1719;"Ålsgårde";"no";0;0;0;56,075555;12,539722
1720;"Ålsgårde";"no";0;0;0;56,075555;12,539722
1721;"Ålsgårde";"no";0;0;0;56,075555;12,539722
1722;"Ålsgårde";"no";0;0;0;56,075555;12,539722
1723;"Ålsgårde";"no";0;0;0;56,075555;12,539722
1724;"Ålsgårde";"no";0;0;0;56,075555;12,539722
1725;"Ålsgårde";"no";0;0;0;56,075555;12,539722
1726;"Ålsgårde";"no";0;0;0;56,075555;12,539722
1727;"Ålsgårde";"no";0;0;0;56,075555;12,539722
1728;"Ålsgårde";"no";0;0;0;56,075555;12,539722
1729;"Ålsgårde";"no";0;0;0;56,075555;12,539722
1730;"Ålsgårde";"no";0;0;0;56,075555;12,539722
1731;"Ålsgårde";"no";0;0;0;56,075555;12,539722
1732;"Ålsgårde";"no";0;0;0;56,075555;12,539722
1733;"Ålsgårde";"no";0;0;0;56,075555;12,539722
1734;"Ålsgårde";"no";0;0;0;56,075555;12,539722
1735;"Ålsgårde";"no";0;0;0;56,075555;12,539722
1736;"Ålsgårde";"no";0;0;0;56,075555;12,539722
1737;"Ålsgårde";"no";0;0;0;56,075555;12,539722
1738;"Ålsgårde";"no";0;0;0;56,075555;12,539722
1739;"Ålsgårde";"no";0;0;0;56,075555;12,539722
1740;"Ålsgårde";"no";0;0;0;56,075555;12,539722
1741;"Ålsgårde";"no";0;0;0;56,075555;12,539722
1742;"Ålsgårde";"no";0;0;0;56,075555;12,539722
1743;"Ålsgårde";"no";0;0;0;56,075555;12,539722
1744;"Ålsgårde";"no";0;0;0;56,075555;12,539722
1745;"Ålsgårde";"no";0;0;0;56,075555;12,539722
1746;"Ålsgårde";"no";0;0;0;56,075555;12,539722
1747;"Ålsgårde";"no";0;0;0;56,075555;12,539722
1748;"Ålsgårde";"no";0;0;0;56,075555;12,539722
1749;"Ålsgårde";"no";0;0;0;56,075555;12,539722
1750;"Ålsgårde";"no";0;0;0;56,075555;12,539722
1751;"Ålsgårde";"no";0;0;0;56,075555;12,539722
1752;"Ålsgårde";"no";0;0;0;56,075555;12,539722
1753;"Ålsgårde";"no";0;0;0;56,075555;12,539722
1754;"Ålsgårde";"no";0;0;0;56,075555;12,539722
1755;"Ålsgårde";"no";0;0;0;56,075555;12,539722
1756;"Ålsgårde";"no";0;0;0;56,075555;12,539722
1757;"Ålsgårde";"no";0;0;0;56,075555;12,539722
1758;"Ålsgårde";"no";0;0;0;56,075555;12,539722
1759;"Ålsgårde";"no";0;0;0;56,075555;12,539722
1760;"Ålsgårde";"no";0;0;0;56,075555;12,539722
1761;"Ålsgårde";"no";0;0;0;56,075555;12,539722
1762;"Ålsgårde";"no";0;0;0;56,075555;12,539722
1763;"Ålsgårde";"no";0;0;0;56,075555;12,539722
1764;"Ålsgårde";"no";0;0;0;56,075555;12,539722
1765;"Ålsgårde";"no";0;0;0;56,075555;12,539722
1766;"Ålsgårde";"no";0;0;0;56,075555;12,539722
1767;"Ålsgårde";"no";0;0;0;56,075555;12,539722
1768;"Ålsgårde";"no";0;0;0;56,075555;12,539722
1769;"Ålsgårde";"no";0;0;0;56,075555;12,539722
1770;"Ålsgårde";"no";0;0;0;56,075555;12,539722
1771;"Ålsgårde";"no";0;0;0;56,075555;12,539722
1772;"Ålsgårde";"no";0;0;0;56,075555;12,539722
1773;"Ålsgårde";"no";0;0;0;56,075555;12,539722
1774;"Ålsgårde";"no";0;0;0;56,075555;12,539722
1775;"Ålsgårde";"no";0;0;0;56,075555;12,539722
1776;"Ålsgårde";"no";0;0;0;56,075555;12,539722
1777;"Ålsgårde";"no";0;0;0;56,075555;12,539722
1778;"Ålsgårde";"no";0;0;0;56,075555;12,539722
1779;"Ålsgårde";"no";0;0;0;56,075555;12,539722
1780;"Ålsgårde";"no";0;0;0;56,075555;12,539722
1781;"Ålsgårde";"no";0;0;0;56,075555;12,539722
1782;"Ålsgårde";"no";0;0;0;56,075555;12,539722
1783;"Ålsgårde";"no";0;0;0;56,075555;12,539722
1784;"Ålsgårde";"no";0;0;0;56,075555;12,539722
1785;"Ålsgårde";"no";0;0;0;56,075555;12,539722
1786;"Ålsgårde";"no";0;0;0;56,075555;12,539722
1787;"Ålsgårde";"no";0;0;0;56,075555;12,539722
1788;"Ålsgårde";"no";0;0;0;56,075555;12,539722
1789;"Ålsgårde";"no";0;0;0;56,075555;12,539722
1790;"Ålsgårde";"no";0;0;0;56,075555;12,539722
1791;"Ålsgårde";"no";0;0;0;56,075555;12,539722
1792;"Ålsgårde";"no";0;0;0;56,075555;12,539722
1793;"Ålsgårde";"no";0;0;0;56,075555;12,539722
1794;"Ålsgårde";"no";0;0;0;56,075555;12,539722
1795;"Ålsgårde";"no";0;0;0;56,075555;12,539722
1796;"Ålsgårde";"no";0;0;0;56,075555;12,539722
1797;"Ålsgårde";"no";0;0;0;56,075555;12,539722
1798;"Ålsgårde";"no";0;0;0;56,075555;12,539722
1799;"Ålsgårde";"no";0;0;0;56,075555;12,539722
1800;"Ålsgårde";"no";0;0;0;56,075555;12,539722
1801;"Ålsgårde";"no";0;0;0;56,075555;12,539722
1802;"Ålsgårde";"no";0;0;0;56,075555;12,539722
1803;"Ålsgårde";"no";0;0;0;56,075555;12,539722
1804;"Ålsgårde";"no";0;0;0;56,075555;12,539722
1805;"Ålsgårde";"no";0;0;0;56,075555;12,539722
1806;"Ålsgårde";"no";0;0;0;56,075555;12,539722
1807;"Ålsgårde";"no";0;0;0;56,075555;12,539722
1808;"Ålsgårde";"no";0;0;0;56,075555;12,539722
1809;"Ålsgårde";"no";0;0;0;56,075555;12,539722
1810;"Ålsgårde";"no";0;0;0;56,075555;12,539722
1811;"Ålsgårde";"no";0;0;0;56,075555;12,539722
1812;"Ålsgårde";"no";0;0;0;56,075555;12,539722
1813;"Ålsgårde";"no";0;0;0;56,075555;12,539722
1814;"Ålsgårde";"no";0;0;0;56,075555;12,539722
1815;"Ålsgårde";"no";0;0;0;56,075555;12,539722
1816;"Ålsgårde";"no";0;0;0;56,075555;12,539722
1817;"Ålsgårde";"no";0;0;0;56,075555;12,539722
1818;"Ålsgårde";"no";0;0;0;56,075555;12,539722
1819;"Ålsgårde";"no";0;0;0;56,075555;12,539722
1820;"Ålsgårde";"no";0;0;0;56,075555;12,539722
1821;"Ålsgårde";"no";0;0;0;56,075555;12,539722
1822;"Ålsgårde";"no";0;0;0;56,075555;12,539722
1823;"Ålsgårde";"no";0;0;0;56,075555;12,539722
1824;"Ålsgårde";"no";0;0;0;56,075555;12,539722
1825;"Ålsgårde";"no";0;0;0;56,075555;12,539722
1826;"Ålsgårde";"no";0;0;0;56,075555;12,539722
1827;"Ålsgårde";"no";0;0;0;56,075555;12,539722
1828;"Ålsgårde";"no";0;0;0;56,075555;12,539722
1829;"Ålsgårde";"no";0;0;0;56,075555;12,539722
1830;"Ålsgårde";"no";0;0;0;56,075555;12,539722
1831;"Ålsgårde";"no";0;0;0;56,075555;12,539722
1832;"Ålsgårde";"no";0;0;0;56,075555;12,539722
1833;"Ålsgårde";"no";0;0;0;56,075555;12,539722
1834;"Ålsgårde";"no";0;0;0;56,075555;12,539722
1835;"Ålsgårde";"no";2;0;2;56,075555;12,539722
1836;"Ålsgårde";"no";0;0;0;56,075555;12,539722
1837;"Ålsgårde";"no";0;0;0;56,075555;12,539722
1838;"Ålsgårde";"no";0;0;0;56,075555;12,539722
1839;"Ålsgårde";"no";0;0;0;56,075555;12,539722
1840;"Ålsgårde";"no";0;0;0;56,075555;12,539722
1841;"Ålsgårde";"no";0;0;0;56,075555;12,539722
1842;"Ålsgårde";"no";0;0;0;56,075555;12,539722
1843;"Ålsgårde";"no";0;1;1;56,075555;12,539722
1844;"Ålsgårde";"no";0;0;0;56,075555;12,539722
1845;"Ålsgårde";"no";0;1;1;56,075555;12,539722
1846;"Ålsgårde";"no";0;0;0;56,075555;12,539722
1847;"Ålsgårde";"no";0;0;0;56,075555;12,539722
1848;"Ålsgårde";"no";0;0;0;56,075555;12,539722
1849;"Ålsgårde";"no";0;0;0;56,075555;12,539722
1850;"Ålsgårde";"no";0;0;0;56,075555;12,539722
1851;"Ålsgårde";"no";0;1;1;56,075555;12,539722
1852;"Ålsgårde";"no";0;0;0;56,075555;12,539722
1853;"Ålsgårde";"no";0;0;0;56,075555;12,539722
1854;"Ålsgårde";"no";0;0;0;56,075555;12,539722
1855;"Ålsgårde";"no";0;0;0;56,075555;12,539722
1856;"Ålsgårde";"no";0;0;0;56,075555;12,539722
1857;"Ålsgårde";"no";0;0;0;56,075555;12,539722
1634;"Kyholm";"no";0;0;0;55,9325;10,671944
1635;"Kyholm";"no";0;0;0;55,9325;10,671944
1636;"Kyholm";"no";0;0;0;55,9325;10,671944
1637;"Kyholm";"no";0;0;0;55,9325;10,671944
1638;"Kyholm";"no";0;0;0;55,9325;10,671944
1639;"Kyholm";"no";0;0;0;55,9325;10,671944
1640;"Kyholm";"no";0;0;0;55,9325;10,671944
1641;"Kyholm";"no";0;0;0;55,9325;10,671944
1642;"Kyholm";"no";0;0;0;55,9325;10,671944
1643;"Kyholm";"no";0;0;0;55,9325;10,671944
1644;"Kyholm";"no";0;0;0;55,9325;10,671944
1645;"Kyholm";"no";0;0;0;55,9325;10,671944
1646;"Kyholm";"no";0;0;0;55,9325;10,671944
1647;"Kyholm";"no";0;0;0;55,9325;10,671944
1648;"Kyholm";"no";0;0;0;55,9325;10,671944
1649;"Kyholm";"no";0;0;0;55,9325;10,671944
1650;"Kyholm";"no";0;0;0;55,9325;10,671944
1651;"Kyholm";"no";0;0;0;55,9325;10,671944
1652;"Kyholm";"no";0;0;0;55,9325;10,671944
1653;"Kyholm";"no";0;0;0;55,9325;10,671944
1654;"Kyholm";"no";0;0;0;55,9325;10,671944
1655;"Kyholm";"no";0;0;0;55,9325;10,671944
1656;"Kyholm";"no";0;0;0;55,9325;10,671944
1657;"Kyholm";"no";0;0;0;55,9325;10,671944
1658;"Kyholm";"no";0;0;0;55,9325;10,671944
1659;"Kyholm";"no";0;0;0;55,9325;10,671944
1660;"Kyholm";"no";0;0;0;55,9325;10,671944
1661;"Kyholm";"no";0;0;0;55,9325;10,671944
1662;"Kyholm";"no";0;0;0;55,9325;10,671944
1663;"Kyholm";"no";0;0;0;55,9325;10,671944
1664;"Kyholm";"no";0;0;0;55,9325;10,671944
1665;"Kyholm";"no";0;0;0;55,9325;10,671944
1666;"Kyholm";"no";0;0;0;55,9325;10,671944
1667;"Kyholm";"no";0;0;0;55,9325;10,671944
1668;"Kyholm";"no";0;0;0;55,9325;10,671944
1669;"Kyholm";"no";0;0;0;55,9325;10,671944
1670;"Kyholm";"no";0;0;0;55,9325;10,671944
1671;"Kyholm";"no";0;0;0;55,9325;10,671944
1672;"Kyholm";"no";0;0;0;55,9325;10,671944
1673;"Kyholm";"no";0;0;0;55,9325;10,671944
1674;"Kyholm";"no";0;0;0;55,9325;10,671944
1675;"Kyholm";"no";0;0;0;55,9325;10,671944
1676;"Kyholm";"no";0;0;0;55,9325;10,671944
1677;"Kyholm";"no";0;0;0;55,9325;10,671944
1678;"Kyholm";"no";0;0;0;55,9325;10,671944
1679;"Kyholm";"no";0;0;0;55,9325;10,671944
1680;"Kyholm";"no";0;0;0;55,9325;10,671944
1681;"Kyholm";"no";0;0;0;55,9325;10,671944
1682;"Kyholm";"no";0;0;0;55,9325;10,671944
1683;"Kyholm";"no";0;0;0;55,9325;10,671944
1684;"Kyholm";"no";0;0;0;55,9325;10,671944
1685;"Kyholm";"no";0;0;0;55,9325;10,671944
1686;"Kyholm";"no";0;0;0;55,9325;10,671944
1687;"Kyholm";"no";0;0;0;55,9325;10,671944
1688;"Kyholm";"no";0;0;0;55,9325;10,671944
1689;"Kyholm";"no";0;0;0;55,9325;10,671944
1690;"Kyholm";"no";0;0;0;55,9325;10,671944
1691;"Kyholm";"no";0;0;0;55,9325;10,671944
1692;"Kyholm";"no";0;0;0;55,9325;10,671944
1693;"Kyholm";"no";0;0;0;55,9325;10,671944
1694;"Kyholm";"no";0;0;0;55,9325;10,671944
1695;"Kyholm";"no";0;0;0;55,9325;10,671944
1696;"Kyholm";"no";0;0;0;55,9325;10,671944
1697;"Kyholm";"no";0;0;0;55,9325;10,671944
1698;"Kyholm";"no";0;0;0;55,9325;10,671944
1699;"Kyholm";"no";0;0;0;55,9325;10,671944
1700;"Kyholm";"no";0;0;0;55,9325;10,671944
1701;"Kyholm";"no";0;0;0;55,9325;10,671944
1702;"Kyholm";"no";0;0;0;55,9325;10,671944
1703;"Kyholm";"no";0;0;0;55,9325;10,671944
1704;"Kyholm";"no";0;0;0;55,9325;10,671944
1705;"Kyholm";"no";0;0;0;55,9325;10,671944
1706;"Kyholm";"no";0;0;0;55,9325;10,671944
1707;"Kyholm";"no";0;0;0;55,9325;10,671944
1708;"Kyholm";"no";0;0;0;55,9325;10,671944
1709;"Kyholm";"no";0;0;0;55,9325;10,671944
1710;"Kyholm";"no";0;0;0;55,9325;10,671944
1711;"Kyholm";"no";0;0;0;55,9325;10,671944
1712;"Kyholm";"no";0;0;0;55,9325;10,671944
1713;"Kyholm";"no";0;0;0;55,9325;10,671944
1714;"Kyholm";"no";0;0;0;55,9325;10,671944
1715;"Kyholm";"no";0;0;0;55,9325;10,671944
1716;"Kyholm";"no";0;0;0;55,9325;10,671944
1717;"Kyholm";"no";0;0;0;55,9325;10,671944
1718;"Kyholm";"no";0;0;0;55,9325;10,671944
1719;"Kyholm";"no";0;0;0;55,9325;10,671944
1720;"Kyholm";"no";0;0;0;55,9325;10,671944
1721;"Kyholm";"no";0;0;0;55,9325;10,671944
1722;"Kyholm";"no";0;0;0;55,9325;10,671944
1723;"Kyholm";"no";0;0;0;55,9325;10,671944
1724;"Kyholm";"no";0;0;0;55,9325;10,671944
1725;"Kyholm";"no";0;0;0;55,9325;10,671944
1726;"Kyholm";"no";0;0;0;55,9325;10,671944
1727;"Kyholm";"no";0;0;0;55,9325;10,671944
1728;"Kyholm";"no";0;0;0;55,9325;10,671944
1729;"Kyholm";"no";0;0;0;55,9325;10,671944
1730;"Kyholm";"no";0;0;0;55,9325;10,671944
1731;"Kyholm";"no";0;0;0;55,9325;10,671944
1732;"Kyholm";"no";0;0;0;55,9325;10,671944
1733;"Kyholm";"no";0;0;0;55,9325;10,671944
1734;"Kyholm";"no";0;0;0;55,9325;10,671944
1735;"Kyholm";"no";0;0;0;55,9325;10,671944
1736;"Kyholm";"no";0;0;0;55,9325;10,671944
1737;"Kyholm";"no";0;0;0;55,9325;10,671944
1738;"Kyholm";"no";0;0;0;55,9325;10,671944
1739;"Kyholm";"no";0;0;0;55,9325;10,671944
1740;"Kyholm";"no";0;0;0;55,9325;10,671944
1741;"Kyholm";"no";0;0;0;55,9325;10,671944
1742;"Kyholm";"no";0;0;0;55,9325;10,671944
1743;"Kyholm";"no";0;0;0;55,9325;10,671944
1744;"Kyholm";"no";0;0;0;55,9325;10,671944
1745;"Kyholm";"no";0;0;0;55,9325;10,671944
1746;"Kyholm";"no";0;0;0;55,9325;10,671944
1747;"Kyholm";"no";0;0;0;55,9325;10,671944
1748;"Kyholm";"no";0;0;0;55,9325;10,671944
1749;"Kyholm";"no";0;0;0;55,9325;10,671944
1750;"Kyholm";"no";0;0;0;55,9325;10,671944
1751;"Kyholm";"no";0;0;0;55,9325;10,671944
1752;"Kyholm";"no";0;0;0;55,9325;10,671944
1753;"Kyholm";"no";0;0;0;55,9325;10,671944
1754;"Kyholm";"no";0;0;0;55,9325;10,671944
1755;"Kyholm";"no";0;0;0;55,9325;10,671944
1756;"Kyholm";"no";0;0;0;55,9325;10,671944
1757;"Kyholm";"no";0;0;0;55,9325;10,671944
1758;"Kyholm";"no";0;0;0;55,9325;10,671944
1759;"Kyholm";"no";0;0;0;55,9325;10,671944
1760;"Kyholm";"no";0;0;0;55,9325;10,671944
1761;"Kyholm";"no";0;0;0;55,9325;10,671944
1762;"Kyholm";"no";0;0;0;55,9325;10,671944
1763;"Kyholm";"no";0;0;0;55,9325;10,671944
1764;"Kyholm";"no";0;0;0;55,9325;10,671944
1765;"Kyholm";"no";0;0;0;55,9325;10,671944
1766;"Kyholm";"no";0;0;0;55,9325;10,671944
1767;"Kyholm";"no";0;0;0;55,9325;10,671944
1768;"Kyholm";"no";0;0;0;55,9325;10,671944
1769;"Kyholm";"no";0;0;0;55,9325;10,671944
1770;"Kyholm";"no";0;0;0;55,9325;10,671944
1771;"Kyholm";"no";0;0;0;55,9325;10,671944
1772;"Kyholm";"no";0;0;0;55,9325;10,671944
1773;"Kyholm";"no";0;0;0;55,9325;10,671944
1774;"Kyholm";"no";0;0;0;55,9325;10,671944
1775;"Kyholm";"no";0;0;0;55,9325;10,671944
1776;"Kyholm";"no";0;0;0;55,9325;10,671944
1777;"Kyholm";"no";0;0;0;55,9325;10,671944
1778;"Kyholm";"no";0;0;0;55,9325;10,671944
1779;"Kyholm";"no";0;0;0;55,9325;10,671944
1780;"Kyholm";"no";0;0;0;55,9325;10,671944
1781;"Kyholm";"no";0;0;0;55,9325;10,671944
1782;"Kyholm";"no";0;0;0;55,9325;10,671944
1783;"Kyholm";"no";0;0;0;55,9325;10,671944
1784;"Kyholm";"no";0;0;0;55,9325;10,671944
1785;"Kyholm";"no";0;0;0;55,9325;10,671944
1786;"Kyholm";"no";0;0;0;55,9325;10,671944
1787;"Kyholm";"no";0;0;0;55,9325;10,671944
1788;"Kyholm";"no";0;0;0;55,9325;10,671944
1789;"Kyholm";"no";0;0;0;55,9325;10,671944
1790;"Kyholm";"no";0;0;0;55,9325;10,671944
1791;"Kyholm";"no";0;0;0;55,9325;10,671944
1792;"Kyholm";"no";0;0;0;55,9325;10,671944
1793;"Kyholm";"no";0;0;0;55,9325;10,671944
1794;"Kyholm";"no";0;0;0;55,9325;10,671944
1795;"Kyholm";"no";0;0;0;55,9325;10,671944
1796;"Kyholm";"no";0;0;0;55,9325;10,671944
1797;"Kyholm";"no";0;0;0;55,9325;10,671944
1798;"Kyholm";"no";0;0;0;55,9325;10,671944
1799;"Kyholm";"no";0;0;0;55,9325;10,671944
1800;"Kyholm";"no";0;0;0;55,9325;10,671944
1801;"Kyholm";"no";0;0;0;55,9325;10,671944
1802;"Kyholm";"no";0;0;0;55,9325;10,671944
1803;"Kyholm";"no";0;0;0;55,9325;10,671944
1804;"Kyholm";"no";0;0;0;55,9325;10,671944
1805;"Kyholm";"no";0;0;0;55,9325;10,671944
1806;"Kyholm";"no";0;0;0;55,9325;10,671944
1807;"Kyholm";"no";0;0;0;55,9325;10,671944
1808;"Kyholm";"no";0;0;0;55,9325;10,671944
1809;"Kyholm";"no";0;0;0;55,9325;10,671944
1810;"Kyholm";"no";0;0;0;55,9325;10,671944
1811;"Kyholm";"no";0;0;0;55,9325;10,671944
1812;"Kyholm";"no";0;0;0;55,9325;10,671944
1813;"Kyholm";"no";0;0;0;55,9325;10,671944
1814;"Kyholm";"no";0;0;0;55,9325;10,671944
1815;"Kyholm";"no";0;0;0;55,9325;10,671944
1816;"Kyholm";"no";0;0;0;55,9325;10,671944
1817;"Kyholm";"no";0;0;0;55,9325;10,671944
1818;"Kyholm";"no";0;0;0;55,9325;10,671944
1819;"Kyholm";"no";0;0;0;55,9325;10,671944
1820;"Kyholm";"no";0;0;0;55,9325;10,671944
1821;"Kyholm";"no";0;0;0;55,9325;10,671944
1822;"Kyholm";"no";0;0;0;55,9325;10,671944
1823;"Kyholm";"no";0;0;0;55,9325;10,671944
1824;"Kyholm";"no";0;0;0;55,9325;10,671944
1825;"Kyholm";"no";0;0;0;55,9325;10,671944
1826;"Kyholm";"no";0;0;0;55,9325;10,671944
1827;"Kyholm";"no";0;0;0;55,9325;10,671944
1828;"Kyholm";"no";0;0;0;55,9325;10,671944
1829;"Kyholm";"no";0;0;0;55,9325;10,671944
1830;"Kyholm";"no";0;0;0;55,9325;10,671944
1831;"Kyholm";"no";0;0;0;55,9325;10,671944
1832;"Kyholm";"no";0;0;0;55,9325;10,671944
1833;"Kyholm";"no";0;0;0;55,9325;10,671944
1834;"Kyholm";"no";0;0;0;55,9325;10,671944
1835;"Kyholm";"no";0;0;0;55,9325;10,671944
1836;"Kyholm";"no";3;0;3;55,9325;10,671944
1837;"Kyholm";"no";2;0;2;55,9325;10,671944
1838;"Kyholm";"no";3;0;3;55,9325;10,671944
1839;"Kyholm";"no";0;4;4;55,9325;10,671944
1840;"Kyholm";"no";0;0;0;55,9325;10,671944
1841;"Kyholm";"no";0;0;0;55,9325;10,671944
1842;"Kyholm";"no";0;0;0;55,9325;10,671944
1843;"Kyholm";"no";0;0;0;55,9325;10,671944
1844;"Kyholm";"no";0;0;0;55,9325;10,671944
1845;"Kyholm";"no";0;0;0;55,9325;10,671944
1846;"Kyholm";"no";0;0;0;55,9325;10,671944
1847;"Kyholm";"no";0;0;0;55,9325;10,671944
1848;"Kyholm";"no";0;0;0;55,9325;10,671944
1849;"Kyholm";"no";0;0;0;55,9325;10,671944
1850;"Kyholm";"no";0;0;0;55,9325;10,671944
1851;"Kyholm";"no";0;0;0;55,9325;10,671944
1852;"Kyholm";"no";0;0;0;55,9325;10,671944
1853;"Kyholm";"no";0;0;0;55,9325;10,671944
1854;"Kyholm";"no";0;0;0;55,9325;10,671944
1855;"Kyholm";"no";0;0;0;55,9325;10,671944
1856;"Kyholm";"no";0;0;0;55,9325;10,671944
1857;"Kyholm";"no";0;0;0;55,9325;10,671944
1634;"Strandmøllen";"no";0;0;0;55,806388;12,581666
1635;"Strandmøllen";"no";0;0;0;55,806388;12,581666
1636;"Strandmøllen";"no";0;0;0;55,806388;12,581666
1637;"Strandmøllen";"no";0;0;0;55,806388;12,581666
1638;"Strandmøllen";"no";0;0;0;55,806388;12,581666
1639;"Strandmøllen";"no";0;0;0;55,806388;12,581666
1640;"Strandmøllen";"no";0;0;0;55,806388;12,581666
1641;"Strandmøllen";"no";0;0;0;55,806388;12,581666
1642;"Strandmøllen";"no";0;0;0;55,806388;12,581666
1643;"Strandmøllen";"no";0;0;0;55,806388;12,581666
1644;"Strandmøllen";"no";0;0;0;55,806388;12,581666
1645;"Strandmøllen";"no";0;0;0;55,806388;12,581666
1646;"Strandmøllen";"no";0;0;0;55,806388;12,581666
1647;"Strandmøllen";"no";0;0;0;55,806388;12,581666
1648;"Strandmøllen";"no";0;0;0;55,806388;12,581666
1649;"Strandmøllen";"no";0;0;0;55,806388;12,581666
1650;"Strandmøllen";"no";0;0;0;55,806388;12,581666
1651;"Strandmøllen";"no";0;0;0;55,806388;12,581666
1652;"Strandmøllen";"no";0;0;0;55,806388;12,581666
1653;"Strandmøllen";"no";0;0;0;55,806388;12,581666
1654;"Strandmøllen";"no";0;0;0;55,806388;12,581666
1655;"Strandmøllen";"no";0;0;0;55,806388;12,581666
1656;"Strandmøllen";"no";0;0;0;55,806388;12,581666
1657;"Strandmøllen";"no";0;0;0;55,806388;12,581666
1658;"Strandmøllen";"no";0;0;0;55,806388;12,581666
1659;"Strandmøllen";"no";0;0;0;55,806388;12,581666
1660;"Strandmøllen";"no";0;0;0;55,806388;12,581666
1661;"Strandmøllen";"no";0;0;0;55,806388;12,581666
1662;"Strandmøllen";"no";0;0;0;55,806388;12,581666
1663;"Strandmøllen";"no";0;0;0;55,806388;12,581666
1664;"Strandmøllen";"no";0;0;0;55,806388;12,581666
1665;"Strandmøllen";"no";0;0;0;55,806388;12,581666
1666;"Strandmøllen";"no";0;0;0;55,806388;12,581666
1667;"Strandmøllen";"no";0;0;0;55,806388;12,581666
1668;"Strandmøllen";"no";0;0;0;55,806388;12,581666
1669;"Strandmøllen";"no";0;0;0;55,806388;12,581666
1670;"Strandmøllen";"no";0;0;0;55,806388;12,581666
1671;"Strandmøllen";"no";0;0;0;55,806388;12,581666
1672;"Strandmøllen";"no";0;0;0;55,806388;12,581666
1673;"Strandmøllen";"no";0;0;0;55,806388;12,581666
1674;"Strandmøllen";"no";0;0;0;55,806388;12,581666
1675;"Strandmøllen";"no";0;0;0;55,806388;12,581666
1676;"Strandmøllen";"no";0;0;0;55,806388;12,581666
1677;"Strandmøllen";"no";0;0;0;55,806388;12,581666
1678;"Strandmøllen";"no";0;0;0;55,806388;12,581666
1679;"Strandmøllen";"no";0;0;0;55,806388;12,581666
1680;"Strandmøllen";"no";0;0;0;55,806388;12,581666
1681;"Strandmøllen";"no";0;0;0;55,806388;12,581666
1682;"Strandmøllen";"no";0;0;0;55,806388;12,581666
1683;"Strandmøllen";"no";0;0;0;55,806388;12,581666
1684;"Strandmøllen";"no";0;0;0;55,806388;12,581666
1685;"Strandmøllen";"no";0;0;0;55,806388;12,581666
1686;"Strandmøllen";"no";0;0;0;55,806388;12,581666
1687;"Strandmøllen";"no";0;0;0;55,806388;12,581666
1688;"Strandmøllen";"no";0;0;0;55,806388;12,581666
1689;"Strandmøllen";"no";0;0;0;55,806388;12,581666
1690;"Strandmøllen";"no";0;0;0;55,806388;12,581666
1691;"Strandmøllen";"no";0;0;0;55,806388;12,581666
1692;"Strandmøllen";"no";0;0;0;55,806388;12,581666
1693;"Strandmøllen";"no";0;0;0;55,806388;12,581666
1694;"Strandmøllen";"no";0;0;0;55,806388;12,581666
1695;"Strandmøllen";"no";0;0;0;55,806388;12,581666
1696;"Strandmøllen";"no";0;0;0;55,806388;12,581666
1697;"Strandmøllen";"no";0;0;0;55,806388;12,581666
1698;"Strandmøllen";"no";0;0;0;55,806388;12,581666
1699;"Strandmøllen";"no";0;0;0;55,806388;12,581666
1700;"Strandmøllen";"no";0;0;0;55,806388;12,581666
1701;"Strandmøllen";"no";0;0;0;55,806388;12,581666
1702;"Strandmøllen";"no";0;0;0;55,806388;12,581666
1703;"Strandmøllen";"no";0;0;0;55,806388;12,581666
1704;"Strandmøllen";"no";0;0;0;55,806388;12,581666
1705;"Strandmøllen";"no";0;0;0;55,806388;12,581666
1706;"Strandmøllen";"no";0;0;0;55,806388;12,581666
1707;"Strandmøllen";"no";0;0;0;55,806388;12,581666
1708;"Strandmøllen";"no";0;0;0;55,806388;12,581666
1709;"Strandmøllen";"no";0;0;0;55,806388;12,581666
1710;"Strandmøllen";"no";0;0;0;55,806388;12,581666
1711;"Strandmøllen";"no";0;0;0;55,806388;12,581666
1712;"Strandmøllen";"no";0;0;0;55,806388;12,581666
1713;"Strandmøllen";"no";0;0;0;55,806388;12,581666
1714;"Strandmøllen";"no";0;0;0;55,806388;12,581666
1715;"Strandmøllen";"no";0;0;0;55,806388;12,581666
1716;"Strandmøllen";"no";0;0;0;55,806388;12,581666
1717;"Strandmøllen";"no";0;0;0;55,806388;12,581666
1718;"Strandmøllen";"no";0;0;0;55,806388;12,581666
1719;"Strandmøllen";"no";0;0;0;55,806388;12,581666
1720;"Strandmøllen";"no";0;0;0;55,806388;12,581666
1721;"Strandmøllen";"no";0;0;0;55,806388;12,581666
1722;"Strandmøllen";"no";0;0;0;55,806388;12,581666
1723;"Strandmøllen";"no";0;0;0;55,806388;12,581666
1724;"Strandmøllen";"no";0;0;0;55,806388;12,581666
1725;"Strandmøllen";"no";0;0;0;55,806388;12,581666
1726;"Strandmøllen";"no";0;0;0;55,806388;12,581666
1727;"Strandmøllen";"no";0;0;0;55,806388;12,581666
1728;"Strandmøllen";"no";0;0;0;55,806388;12,581666
1729;"Strandmøllen";"no";0;0;0;55,806388;12,581666
1730;"Strandmøllen";"no";0;0;0;55,806388;12,581666
1731;"Strandmøllen";"no";0;0;0;55,806388;12,581666
1732;"Strandmøllen";"no";0;0;0;55,806388;12,581666
1733;"Strandmøllen";"no";0;0;0;55,806388;12,581666
1734;"Strandmøllen";"no";0;0;0;55,806388;12,581666
1735;"Strandmøllen";"no";0;0;0;55,806388;12,581666
1736;"Strandmøllen";"no";0;0;0;55,806388;12,581666
1737;"Strandmøllen";"no";0;0;0;55,806388;12,581666
1738;"Strandmøllen";"no";0;0;0;55,806388;12,581666
1739;"Strandmøllen";"no";0;0;0;55,806388;12,581666
1740;"Strandmøllen";"no";0;0;0;55,806388;12,581666
1741;"Strandmøllen";"no";0;0;0;55,806388;12,581666
1742;"Strandmøllen";"no";0;0;0;55,806388;12,581666
1743;"Strandmøllen";"no";0;0;0;55,806388;12,581666
1744;"Strandmøllen";"no";0;0;0;55,806388;12,581666
1745;"Strandmøllen";"no";0;0;0;55,806388;12,581666
1746;"Strandmøllen";"no";0;0;0;55,806388;12,581666
1747;"Strandmøllen";"no";0;0;0;55,806388;12,581666
1748;"Strandmøllen";"no";0;0;0;55,806388;12,581666
1749;"Strandmøllen";"no";0;0;0;55,806388;12,581666
1750;"Strandmøllen";"no";0;0;0;55,806388;12,581666
1751;"Strandmøllen";"no";0;0;0;55,806388;12,581666
1752;"Strandmøllen";"no";0;0;0;55,806388;12,581666
1753;"Strandmøllen";"no";0;0;0;55,806388;12,581666
1754;"Strandmøllen";"no";0;0;0;55,806388;12,581666
1755;"Strandmøllen";"no";0;0;0;55,806388;12,581666
1756;"Strandmøllen";"no";0;0;0;55,806388;12,581666
1757;"Strandmøllen";"no";0;0;0;55,806388;12,581666
1758;"Strandmøllen";"no";0;0;0;55,806388;12,581666
1759;"Strandmøllen";"no";0;0;0;55,806388;12,581666
1760;"Strandmøllen";"no";0;0;0;55,806388;12,581666
1761;"Strandmøllen";"no";0;0;0;55,806388;12,581666
1762;"Strandmøllen";"no";0;0;0;55,806388;12,581666
1763;"Strandmøllen";"no";0;0;0;55,806388;12,581666
1764;"Strandmøllen";"no";0;0;0;55,806388;12,581666
1765;"Strandmøllen";"no";0;0;0;55,806388;12,581666
1766;"Strandmøllen";"no";0;0;0;55,806388;12,581666
1767;"Strandmøllen";"no";0;0;0;55,806388;12,581666
1768;"Strandmøllen";"no";0;0;0;55,806388;12,581666
1769;"Strandmøllen";"no";0;0;0;55,806388;12,581666
1770;"Strandmøllen";"no";0;0;0;55,806388;12,581666
1771;"Strandmøllen";"no";0;0;0;55,806388;12,581666
1772;"Strandmøllen";"no";0;0;0;55,806388;12,581666
1773;"Strandmøllen";"no";0;0;0;55,806388;12,581666
1774;"Strandmøllen";"no";0;0;0;55,806388;12,581666
1775;"Strandmøllen";"no";0;0;0;55,806388;12,581666
1776;"Strandmøllen";"no";0;0;0;55,806388;12,581666
1777;"Strandmøllen";"no";0;0;0;55,806388;12,581666
1778;"Strandmøllen";"no";0;0;0;55,806388;12,581666
1779;"Strandmøllen";"no";0;0;0;55,806388;12,581666
1780;"Strandmøllen";"no";0;0;0;55,806388;12,581666
1781;"Strandmøllen";"no";0;0;0;55,806388;12,581666
1782;"Strandmøllen";"no";0;0;0;55,806388;12,581666
1783;"Strandmøllen";"no";0;0;0;55,806388;12,581666
1784;"Strandmøllen";"no";0;0;0;55,806388;12,581666
1785;"Strandmøllen";"no";0;0;0;55,806388;12,581666
1786;"Strandmøllen";"no";0;0;0;55,806388;12,581666
1787;"Strandmøllen";"no";0;0;0;55,806388;12,581666
1788;"Strandmøllen";"no";0;0;0;55,806388;12,581666
1789;"Strandmøllen";"no";0;0;0;55,806388;12,581666
1790;"Strandmøllen";"no";0;0;0;55,806388;12,581666
1791;"Strandmøllen";"no";0;0;0;55,806388;12,581666
1792;"Strandmøllen";"no";0;0;0;55,806388;12,581666
1793;"Strandmøllen";"no";0;0;0;55,806388;12,581666
1794;"Strandmøllen";"no";0;0;0;55,806388;12,581666
1795;"Strandmøllen";"no";0;0;0;55,806388;12,581666
1796;"Strandmøllen";"no";0;0;0;55,806388;12,581666
1797;"Strandmøllen";"no";0;0;0;55,806388;12,581666
1798;"Strandmøllen";"no";0;0;0;55,806388;12,581666
1799;"Strandmøllen";"no";0;0;0;55,806388;12,581666
1800;"Strandmøllen";"no";0;0;0;55,806388;12,581666
1801;"Strandmøllen";"no";0;0;0;55,806388;12,581666
1802;"Strandmøllen";"no";0;0;0;55,806388;12,581666
1803;"Strandmøllen";"no";0;0;0;55,806388;12,581666
1804;"Strandmøllen";"no";0;0;0;55,806388;12,581666
1805;"Strandmøllen";"no";0;0;0;55,806388;12,581666
1806;"Strandmøllen";"no";0;0;0;55,806388;12,581666
1807;"Strandmøllen";"no";0;0;0;55,806388;12,581666
1808;"Strandmøllen";"no";0;0;0;55,806388;12,581666
1809;"Strandmøllen";"no";0;0;0;55,806388;12,581666
1810;"Strandmøllen";"no";0;0;0;55,806388;12,581666
1811;"Strandmøllen";"no";0;0;0;55,806388;12,581666
1812;"Strandmøllen";"no";0;0;0;55,806388;12,581666
1813;"Strandmøllen";"no";0;0;0;55,806388;12,581666
1814;"Strandmøllen";"no";0;0;0;55,806388;12,581666
1815;"Strandmøllen";"no";0;0;0;55,806388;12,581666
1816;"Strandmøllen";"no";0;0;0;55,806388;12,581666
1817;"Strandmøllen";"no";0;0;0;55,806388;12,581666
1818;"Strandmøllen";"no";0;0;0;55,806388;12,581666
1819;"Strandmøllen";"no";0;0;0;55,806388;12,581666
1820;"Strandmøllen";"no";0;0;0;55,806388;12,581666
1821;"Strandmøllen";"no";0;0;0;55,806388;12,581666
1822;"Strandmøllen";"no";0;0;0;55,806388;12,581666
1823;"Strandmøllen";"no";0;0;0;55,806388;12,581666
1824;"Strandmøllen";"no";0;0;0;55,806388;12,581666
1825;"Strandmøllen";"no";0;0;0;55,806388;12,581666
1826;"Strandmøllen";"no";0;0;0;55,806388;12,581666
1827;"Strandmøllen";"no";0;0;0;55,806388;12,581666
1828;"Strandmøllen";"no";0;0;0;55,806388;12,581666
1829;"Strandmøllen";"no";0;1;1;55,806388;12,581666
1830;"Strandmøllen";"no";0;3;3;55,806388;12,581666
1831;"Strandmøllen";"no";0;0;0;55,806388;12,581666
1832;"Strandmøllen";"no";0;0;0;55,806388;12,581666
1833;"Strandmøllen";"no";0;0;0;55,806388;12,581666
1834;"Strandmøllen";"no";0;0;0;55,806388;12,581666
1835;"Strandmøllen";"no";0;0;0;55,806388;12,581666
1836;"Strandmøllen";"no";0;0;0;55,806388;12,581666
1837;"Strandmøllen";"no";0;0;0;55,806388;12,581666
1838;"Strandmøllen";"no";1;6;7;55,806388;12,581666
1839;"Strandmøllen";"no";0;0;0;55,806388;12,581666
1840;"Strandmøllen";"no";0;1;1;55,806388;12,581666
1841;"Strandmøllen";"no";0;0;0;55,806388;12,581666
1842;"Strandmøllen";"no";0;2;2;55,806388;12,581666
1843;"Strandmøllen";"no";0;1;1;55,806388;12,581666
1844;"Strandmøllen";"no";0;1;1;55,806388;12,581666
1845;"Strandmøllen";"no";0;1;1;55,806388;12,581666
1846;"Strandmøllen";"no";0;1;1;55,806388;12,581666
1847;"Strandmøllen";"no";0;0;0;55,806388;12,581666
1848;"Strandmøllen";"no";0;3;3;55,806388;12,581666
1849;"Strandmøllen";"no";0;1;1;55,806388;12,581666
1850;"Strandmøllen";"no";0;4;4;55,806388;12,581666
1851;"Strandmøllen";"no";0;4;4;55,806388;12,581666
1852;"Strandmøllen";"no";0;5;5;55,806388;12,581666
1853;"Strandmøllen";"no";0;2;2;55,806388;12,581666
1854;"Strandmøllen";"no";0;6;6;55,806388;12,581666
1855;"Strandmøllen";"no";0;8;8;55,806388;12,581666
1856;"Strandmøllen";"no";0;11;11;55,806388;12,581666
1857;"Strandmøllen";"no";0;0;0;55,806388;12,581666
1634;"Skovshoved";"no";0;0;0;55,766666;12,6
1635;"Skovshoved";"no";0;0;0;55,766666;12,6
1636;"Skovshoved";"no";0;0;0;55,766666;12,6
1637;"Skovshoved";"no";0;0;0;55,766666;12,6
1638;"Skovshoved";"no";0;0;0;55,766666;12,6
1639;"Skovshoved";"no";0;0;0;55,766666;12,6
1640;"Skovshoved";"no";0;0;0;55,766666;12,6
1641;"Skovshoved";"no";0;0;0;55,766666;12,6
1642;"Skovshoved";"no";0;0;0;55,766666;12,6
1643;"Skovshoved";"no";0;0;0;55,766666;12,6
1644;"Skovshoved";"no";0;0;0;55,766666;12,6
1645;"Skovshoved";"no";0;0;0;55,766666;12,6
1646;"Skovshoved";"no";0;0;0;55,766666;12,6
1647;"Skovshoved";"no";0;0;0;55,766666;12,6
1648;"Skovshoved";"no";0;0;0;55,766666;12,6
1649;"Skovshoved";"no";0;0;0;55,766666;12,6
1650;"Skovshoved";"no";0;0;0;55,766666;12,6
1651;"Skovshoved";"no";0;0;0;55,766666;12,6
1652;"Skovshoved";"no";0;0;0;55,766666;12,6
1653;"Skovshoved";"no";0;0;0;55,766666;12,6
1654;"Skovshoved";"no";0;0;0;55,766666;12,6
1655;"Skovshoved";"no";0;0;0;55,766666;12,6
1656;"Skovshoved";"no";0;0;0;55,766666;12,6
1657;"Skovshoved";"no";0;0;0;55,766666;12,6
1658;"Skovshoved";"no";0;0;0;55,766666;12,6
1659;"Skovshoved";"no";0;0;0;55,766666;12,6
1660;"Skovshoved";"no";0;0;0;55,766666;12,6
1661;"Skovshoved";"no";0;0;0;55,766666;12,6
1662;"Skovshoved";"no";0;0;0;55,766666;12,6
1663;"Skovshoved";"no";0;0;0;55,766666;12,6
1664;"Skovshoved";"no";0;0;0;55,766666;12,6
1665;"Skovshoved";"no";0;0;0;55,766666;12,6
1666;"Skovshoved";"no";0;0;0;55,766666;12,6
1667;"Skovshoved";"no";0;0;0;55,766666;12,6
1668;"Skovshoved";"no";0;0;0;55,766666;12,6
1669;"Skovshoved";"no";0;0;0;55,766666;12,6
1670;"Skovshoved";"no";0;0;0;55,766666;12,6
1671;"Skovshoved";"no";0;0;0;55,766666;12,6
1672;"Skovshoved";"no";0;0;0;55,766666;12,6
1673;"Skovshoved";"no";0;0;0;55,766666;12,6
1674;"Skovshoved";"no";0;0;0;55,766666;12,6
1675;"Skovshoved";"no";0;0;0;55,766666;12,6
1676;"Skovshoved";"no";0;0;0;55,766666;12,6
1677;"Skovshoved";"no";0;0;0;55,766666;12,6
1678;"Skovshoved";"no";0;0;0;55,766666;12,6
1679;"Skovshoved";"no";0;0;0;55,766666;12,6
1680;"Skovshoved";"no";0;0;0;55,766666;12,6
1681;"Skovshoved";"no";0;0;0;55,766666;12,6
1682;"Skovshoved";"no";0;0;0;55,766666;12,6
1683;"Skovshoved";"no";0;0;0;55,766666;12,6
1684;"Skovshoved";"no";0;0;0;55,766666;12,6
1685;"Skovshoved";"no";0;0;0;55,766666;12,6
1686;"Skovshoved";"no";0;0;0;55,766666;12,6
1687;"Skovshoved";"no";0;0;0;55,766666;12,6
1688;"Skovshoved";"no";0;0;0;55,766666;12,6
1689;"Skovshoved";"no";0;0;0;55,766666;12,6
1690;"Skovshoved";"no";0;0;0;55,766666;12,6
1691;"Skovshoved";"no";0;0;0;55,766666;12,6
1692;"Skovshoved";"no";0;0;0;55,766666;12,6
1693;"Skovshoved";"no";0;0;0;55,766666;12,6
1694;"Skovshoved";"no";0;0;0;55,766666;12,6
1695;"Skovshoved";"no";0;0;0;55,766666;12,6
1696;"Skovshoved";"no";0;0;0;55,766666;12,6
1697;"Skovshoved";"no";0;0;0;55,766666;12,6
1698;"Skovshoved";"no";0;0;0;55,766666;12,6
1699;"Skovshoved";"no";0;0;0;55,766666;12,6
1700;"Skovshoved";"no";0;0;0;55,766666;12,6
1701;"Skovshoved";"no";0;0;0;55,766666;12,6
1702;"Skovshoved";"no";0;0;0;55,766666;12,6
1703;"Skovshoved";"no";0;0;0;55,766666;12,6
1704;"Skovshoved";"no";0;0;0;55,766666;12,6
1705;"Skovshoved";"no";0;0;0;55,766666;12,6
1706;"Skovshoved";"no";0;0;0;55,766666;12,6
1707;"Skovshoved";"no";0;0;0;55,766666;12,6
1708;"Skovshoved";"no";0;0;0;55,766666;12,6
1709;"Skovshoved";"no";0;0;0;55,766666;12,6
1710;"Skovshoved";"no";0;0;0;55,766666;12,6
1711;"Skovshoved";"no";0;0;0;55,766666;12,6
1712;"Skovshoved";"no";0;0;0;55,766666;12,6
1713;"Skovshoved";"no";0;0;0;55,766666;12,6
1714;"Skovshoved";"no";0;0;0;55,766666;12,6
1715;"Skovshoved";"no";0;0;0;55,766666;12,6
1716;"Skovshoved";"no";0;0;0;55,766666;12,6
1717;"Skovshoved";"no";0;0;0;55,766666;12,6
1718;"Skovshoved";"no";0;0;0;55,766666;12,6
1719;"Skovshoved";"no";0;0;0;55,766666;12,6
1720;"Skovshoved";"no";0;0;0;55,766666;12,6
1721;"Skovshoved";"no";0;0;0;55,766666;12,6
1722;"Skovshoved";"no";0;0;0;55,766666;12,6
1723;"Skovshoved";"no";0;0;0;55,766666;12,6
1724;"Skovshoved";"no";0;0;0;55,766666;12,6
1725;"Skovshoved";"no";0;0;0;55,766666;12,6
1726;"Skovshoved";"no";0;0;0;55,766666;12,6
1727;"Skovshoved";"no";0;0;0;55,766666;12,6
1728;"Skovshoved";"no";0;0;0;55,766666;12,6
1729;"Skovshoved";"no";0;0;0;55,766666;12,6
1730;"Skovshoved";"no";0;0;0;55,766666;12,6
1731;"Skovshoved";"no";0;0;0;55,766666;12,6
1732;"Skovshoved";"no";0;0;0;55,766666;12,6
1733;"Skovshoved";"no";0;0;0;55,766666;12,6
1734;"Skovshoved";"no";0;0;0;55,766666;12,6
1735;"Skovshoved";"no";0;0;0;55,766666;12,6
1736;"Skovshoved";"no";0;0;0;55,766666;12,6
1737;"Skovshoved";"no";0;0;0;55,766666;12,6
1738;"Skovshoved";"no";0;0;0;55,766666;12,6
1739;"Skovshoved";"no";0;0;0;55,766666;12,6
1740;"Skovshoved";"no";0;0;0;55,766666;12,6
1741;"Skovshoved";"no";0;0;0;55,766666;12,6
1742;"Skovshoved";"no";0;0;0;55,766666;12,6
1743;"Skovshoved";"no";0;0;0;55,766666;12,6
1744;"Skovshoved";"no";0;0;0;55,766666;12,6
1745;"Skovshoved";"no";0;0;0;55,766666;12,6
1746;"Skovshoved";"no";0;0;0;55,766666;12,6
1747;"Skovshoved";"no";0;0;0;55,766666;12,6
1748;"Skovshoved";"no";0;0;0;55,766666;12,6
1749;"Skovshoved";"no";0;0;0;55,766666;12,6
1750;"Skovshoved";"no";0;0;0;55,766666;12,6
1751;"Skovshoved";"no";0;0;0;55,766666;12,6
1752;"Skovshoved";"no";0;0;0;55,766666;12,6
1753;"Skovshoved";"no";0;0;0;55,766666;12,6
1754;"Skovshoved";"no";0;0;0;55,766666;12,6
1755;"Skovshoved";"no";0;0;0;55,766666;12,6
1756;"Skovshoved";"no";0;0;0;55,766666;12,6
1757;"Skovshoved";"no";0;0;0;55,766666;12,6
1758;"Skovshoved";"no";0;0;0;55,766666;12,6
1759;"Skovshoved";"no";0;0;0;55,766666;12,6
1760;"Skovshoved";"no";0;0;0;55,766666;12,6
1761;"Skovshoved";"no";0;0;0;55,766666;12,6
1762;"Skovshoved";"no";0;0;0;55,766666;12,6
1763;"Skovshoved";"no";0;0;0;55,766666;12,6
1764;"Skovshoved";"no";0;0;0;55,766666;12,6
1765;"Skovshoved";"no";0;0;0;55,766666;12,6
1766;"Skovshoved";"no";0;0;0;55,766666;12,6
1767;"Skovshoved";"no";0;0;0;55,766666;12,6
1768;"Skovshoved";"no";0;0;0;55,766666;12,6
1769;"Skovshoved";"no";0;0;0;55,766666;12,6
1770;"Skovshoved";"no";0;0;0;55,766666;12,6
1771;"Skovshoved";"no";0;0;0;55,766666;12,6
1772;"Skovshoved";"no";0;0;0;55,766666;12,6
1773;"Skovshoved";"no";0;0;0;55,766666;12,6
1774;"Skovshoved";"no";0;0;0;55,766666;12,6
1775;"Skovshoved";"no";0;0;0;55,766666;12,6
1776;"Skovshoved";"no";0;0;0;55,766666;12,6
1777;"Skovshoved";"no";0;0;0;55,766666;12,6
1778;"Skovshoved";"no";0;0;0;55,766666;12,6
1779;"Skovshoved";"no";0;0;0;55,766666;12,6
1780;"Skovshoved";"no";0;0;0;55,766666;12,6
1781;"Skovshoved";"no";0;0;0;55,766666;12,6
1782;"Skovshoved";"no";0;0;0;55,766666;12,6
1783;"Skovshoved";"no";0;0;0;55,766666;12,6
1784;"Skovshoved";"no";0;0;0;55,766666;12,6
1785;"Skovshoved";"no";0;0;0;55,766666;12,6
1786;"Skovshoved";"no";0;0;0;55,766666;12,6
1787;"Skovshoved";"no";0;0;0;55,766666;12,6
1788;"Skovshoved";"no";0;0;0;55,766666;12,6
1789;"Skovshoved";"no";0;0;0;55,766666;12,6
1790;"Skovshoved";"no";0;0;0;55,766666;12,6
1791;"Skovshoved";"no";0;0;0;55,766666;12,6
1792;"Skovshoved";"no";0;0;0;55,766666;12,6
1793;"Skovshoved";"no";0;0;0;55,766666;12,6
1794;"Skovshoved";"no";0;0;0;55,766666;12,6
1795;"Skovshoved";"no";0;0;0;55,766666;12,6
1796;"Skovshoved";"no";0;0;0;55,766666;12,6
1797;"Skovshoved";"no";0;0;0;55,766666;12,6
1798;"Skovshoved";"no";0;0;0;55,766666;12,6
1799;"Skovshoved";"no";0;0;0;55,766666;12,6
1800;"Skovshoved";"no";0;0;0;55,766666;12,6
1801;"Skovshoved";"no";0;0;0;55,766666;12,6
1802;"Skovshoved";"no";0;0;0;55,766666;12,6
1803;"Skovshoved";"no";0;0;0;55,766666;12,6
1804;"Skovshoved";"no";0;0;0;55,766666;12,6
1805;"Skovshoved";"no";0;0;0;55,766666;12,6
1806;"Skovshoved";"no";0;0;0;55,766666;12,6
1807;"Skovshoved";"no";0;0;0;55,766666;12,6
1808;"Skovshoved";"no";0;0;0;55,766666;12,6
1809;"Skovshoved";"no";0;0;0;55,766666;12,6
1810;"Skovshoved";"no";0;0;0;55,766666;12,6
1811;"Skovshoved";"no";0;0;0;55,766666;12,6
1812;"Skovshoved";"no";0;0;0;55,766666;12,6
1813;"Skovshoved";"no";0;0;0;55,766666;12,6
1814;"Skovshoved";"no";0;0;0;55,766666;12,6
1815;"Skovshoved";"no";0;0;0;55,766666;12,6
1816;"Skovshoved";"no";0;0;0;55,766666;12,6
1817;"Skovshoved";"no";0;0;0;55,766666;12,6
1818;"Skovshoved";"no";0;0;0;55,766666;12,6
1819;"Skovshoved";"no";0;0;0;55,766666;12,6
1820;"Skovshoved";"no";0;0;0;55,766666;12,6
1821;"Skovshoved";"no";0;0;0;55,766666;12,6
1822;"Skovshoved";"no";0;0;0;55,766666;12,6
1823;"Skovshoved";"no";0;0;0;55,766666;12,6
1824;"Skovshoved";"no";0;0;0;55,766666;12,6
1825;"Skovshoved";"no";0;0;0;55,766666;12,6
1826;"Skovshoved";"no";0;0;0;55,766666;12,6
1827;"Skovshoved";"no";0;0;0;55,766666;12,6
1828;"Skovshoved";"no";0;0;0;55,766666;12,6
1829;"Skovshoved";"no";0;0;0;55,766666;12,6
1830;"Skovshoved";"no";0;0;0;55,766666;12,6
1831;"Skovshoved";"no";0;0;0;55,766666;12,6
1832;"Skovshoved";"no";0;0;0;55,766666;12,6
1833;"Skovshoved";"no";0;0;0;55,766666;12,6
1834;"Skovshoved";"no";0;0;0;55,766666;12,6
1835;"Skovshoved";"no";0;0;0;55,766666;12,6
1836;"Skovshoved";"no";0;0;0;55,766666;12,6
1837;"Skovshoved";"no";0;0;0;55,766666;12,6
1838;"Skovshoved";"no";0;0;0;55,766666;12,6
1839;"Skovshoved";"no";1;0;1;55,766666;12,6
1840;"Skovshoved";"no";0;0;0;55,766666;12,6
1841;"Skovshoved";"no";0;0;0;55,766666;12,6
1842;"Skovshoved";"no";0;0;0;55,766666;12,6
1843;"Skovshoved";"no";0;0;0;55,766666;12,6
1844;"Skovshoved";"no";0;0;0;55,766666;12,6
1845;"Skovshoved";"no";0;0;0;55,766666;12,6
1846;"Skovshoved";"no";0;0;0;55,766666;12,6
1847;"Skovshoved";"no";0;0;0;55,766666;12,6
1848;"Skovshoved";"no";0;0;0;55,766666;12,6
1849;"Skovshoved";"no";0;0;0;55,766666;12,6
1850;"Skovshoved";"no";0;0;0;55,766666;12,6
1851;"Skovshoved";"no";0;0;0;55,766666;12,6
1852;"Skovshoved";"no";0;0;0;55,766666;12,6
1853;"Skovshoved";"no";0;0;0;55,766666;12,6
1854;"Skovshoved";"no";0;0;0;55,766666;12,6
1855;"Skovshoved";"no";0;0;0;55,766666;12,6
1856;"Skovshoved";"no";0;0;0;55,766666;12,6
1857;"Skovshoved";"no";0;0;0;55,766666;12,6
1634;"Nibe";"east";0;0;0;56,983333;9,633333
1635;"Nibe";"east";0;0;0;56,983333;9,633333
1636;"Nibe";"east";0;0;0;56,983333;9,633333
1637;"Nibe";"east";0;0;0;56,983333;9,633333
1638;"Nibe";"east";0;0;0;56,983333;9,633333
1639;"Nibe";"east";0;0;0;56,983333;9,633333
1640;"Nibe";"east";0;0;0;56,983333;9,633333
1641;"Nibe";"east";0;0;0;56,983333;9,633333
1642;"Nibe";"east";0;0;0;56,983333;9,633333
1643;"Nibe";"east";0;0;0;56,983333;9,633333
1644;"Nibe";"east";0;0;0;56,983333;9,633333
1645;"Nibe";"east";0;0;0;56,983333;9,633333
1646;"Nibe";"east";0;0;0;56,983333;9,633333
1647;"Nibe";"east";0;0;0;56,983333;9,633333
1648;"Nibe";"east";0;0;0;56,983333;9,633333
1649;"Nibe";"east";0;0;0;56,983333;9,633333
1650;"Nibe";"east";0;0;0;56,983333;9,633333
1651;"Nibe";"east";0;0;0;56,983333;9,633333
1652;"Nibe";"east";0;0;0;56,983333;9,633333
1653;"Nibe";"east";0;0;0;56,983333;9,633333
1654;"Nibe";"east";0;0;0;56,983333;9,633333
1655;"Nibe";"east";0;0;0;56,983333;9,633333
1656;"Nibe";"east";0;0;0;56,983333;9,633333
1657;"Nibe";"east";0;0;0;56,983333;9,633333
1658;"Nibe";"east";0;0;0;56,983333;9,633333
1659;"Nibe";"east";0;0;0;56,983333;9,633333
1660;"Nibe";"east";0;0;0;56,983333;9,633333
1661;"Nibe";"east";0;0;0;56,983333;9,633333
1662;"Nibe";"east";0;0;0;56,983333;9,633333
1663;"Nibe";"east";0;0;0;56,983333;9,633333
1664;"Nibe";"east";0;0;0;56,983333;9,633333
1665;"Nibe";"east";0;0;0;56,983333;9,633333
1666;"Nibe";"east";0;0;0;56,983333;9,633333
1667;"Nibe";"east";0;0;0;56,983333;9,633333
1668;"Nibe";"east";0;0;0;56,983333;9,633333
1669;"Nibe";"east";0;0;0;56,983333;9,633333
1670;"Nibe";"east";0;0;0;56,983333;9,633333
1671;"Nibe";"east";0;0;0;56,983333;9,633333
1672;"Nibe";"east";0;0;0;56,983333;9,633333
1673;"Nibe";"east";0;0;0;56,983333;9,633333
1674;"Nibe";"east";0;0;0;56,983333;9,633333
1675;"Nibe";"east";0;0;0;56,983333;9,633333
1676;"Nibe";"east";0;0;0;56,983333;9,633333
1677;"Nibe";"east";0;0;0;56,983333;9,633333
1678;"Nibe";"east";0;0;0;56,983333;9,633333
1679;"Nibe";"east";0;0;0;56,983333;9,633333
1680;"Nibe";"east";0;0;0;56,983333;9,633333
1681;"Nibe";"east";0;0;0;56,983333;9,633333
1682;"Nibe";"east";0;0;0;56,983333;9,633333
1683;"Nibe";"east";0;0;0;56,983333;9,633333
1684;"Nibe";"east";0;0;0;56,983333;9,633333
1685;"Nibe";"east";0;0;0;56,983333;9,633333
1686;"Nibe";"east";0;0;0;56,983333;9,633333
1687;"Nibe";"east";0;0;0;56,983333;9,633333
1688;"Nibe";"east";0;0;0;56,983333;9,633333
1689;"Nibe";"east";0;0;0;56,983333;9,633333
1690;"Nibe";"east";0;0;0;56,983333;9,633333
1691;"Nibe";"east";0;0;0;56,983333;9,633333
1692;"Nibe";"east";0;0;0;56,983333;9,633333
1693;"Nibe";"east";0;0;0;56,983333;9,633333
1694;"Nibe";"east";0;0;0;56,983333;9,633333
1695;"Nibe";"east";0;0;0;56,983333;9,633333
1696;"Nibe";"east";0;0;0;56,983333;9,633333
1697;"Nibe";"east";0;0;0;56,983333;9,633333
1698;"Nibe";"east";0;0;0;56,983333;9,633333
1699;"Nibe";"east";0;0;0;56,983333;9,633333
1700;"Nibe";"east";0;0;0;56,983333;9,633333
1701;"Nibe";"east";0;0;0;56,983333;9,633333
1702;"Nibe";"east";0;0;0;56,983333;9,633333
1703;"Nibe";"east";0;0;0;56,983333;9,633333
1704;"Nibe";"east";0;0;0;56,983333;9,633333
1705;"Nibe";"east";0;0;0;56,983333;9,633333
1706;"Nibe";"east";0;0;0;56,983333;9,633333
1707;"Nibe";"east";0;0;0;56,983333;9,633333
1708;"Nibe";"east";0;0;0;56,983333;9,633333
1709;"Nibe";"east";0;0;0;56,983333;9,633333
1710;"Nibe";"east";0;0;0;56,983333;9,633333
1711;"Nibe";"east";0;0;0;56,983333;9,633333
1712;"Nibe";"east";0;0;0;56,983333;9,633333
1713;"Nibe";"east";0;0;0;56,983333;9,633333
1714;"Nibe";"east";0;0;0;56,983333;9,633333
1715;"Nibe";"east";0;0;0;56,983333;9,633333
1716;"Nibe";"east";0;0;0;56,983333;9,633333
1717;"Nibe";"east";0;0;0;56,983333;9,633333
1718;"Nibe";"east";0;0;0;56,983333;9,633333
1719;"Nibe";"east";0;0;0;56,983333;9,633333
1720;"Nibe";"east";0;0;0;56,983333;9,633333
1721;"Nibe";"east";0;0;0;56,983333;9,633333
1722;"Nibe";"east";0;0;0;56,983333;9,633333
1723;"Nibe";"east";0;0;0;56,983333;9,633333
1724;"Nibe";"east";0;0;0;56,983333;9,633333
1725;"Nibe";"east";0;0;0;56,983333;9,633333
1726;"Nibe";"east";0;0;0;56,983333;9,633333
1727;"Nibe";"east";0;0;0;56,983333;9,633333
1728;"Nibe";"east";0;0;0;56,983333;9,633333
1729;"Nibe";"east";0;0;0;56,983333;9,633333
1730;"Nibe";"east";0;0;0;56,983333;9,633333
1731;"Nibe";"east";0;0;0;56,983333;9,633333
1732;"Nibe";"east";0;0;0;56,983333;9,633333
1733;"Nibe";"east";0;0;0;56,983333;9,633333
1734;"Nibe";"east";0;0;0;56,983333;9,633333
1735;"Nibe";"east";0;0;0;56,983333;9,633333
1736;"Nibe";"east";0;0;0;56,983333;9,633333
1737;"Nibe";"east";0;0;0;56,983333;9,633333
1738;"Nibe";"east";0;0;0;56,983333;9,633333
1739;"Nibe";"east";0;0;0;56,983333;9,633333
1740;"Nibe";"east";0;0;0;56,983333;9,633333
1741;"Nibe";"east";0;0;0;56,983333;9,633333
1742;"Nibe";"east";0;0;0;56,983333;9,633333
1743;"Nibe";"east";0;0;0;56,983333;9,633333
1744;"Nibe";"east";0;0;0;56,983333;9,633333
1745;"Nibe";"east";0;0;0;56,983333;9,633333
1746;"Nibe";"east";0;0;0;56,983333;9,633333
1747;"Nibe";"east";0;0;0;56,983333;9,633333
1748;"Nibe";"east";0;0;0;56,983333;9,633333
1749;"Nibe";"east";0;0;0;56,983333;9,633333
1750;"Nibe";"east";0;0;0;56,983333;9,633333
1751;"Nibe";"east";0;0;0;56,983333;9,633333
1752;"Nibe";"east";0;0;0;56,983333;9,633333
1753;"Nibe";"east";0;0;0;56,983333;9,633333
1754;"Nibe";"east";0;0;0;56,983333;9,633333
1755;"Nibe";"east";0;0;0;56,983333;9,633333
1756;"Nibe";"east";0;0;0;56,983333;9,633333
1757;"Nibe";"east";0;0;0;56,983333;9,633333
1758;"Nibe";"east";0;0;0;56,983333;9,633333
1759;"Nibe";"east";0;0;0;56,983333;9,633333
1760;"Nibe";"east";0;0;0;56,983333;9,633333
1761;"Nibe";"east";0;0;0;56,983333;9,633333
1762;"Nibe";"east";0;0;0;56,983333;9,633333
1763;"Nibe";"east";0;0;0;56,983333;9,633333
1764;"Nibe";"east";0;0;0;56,983333;9,633333
1765;"Nibe";"east";0;0;0;56,983333;9,633333
1766;"Nibe";"east";0;0;0;56,983333;9,633333
1767;"Nibe";"east";0;0;0;56,983333;9,633333
1768;"Nibe";"east";0;0;0;56,983333;9,633333
1769;"Nibe";"east";0;0;0;56,983333;9,633333
1770;"Nibe";"east";0;0;0;56,983333;9,633333
1771;"Nibe";"east";0;0;0;56,983333;9,633333
1772;"Nibe";"east";0;0;0;56,983333;9,633333
1773;"Nibe";"east";0;0;0;56,983333;9,633333
1774;"Nibe";"east";0;0;0;56,983333;9,633333
1775;"Nibe";"east";0;0;0;56,983333;9,633333
1776;"Nibe";"east";0;0;0;56,983333;9,633333
1777;"Nibe";"east";0;0;0;56,983333;9,633333
1778;"Nibe";"east";0;0;0;56,983333;9,633333
1779;"Nibe";"east";0;0;0;56,983333;9,633333
1780;"Nibe";"east";0;0;0;56,983333;9,633333
1781;"Nibe";"east";0;0;0;56,983333;9,633333
1782;"Nibe";"east";0;0;0;56,983333;9,633333
1783;"Nibe";"east";0;0;0;56,983333;9,633333
1784;"Nibe";"east";0;0;0;56,983333;9,633333
1785;"Nibe";"east";0;0;0;56,983333;9,633333
1786;"Nibe";"east";0;0;0;56,983333;9,633333
1787;"Nibe";"east";0;0;0;56,983333;9,633333
1788;"Nibe";"east";0;0;0;56,983333;9,633333
1789;"Nibe";"east";0;0;0;56,983333;9,633333
1790;"Nibe";"east";0;0;0;56,983333;9,633333
1791;"Nibe";"east";0;0;0;56,983333;9,633333
1792;"Nibe";"east";0;0;0;56,983333;9,633333
1793;"Nibe";"east";0;0;0;56,983333;9,633333
1794;"Nibe";"east";0;0;0;56,983333;9,633333
1795;"Nibe";"east";0;0;0;56,983333;9,633333
1796;"Nibe";"east";0;0;0;56,983333;9,633333
1797;"Nibe";"east";0;0;0;56,983333;9,633333
1798;"Nibe";"east";0;0;0;56,983333;9,633333
1799;"Nibe";"east";0;0;0;56,983333;9,633333
1800;"Nibe";"east";0;0;0;56,983333;9,633333
1801;"Nibe";"east";0;0;0;56,983333;9,633333
1802;"Nibe";"east";0;0;0;56,983333;9,633333
1803;"Nibe";"east";0;0;0;56,983333;9,633333
1804;"Nibe";"east";0;0;0;56,983333;9,633333
1805;"Nibe";"east";0;0;0;56,983333;9,633333
1806;"Nibe";"east";0;0;0;56,983333;9,633333
1807;"Nibe";"east";0;0;0;56,983333;9,633333
1808;"Nibe";"east";0;0;0;56,983333;9,633333
1809;"Nibe";"east";0;0;0;56,983333;9,633333
1810;"Nibe";"east";0;0;0;56,983333;9,633333
1811;"Nibe";"east";0;0;0;56,983333;9,633333
1812;"Nibe";"east";0;0;0;56,983333;9,633333
1813;"Nibe";"east";0;0;0;56,983333;9,633333
1814;"Nibe";"east";0;0;0;56,983333;9,633333
1815;"Nibe";"east";0;0;0;56,983333;9,633333
1816;"Nibe";"east";0;0;0;56,983333;9,633333
1817;"Nibe";"east";0;0;0;56,983333;9,633333
1818;"Nibe";"east";0;0;0;56,983333;9,633333
1819;"Nibe";"east";0;0;0;56,983333;9,633333
1820;"Nibe";"east";0;0;0;56,983333;9,633333
1821;"Nibe";"east";0;0;0;56,983333;9,633333
1822;"Nibe";"east";0;1;1;56,983333;9,633333
1823;"Nibe";"east";0;0;0;56,983333;9,633333
1824;"Nibe";"east";0;1;1;56,983333;9,633333
1825;"Nibe";"east";0;1;1;56,983333;9,633333
1826;"Nibe";"east";0;0;0;56,983333;9,633333
1827;"Nibe";"east";0;0;0;56,983333;9,633333
1828;"Nibe";"east";0;1;1;56,983333;9,633333
1829;"Nibe";"east";0;0;0;56,983333;9,633333
1830;"Nibe";"east";0;0;0;56,983333;9,633333
1831;"Nibe";"east";0;0;0;56,983333;9,633333
1832;"Nibe";"east";0;0;0;56,983333;9,633333
1833;"Nibe";"east";0;0;0;56,983333;9,633333
1834;"Nibe";"east";0;0;0;56,983333;9,633333
1835;"Nibe";"east";0;0;0;56,983333;9,633333
1836;"Nibe";"east";0;0;0;56,983333;9,633333
1837;"Nibe";"east";0;0;0;56,983333;9,633333
1838;"Nibe";"east";0;0;0;56,983333;9,633333
1839;"Nibe";"east";0;0;0;56,983333;9,633333
1840;"Nibe";"east";0;0;0;56,983333;9,633333
1841;"Nibe";"east";1;0;1;56,983333;9,633333
1842;"Nibe";"east";2;0;2;56,983333;9,633333
1843;"Nibe";"east";1;2;3;56,983333;9,633333
1844;"Nibe";"east";0;0;0;56,983333;9,633333
1845;"Nibe";"east";0;0;0;56,983333;9,633333
1846;"Nibe";"east";1;0;1;56,983333;9,633333
1847;"Nibe";"east";2;1;3;56,983333;9,633333
1848;"Nibe";"east";3;1;4;56,983333;9,633333
1849;"Nibe";"east";3;0;3;56,983333;9,633333
1850;"Nibe";"east";2;0;2;56,983333;9,633333
1851;"Nibe";"east";0;1;1;56,983333;9,633333
1852;"Nibe";"east";0;0;0;56,983333;9,633333
1853;"Nibe";"east";1;0;1;56,983333;9,633333
1854;"Nibe";"east";1;1;2;56,983333;9,633333
1855;"Nibe";"east";7;0;7;56,983333;9,633333
1856;"Nibe";"east";2;0;2;56,983333;9,633333
1857;"Nibe";"east";0;0;0;56,983333;9,633333
1634;"Gilleleje";"no";0;0;0;56,121944;12,310555
1635;"Gilleleje";"no";0;0;0;56,121944;12,310555
1636;"Gilleleje";"no";0;0;0;56,121944;12,310555
1637;"Gilleleje";"no";0;0;0;56,121944;12,310555
1638;"Gilleleje";"no";0;0;0;56,121944;12,310555
1639;"Gilleleje";"no";0;0;0;56,121944;12,310555
1640;"Gilleleje";"no";0;0;0;56,121944;12,310555
1641;"Gilleleje";"no";0;0;0;56,121944;12,310555
1642;"Gilleleje";"no";0;0;0;56,121944;12,310555
1643;"Gilleleje";"no";0;0;0;56,121944;12,310555
1644;"Gilleleje";"no";0;0;0;56,121944;12,310555
1645;"Gilleleje";"no";0;0;0;56,121944;12,310555
1646;"Gilleleje";"no";0;0;0;56,121944;12,310555
1647;"Gilleleje";"no";0;0;0;56,121944;12,310555
1648;"Gilleleje";"no";0;0;0;56,121944;12,310555
1649;"Gilleleje";"no";0;0;0;56,121944;12,310555
1650;"Gilleleje";"no";0;0;0;56,121944;12,310555
1651;"Gilleleje";"no";0;0;0;56,121944;12,310555
1652;"Gilleleje";"no";0;0;0;56,121944;12,310555
1653;"Gilleleje";"no";0;0;0;56,121944;12,310555
1654;"Gilleleje";"no";0;0;0;56,121944;12,310555
1655;"Gilleleje";"no";0;0;0;56,121944;12,310555
1656;"Gilleleje";"no";0;0;0;56,121944;12,310555
1657;"Gilleleje";"no";0;0;0;56,121944;12,310555
1658;"Gilleleje";"no";0;0;0;56,121944;12,310555
1659;"Gilleleje";"no";0;0;0;56,121944;12,310555
1660;"Gilleleje";"no";0;0;0;56,121944;12,310555
1661;"Gilleleje";"no";0;0;0;56,121944;12,310555
1662;"Gilleleje";"no";0;0;0;56,121944;12,310555
1663;"Gilleleje";"no";0;0;0;56,121944;12,310555
1664;"Gilleleje";"no";0;0;0;56,121944;12,310555
1665;"Gilleleje";"no";0;0;0;56,121944;12,310555
1666;"Gilleleje";"no";0;0;0;56,121944;12,310555
1667;"Gilleleje";"no";0;0;0;56,121944;12,310555
1668;"Gilleleje";"no";0;0;0;56,121944;12,310555
1669;"Gilleleje";"no";0;0;0;56,121944;12,310555
1670;"Gilleleje";"no";0;0;0;56,121944;12,310555
1671;"Gilleleje";"no";0;0;0;56,121944;12,310555
1672;"Gilleleje";"no";0;0;0;56,121944;12,310555
1673;"Gilleleje";"no";0;0;0;56,121944;12,310555
1674;"Gilleleje";"no";0;0;0;56,121944;12,310555
1675;"Gilleleje";"no";0;0;0;56,121944;12,310555
1676;"Gilleleje";"no";0;0;0;56,121944;12,310555
1677;"Gilleleje";"no";0;0;0;56,121944;12,310555
1678;"Gilleleje";"no";0;0;0;56,121944;12,310555
1679;"Gilleleje";"no";0;0;0;56,121944;12,310555
1680;"Gilleleje";"no";0;0;0;56,121944;12,310555
1681;"Gilleleje";"no";0;0;0;56,121944;12,310555
1682;"Gilleleje";"no";0;0;0;56,121944;12,310555
1683;"Gilleleje";"no";0;0;0;56,121944;12,310555
1684;"Gilleleje";"no";0;0;0;56,121944;12,310555
1685;"Gilleleje";"no";0;0;0;56,121944;12,310555
1686;"Gilleleje";"no";0;0;0;56,121944;12,310555
1687;"Gilleleje";"no";0;0;0;56,121944;12,310555
1688;"Gilleleje";"no";0;0;0;56,121944;12,310555
1689;"Gilleleje";"no";0;0;0;56,121944;12,310555
1690;"Gilleleje";"no";0;0;0;56,121944;12,310555
1691;"Gilleleje";"no";0;0;0;56,121944;12,310555
1692;"Gilleleje";"no";0;0;0;56,121944;12,310555
1693;"Gilleleje";"no";0;0;0;56,121944;12,310555
1694;"Gilleleje";"no";0;0;0;56,121944;12,310555
1695;"Gilleleje";"no";0;0;0;56,121944;12,310555
1696;"Gilleleje";"no";0;0;0;56,121944;12,310555
1697;"Gilleleje";"no";0;0;0;56,121944;12,310555
1698;"Gilleleje";"no";0;0;0;56,121944;12,310555
1699;"Gilleleje";"no";0;0;0;56,121944;12,310555
1700;"Gilleleje";"no";0;0;0;56,121944;12,310555
1701;"Gilleleje";"no";0;0;0;56,121944;12,310555
1702;"Gilleleje";"no";0;0;0;56,121944;12,310555
1703;"Gilleleje";"no";0;0;0;56,121944;12,310555
1704;"Gilleleje";"no";0;0;0;56,121944;12,310555
1705;"Gilleleje";"no";0;0;0;56,121944;12,310555
1706;"Gilleleje";"no";0;0;0;56,121944;12,310555
1707;"Gilleleje";"no";0;0;0;56,121944;12,310555
1708;"Gilleleje";"no";0;0;0;56,121944;12,310555
1709;"Gilleleje";"no";0;0;0;56,121944;12,310555
1710;"Gilleleje";"no";0;0;0;56,121944;12,310555
1711;"Gilleleje";"no";0;0;0;56,121944;12,310555
1712;"Gilleleje";"no";0;0;0;56,121944;12,310555
1713;"Gilleleje";"no";0;0;0;56,121944;12,310555
1714;"Gilleleje";"no";0;0;0;56,121944;12,310555
1715;"Gilleleje";"no";0;0;0;56,121944;12,310555
1716;"Gilleleje";"no";0;0;0;56,121944;12,310555
1717;"Gilleleje";"no";0;0;0;56,121944;12,310555
1718;"Gilleleje";"no";0;0;0;56,121944;12,310555
1719;"Gilleleje";"no";0;0;0;56,121944;12,310555
1720;"Gilleleje";"no";0;0;0;56,121944;12,310555
1721;"Gilleleje";"no";0;0;0;56,121944;12,310555
1722;"Gilleleje";"no";0;0;0;56,121944;12,310555
1723;"Gilleleje";"no";0;0;0;56,121944;12,310555
1724;"Gilleleje";"no";0;0;0;56,121944;12,310555
1725;"Gilleleje";"no";0;0;0;56,121944;12,310555
1726;"Gilleleje";"no";0;0;0;56,121944;12,310555
1727;"Gilleleje";"no";0;0;0;56,121944;12,310555
1728;"Gilleleje";"no";0;0;0;56,121944;12,310555
1729;"Gilleleje";"no";0;0;0;56,121944;12,310555
1730;"Gilleleje";"no";0;0;0;56,121944;12,310555
1731;"Gilleleje";"no";0;0;0;56,121944;12,310555
1732;"Gilleleje";"no";0;0;0;56,121944;12,310555
1733;"Gilleleje";"no";0;0;0;56,121944;12,310555
1734;"Gilleleje";"no";0;0;0;56,121944;12,310555
1735;"Gilleleje";"no";0;0;0;56,121944;12,310555
1736;"Gilleleje";"no";0;0;0;56,121944;12,310555
1737;"Gilleleje";"no";0;0;0;56,121944;12,310555
1738;"Gilleleje";"no";0;0;0;56,121944;12,310555
1739;"Gilleleje";"no";0;0;0;56,121944;12,310555
1740;"Gilleleje";"no";0;0;0;56,121944;12,310555
1741;"Gilleleje";"no";0;0;0;56,121944;12,310555
1742;"Gilleleje";"no";0;0;0;56,121944;12,310555
1743;"Gilleleje";"no";0;0;0;56,121944;12,310555
1744;"Gilleleje";"no";0;0;0;56,121944;12,310555
1745;"Gilleleje";"no";0;0;0;56,121944;12,310555
1746;"Gilleleje";"no";0;0;0;56,121944;12,310555
1747;"Gilleleje";"no";0;0;0;56,121944;12,310555
1748;"Gilleleje";"no";0;0;0;56,121944;12,310555
1749;"Gilleleje";"no";0;0;0;56,121944;12,310555
1750;"Gilleleje";"no";0;0;0;56,121944;12,310555
1751;"Gilleleje";"no";0;0;0;56,121944;12,310555
1752;"Gilleleje";"no";0;0;0;56,121944;12,310555
1753;"Gilleleje";"no";0;0;0;56,121944;12,310555
1754;"Gilleleje";"no";0;0;0;56,121944;12,310555
1755;"Gilleleje";"no";0;0;0;56,121944;12,310555
1756;"Gilleleje";"no";0;0;0;56,121944;12,310555
1757;"Gilleleje";"no";0;0;0;56,121944;12,310555
1758;"Gilleleje";"no";0;0;0;56,121944;12,310555
1759;"Gilleleje";"no";0;0;0;56,121944;12,310555
1760;"Gilleleje";"no";0;0;0;56,121944;12,310555
1761;"Gilleleje";"no";0;0;0;56,121944;12,310555
1762;"Gilleleje";"no";0;0;0;56,121944;12,310555
1763;"Gilleleje";"no";0;0;0;56,121944;12,310555
1764;"Gilleleje";"no";0;0;0;56,121944;12,310555
1765;"Gilleleje";"no";0;0;0;56,121944;12,310555
1766;"Gilleleje";"no";0;0;0;56,121944;12,310555
1767;"Gilleleje";"no";0;0;0;56,121944;12,310555
1768;"Gilleleje";"no";0;0;0;56,121944;12,310555
1769;"Gilleleje";"no";0;0;0;56,121944;12,310555
1770;"Gilleleje";"no";0;0;0;56,121944;12,310555
1771;"Gilleleje";"no";0;0;0;56,121944;12,310555
1772;"Gilleleje";"no";0;0;0;56,121944;12,310555
1773;"Gilleleje";"no";0;0;0;56,121944;12,310555
1774;"Gilleleje";"no";0;0;0;56,121944;12,310555
1775;"Gilleleje";"no";0;0;0;56,121944;12,310555
1776;"Gilleleje";"no";0;0;0;56,121944;12,310555
1777;"Gilleleje";"no";0;0;0;56,121944;12,310555
1778;"Gilleleje";"no";0;0;0;56,121944;12,310555
1779;"Gilleleje";"no";0;0;0;56,121944;12,310555
1780;"Gilleleje";"no";0;0;0;56,121944;12,310555
1781;"Gilleleje";"no";0;0;0;56,121944;12,310555
1782;"Gilleleje";"no";0;0;0;56,121944;12,310555
1783;"Gilleleje";"no";0;0;0;56,121944;12,310555
1784;"Gilleleje";"no";0;0;0;56,121944;12,310555
1785;"Gilleleje";"no";0;0;0;56,121944;12,310555
1786;"Gilleleje";"no";0;0;0;56,121944;12,310555
1787;"Gilleleje";"no";0;0;0;56,121944;12,310555
1788;"Gilleleje";"no";0;0;0;56,121944;12,310555
1789;"Gilleleje";"no";0;0;0;56,121944;12,310555
1790;"Gilleleje";"no";0;0;0;56,121944;12,310555
1791;"Gilleleje";"no";0;0;0;56,121944;12,310555
1792;"Gilleleje";"no";0;0;0;56,121944;12,310555
1793;"Gilleleje";"no";0;0;0;56,121944;12,310555
1794;"Gilleleje";"no";0;0;0;56,121944;12,310555
1795;"Gilleleje";"no";0;0;0;56,121944;12,310555
1796;"Gilleleje";"no";0;0;0;56,121944;12,310555
1797;"Gilleleje";"no";0;0;0;56,121944;12,310555
1798;"Gilleleje";"no";0;0;0;56,121944;12,310555
1799;"Gilleleje";"no";0;0;0;56,121944;12,310555
1800;"Gilleleje";"no";0;0;0;56,121944;12,310555
1801;"Gilleleje";"no";0;0;0;56,121944;12,310555
1802;"Gilleleje";"no";0;0;0;56,121944;12,310555
1803;"Gilleleje";"no";0;0;0;56,121944;12,310555
1804;"Gilleleje";"no";0;0;0;56,121944;12,310555
1805;"Gilleleje";"no";0;0;0;56,121944;12,310555
1806;"Gilleleje";"no";0;0;0;56,121944;12,310555
1807;"Gilleleje";"no";0;0;0;56,121944;12,310555
1808;"Gilleleje";"no";0;0;0;56,121944;12,310555
1809;"Gilleleje";"no";0;0;0;56,121944;12,310555
1810;"Gilleleje";"no";0;0;0;56,121944;12,310555
1811;"Gilleleje";"no";0;0;0;56,121944;12,310555
1812;"Gilleleje";"no";0;0;0;56,121944;12,310555
1813;"Gilleleje";"no";0;0;0;56,121944;12,310555
1814;"Gilleleje";"no";0;0;0;56,121944;12,310555
1815;"Gilleleje";"no";0;0;0;56,121944;12,310555
1816;"Gilleleje";"no";0;0;0;56,121944;12,310555
1817;"Gilleleje";"no";0;0;0;56,121944;12,310555
1818;"Gilleleje";"no";0;0;0;56,121944;12,310555
1819;"Gilleleje";"no";0;0;0;56,121944;12,310555
1820;"Gilleleje";"no";0;0;0;56,121944;12,310555
1821;"Gilleleje";"no";0;0;0;56,121944;12,310555
1822;"Gilleleje";"no";0;0;0;56,121944;12,310555
1823;"Gilleleje";"no";0;0;0;56,121944;12,310555
1824;"Gilleleje";"no";0;0;0;56,121944;12,310555
1825;"Gilleleje";"no";0;0;0;56,121944;12,310555
1826;"Gilleleje";"no";0;0;0;56,121944;12,310555
1827;"Gilleleje";"no";0;0;0;56,121944;12,310555
1828;"Gilleleje";"no";0;0;0;56,121944;12,310555
1829;"Gilleleje";"no";0;0;0;56,121944;12,310555
1830;"Gilleleje";"no";0;0;0;56,121944;12,310555
1831;"Gilleleje";"no";0;0;0;56,121944;12,310555
1832;"Gilleleje";"no";0;0;0;56,121944;12,310555
1833;"Gilleleje";"no";0;0;0;56,121944;12,310555
1834;"Gilleleje";"no";0;0;0;56,121944;12,310555
1835;"Gilleleje";"no";0;0;0;56,121944;12,310555
1836;"Gilleleje";"no";0;0;0;56,121944;12,310555
1837;"Gilleleje";"no";0;0;0;56,121944;12,310555
1838;"Gilleleje";"no";0;0;0;56,121944;12,310555
1839;"Gilleleje";"no";0;0;0;56,121944;12,310555
1840;"Gilleleje";"no";0;0;0;56,121944;12,310555
1841;"Gilleleje";"no";0;0;0;56,121944;12,310555
1842;"Gilleleje";"no";1;1;2;56,121944;12,310555
1843;"Gilleleje";"no";0;0;0;56,121944;12,310555
1844;"Gilleleje";"no";0;0;0;56,121944;12,310555
1845;"Gilleleje";"no";1;0;1;56,121944;12,310555
1846;"Gilleleje";"no";0;1;1;56,121944;12,310555
1847;"Gilleleje";"no";0;0;0;56,121944;12,310555
1848;"Gilleleje";"no";0;0;0;56,121944;12,310555
1849;"Gilleleje";"no";0;2;2;56,121944;12,310555
1850;"Gilleleje";"no";0;0;0;56,121944;12,310555
1851;"Gilleleje";"no";0;0;0;56,121944;12,310555
1852;"Gilleleje";"no";0;0;0;56,121944;12,310555
1853;"Gilleleje";"no";0;1;1;56,121944;12,310555
1854;"Gilleleje";"no";0;2;2;56,121944;12,310555
1855;"Gilleleje";"no";0;0;0;56,121944;12,310555
1856;"Gilleleje";"no";0;0;0;56,121944;12,310555
1857;"Gilleleje";"no";0;0;0;56,121944;12,310555
1634;"Holstebro";"no";0;0;0;56,36;8,615833
1635;"Holstebro";"no";0;0;0;56,36;8,615833
1636;"Holstebro";"no";0;0;0;56,36;8,615833
1637;"Holstebro";"no";0;0;0;56,36;8,615833
1638;"Holstebro";"no";0;0;0;56,36;8,615833
1639;"Holstebro";"no";0;0;0;56,36;8,615833
1640;"Holstebro";"no";0;0;0;56,36;8,615833
1641;"Holstebro";"no";0;0;0;56,36;8,615833
1642;"Holstebro";"no";0;0;0;56,36;8,615833
1643;"Holstebro";"no";0;0;0;56,36;8,615833
1644;"Holstebro";"no";0;0;0;56,36;8,615833
1645;"Holstebro";"no";0;0;0;56,36;8,615833
1646;"Holstebro";"no";0;0;0;56,36;8,615833
1647;"Holstebro";"no";0;0;0;56,36;8,615833
1648;"Holstebro";"no";0;0;0;56,36;8,615833
1649;"Holstebro";"no";0;0;0;56,36;8,615833
1650;"Holstebro";"no";0;0;0;56,36;8,615833
1651;"Holstebro";"no";0;0;0;56,36;8,615833
1652;"Holstebro";"no";0;0;0;56,36;8,615833
1653;"Holstebro";"no";0;0;0;56,36;8,615833
1654;"Holstebro";"no";0;0;0;56,36;8,615833
1655;"Holstebro";"no";0;0;0;56,36;8,615833
1656;"Holstebro";"no";0;0;0;56,36;8,615833
1657;"Holstebro";"no";0;0;0;56,36;8,615833
1658;"Holstebro";"no";0;0;0;56,36;8,615833
1659;"Holstebro";"no";0;0;0;56,36;8,615833
1660;"Holstebro";"no";0;0;0;56,36;8,615833
1661;"Holstebro";"no";0;0;0;56,36;8,615833
1662;"Holstebro";"no";0;0;0;56,36;8,615833
1663;"Holstebro";"no";0;0;0;56,36;8,615833
1664;"Holstebro";"no";0;0;0;56,36;8,615833
1665;"Holstebro";"no";0;0;0;56,36;8,615833
1666;"Holstebro";"no";0;0;0;56,36;8,615833
1667;"Holstebro";"no";0;0;0;56,36;8,615833
1668;"Holstebro";"no";0;0;0;56,36;8,615833
1669;"Holstebro";"no";0;0;0;56,36;8,615833
1670;"Holstebro";"no";0;0;0;56,36;8,615833
1671;"Holstebro";"no";0;0;0;56,36;8,615833
1672;"Holstebro";"no";0;0;0;56,36;8,615833
1673;"Holstebro";"no";0;0;0;56,36;8,615833
1674;"Holstebro";"no";0;0;0;56,36;8,615833
1675;"Holstebro";"no";0;0;0;56,36;8,615833
1676;"Holstebro";"no";0;0;0;56,36;8,615833
1677;"Holstebro";"no";0;0;0;56,36;8,615833
1678;"Holstebro";"no";0;0;0;56,36;8,615833
1679;"Holstebro";"no";0;0;0;56,36;8,615833
1680;"Holstebro";"no";0;0;0;56,36;8,615833
1681;"Holstebro";"no";0;0;0;56,36;8,615833
1682;"Holstebro";"no";0;0;0;56,36;8,615833
1683;"Holstebro";"no";0;0;0;56,36;8,615833
1684;"Holstebro";"no";0;0;0;56,36;8,615833
1685;"Holstebro";"no";0;0;0;56,36;8,615833
1686;"Holstebro";"no";0;0;0;56,36;8,615833
1687;"Holstebro";"no";0;0;0;56,36;8,615833
1688;"Holstebro";"no";0;0;0;56,36;8,615833
1689;"Holstebro";"no";0;0;0;56,36;8,615833
1690;"Holstebro";"no";0;0;0;56,36;8,615833
1691;"Holstebro";"no";0;0;0;56,36;8,615833
1692;"Holstebro";"no";0;0;0;56,36;8,615833
1693;"Holstebro";"no";0;0;0;56,36;8,615833
1694;"Holstebro";"no";0;0;0;56,36;8,615833
1695;"Holstebro";"no";0;0;0;56,36;8,615833
1696;"Holstebro";"no";0;0;0;56,36;8,615833
1697;"Holstebro";"no";0;0;0;56,36;8,615833
1698;"Holstebro";"no";0;0;0;56,36;8,615833
1699;"Holstebro";"no";0;0;0;56,36;8,615833
1700;"Holstebro";"no";0;0;0;56,36;8,615833
1701;"Holstebro";"no";0;0;0;56,36;8,615833
1702;"Holstebro";"no";0;0;0;56,36;8,615833
1703;"Holstebro";"no";0;0;0;56,36;8,615833
1704;"Holstebro";"no";0;0;0;56,36;8,615833
1705;"Holstebro";"no";0;0;0;56,36;8,615833
1706;"Holstebro";"no";0;0;0;56,36;8,615833
1707;"Holstebro";"no";0;0;0;56,36;8,615833
1708;"Holstebro";"no";0;0;0;56,36;8,615833
1709;"Holstebro";"no";0;0;0;56,36;8,615833
1710;"Holstebro";"no";0;0;0;56,36;8,615833
1711;"Holstebro";"no";0;0;0;56,36;8,615833
1712;"Holstebro";"no";0;0;0;56,36;8,615833
1713;"Holstebro";"no";0;0;0;56,36;8,615833
1714;"Holstebro";"no";0;0;0;56,36;8,615833
1715;"Holstebro";"no";0;0;0;56,36;8,615833
1716;"Holstebro";"no";0;0;0;56,36;8,615833
1717;"Holstebro";"no";0;0;0;56,36;8,615833
1718;"Holstebro";"no";0;0;0;56,36;8,615833
1719;"Holstebro";"no";0;0;0;56,36;8,615833
1720;"Holstebro";"no";0;0;0;56,36;8,615833
1721;"Holstebro";"no";0;0;0;56,36;8,615833
1722;"Holstebro";"no";0;0;0;56,36;8,615833
1723;"Holstebro";"no";0;0;0;56,36;8,615833
1724;"Holstebro";"no";0;0;0;56,36;8,615833
1725;"Holstebro";"no";0;0;0;56,36;8,615833
1726;"Holstebro";"no";0;0;0;56,36;8,615833
1727;"Holstebro";"no";0;0;0;56,36;8,615833
1728;"Holstebro";"no";0;0;0;56,36;8,615833
1729;"Holstebro";"no";0;0;0;56,36;8,615833
1730;"Holstebro";"no";0;0;0;56,36;8,615833
1731;"Holstebro";"no";0;0;0;56,36;8,615833
1732;"Holstebro";"no";0;0;0;56,36;8,615833
1733;"Holstebro";"no";0;0;0;56,36;8,615833
1734;"Holstebro";"no";0;0;0;56,36;8,615833
1735;"Holstebro";"no";0;0;0;56,36;8,615833
1736;"Holstebro";"no";0;0;0;56,36;8,615833
1737;"Holstebro";"no";0;0;0;56,36;8,615833
1738;"Holstebro";"no";0;0;0;56,36;8,615833
1739;"Holstebro";"no";0;0;0;56,36;8,615833
1740;"Holstebro";"no";0;0;0;56,36;8,615833
1741;"Holstebro";"no";0;0;0;56,36;8,615833
1742;"Holstebro";"no";0;0;0;56,36;8,615833
1743;"Holstebro";"no";0;0;0;56,36;8,615833
1744;"Holstebro";"no";0;0;0;56,36;8,615833
1745;"Holstebro";"no";0;0;0;56,36;8,615833
1746;"Holstebro";"no";0;0;0;56,36;8,615833
1747;"Holstebro";"no";0;0;0;56,36;8,615833
1748;"Holstebro";"no";0;0;0;56,36;8,615833
1749;"Holstebro";"no";0;0;0;56,36;8,615833
1750;"Holstebro";"no";0;0;0;56,36;8,615833
1751;"Holstebro";"no";0;0;0;56,36;8,615833
1752;"Holstebro";"no";0;0;0;56,36;8,615833
1753;"Holstebro";"no";0;0;0;56,36;8,615833
1754;"Holstebro";"no";0;0;0;56,36;8,615833
1755;"Holstebro";"no";0;0;0;56,36;8,615833
1756;"Holstebro";"no";0;0;0;56,36;8,615833
1757;"Holstebro";"no";0;0;0;56,36;8,615833
1758;"Holstebro";"no";0;0;0;56,36;8,615833
1759;"Holstebro";"no";0;0;0;56,36;8,615833
1760;"Holstebro";"no";0;0;0;56,36;8,615833
1761;"Holstebro";"no";0;0;0;56,36;8,615833
1762;"Holstebro";"no";0;0;0;56,36;8,615833
1763;"Holstebro";"no";0;0;0;56,36;8,615833
1764;"Holstebro";"no";0;0;0;56,36;8,615833
1765;"Holstebro";"no";0;0;0;56,36;8,615833
1766;"Holstebro";"no";0;0;0;56,36;8,615833
1767;"Holstebro";"no";0;0;0;56,36;8,615833
1768;"Holstebro";"no";0;0;0;56,36;8,615833
1769;"Holstebro";"no";0;0;0;56,36;8,615833
1770;"Holstebro";"no";0;0;0;56,36;8,615833
1771;"Holstebro";"no";0;0;0;56,36;8,615833
1772;"Holstebro";"no";0;0;0;56,36;8,615833
1773;"Holstebro";"no";0;0;0;56,36;8,615833
1774;"Holstebro";"no";0;0;0;56,36;8,615833
1775;"Holstebro";"no";0;0;0;56,36;8,615833
1776;"Holstebro";"no";0;0;0;56,36;8,615833
1777;"Holstebro";"no";0;0;0;56,36;8,615833
1778;"Holstebro";"no";0;0;0;56,36;8,615833
1779;"Holstebro";"no";0;0;0;56,36;8,615833
1780;"Holstebro";"no";0;0;0;56,36;8,615833
1781;"Holstebro";"no";0;0;0;56,36;8,615833
1782;"Holstebro";"no";0;0;0;56,36;8,615833
1783;"Holstebro";"no";0;0;0;56,36;8,615833
1784;"Holstebro";"no";0;0;0;56,36;8,615833
1785;"Holstebro";"no";0;0;0;56,36;8,615833
1786;"Holstebro";"no";0;0;0;56,36;8,615833
1787;"Holstebro";"no";0;0;0;56,36;8,615833
1788;"Holstebro";"no";0;0;0;56,36;8,615833
1789;"Holstebro";"no";0;0;0;56,36;8,615833
1790;"Holstebro";"no";0;0;0;56,36;8,615833
1791;"Holstebro";"no";0;0;0;56,36;8,615833
1792;"Holstebro";"no";0;0;0;56,36;8,615833
1793;"Holstebro";"no";0;0;0;56,36;8,615833
1794;"Holstebro";"no";0;0;0;56,36;8,615833
1795;"Holstebro";"no";0;0;0;56,36;8,615833
1796;"Holstebro";"no";0;0;0;56,36;8,615833
1797;"Holstebro";"no";0;0;0;56,36;8,615833
1798;"Holstebro";"no";0;0;0;56,36;8,615833
1799;"Holstebro";"no";0;0;0;56,36;8,615833
1800;"Holstebro";"no";0;0;0;56,36;8,615833
1801;"Holstebro";"no";0;0;0;56,36;8,615833
1802;"Holstebro";"no";0;0;0;56,36;8,615833
1803;"Holstebro";"no";0;0;0;56,36;8,615833
1804;"Holstebro";"no";0;0;0;56,36;8,615833
1805;"Holstebro";"no";0;0;0;56,36;8,615833
1806;"Holstebro";"no";0;0;0;56,36;8,615833
1807;"Holstebro";"no";0;0;0;56,36;8,615833
1808;"Holstebro";"no";0;0;0;56,36;8,615833
1809;"Holstebro";"no";0;0;0;56,36;8,615833
1810;"Holstebro";"no";0;0;0;56,36;8,615833
1811;"Holstebro";"no";0;0;0;56,36;8,615833
1812;"Holstebro";"no";0;0;0;56,36;8,615833
1813;"Holstebro";"no";0;0;0;56,36;8,615833
1814;"Holstebro";"no";0;0;0;56,36;8,615833
1815;"Holstebro";"no";0;0;0;56,36;8,615833
1816;"Holstebro";"no";0;0;0;56,36;8,615833
1817;"Holstebro";"no";0;0;0;56,36;8,615833
1818;"Holstebro";"no";0;0;0;56,36;8,615833
1819;"Holstebro";"no";0;0;0;56,36;8,615833
1820;"Holstebro";"no";0;0;0;56,36;8,615833
1821;"Holstebro";"no";0;0;0;56,36;8,615833
1822;"Holstebro";"no";0;0;0;56,36;8,615833
1823;"Holstebro";"no";0;0;0;56,36;8,615833
1824;"Holstebro";"no";0;0;0;56,36;8,615833
1825;"Holstebro";"no";0;0;0;56,36;8,615833
1826;"Holstebro";"no";0;0;0;56,36;8,615833
1827;"Holstebro";"no";0;0;0;56,36;8,615833
1828;"Holstebro";"no";0;0;0;56,36;8,615833
1829;"Holstebro";"no";0;0;0;56,36;8,615833
1830;"Holstebro";"no";0;0;0;56,36;8,615833
1831;"Holstebro";"no";0;0;0;56,36;8,615833
1832;"Holstebro";"no";0;0;0;56,36;8,615833
1833;"Holstebro";"no";0;0;0;56,36;8,615833
1834;"Holstebro";"no";0;0;0;56,36;8,615833
1835;"Holstebro";"no";0;0;0;56,36;8,615833
1836;"Holstebro";"no";0;0;0;56,36;8,615833
1837;"Holstebro";"no";0;0;0;56,36;8,615833
1838;"Holstebro";"no";0;0;0;56,36;8,615833
1839;"Holstebro";"no";0;0;0;56,36;8,615833
1840;"Holstebro";"no";0;0;0;56,36;8,615833
1841;"Holstebro";"no";0;0;0;56,36;8,615833
1842;"Holstebro";"no";2;0;2;56,36;8,615833
1843;"Holstebro";"no";3;2;5;56,36;8,615833
1844;"Holstebro";"no";0;0;0;56,36;8,615833
1845;"Holstebro";"no";0;1;1;56,36;8,615833
1846;"Holstebro";"no";0;1;1;56,36;8,615833
1847;"Holstebro";"no";2;0;2;56,36;8,615833
1848;"Holstebro";"no";2;0;2;56,36;8,615833
1849;"Holstebro";"no";2;1;3;56,36;8,615833
1850;"Holstebro";"no";6;0;6;56,36;8,615833
1851;"Holstebro";"no";3;1;4;56,36;8,615833
1852;"Holstebro";"no";4;0;4;56,36;8,615833
1853;"Holstebro";"no";1;3;4;56,36;8,615833
1854;"Holstebro";"no";3;2;5;56,36;8,615833
1855;"Holstebro";"no";6;4;10;56,36;8,615833
1856;"Holstebro";"no";2;0;2;56,36;8,615833
1857;"Holstebro";"no";0;0;0;56,36;8,615833
1634;"Løgstør";"middle";0;0;0;56,966666;9,25
1635;"Løgstør";"middle";0;0;0;56,966666;9,25
1636;"Løgstør";"middle";0;0;0;56,966666;9,25
1637;"Løgstør";"middle";0;0;0;56,966666;9,25
1638;"Løgstør";"middle";0;0;0;56,966666;9,25
1639;"Løgstør";"middle";0;0;0;56,966666;9,25
1640;"Løgstør";"middle";0;0;0;56,966666;9,25
1641;"Løgstør";"middle";0;0;0;56,966666;9,25
1642;"Løgstør";"middle";0;0;0;56,966666;9,25
1643;"Løgstør";"middle";0;0;0;56,966666;9,25
1644;"Løgstør";"middle";0;0;0;56,966666;9,25
1645;"Løgstør";"middle";0;0;0;56,966666;9,25
1646;"Løgstør";"middle";0;0;0;56,966666;9,25
1647;"Løgstør";"middle";0;0;0;56,966666;9,25
1648;"Løgstør";"middle";0;0;0;56,966666;9,25
1649;"Løgstør";"middle";0;0;0;56,966666;9,25
1650;"Løgstør";"middle";0;0;0;56,966666;9,25
1651;"Løgstør";"middle";0;0;0;56,966666;9,25
1652;"Løgstør";"middle";0;0;0;56,966666;9,25
1653;"Løgstør";"middle";0;0;0;56,966666;9,25
1654;"Løgstør";"middle";0;0;0;56,966666;9,25
1655;"Løgstør";"middle";0;0;0;56,966666;9,25
1656;"Løgstør";"middle";0;0;0;56,966666;9,25
1657;"Løgstør";"middle";0;0;0;56,966666;9,25
1658;"Løgstør";"middle";0;0;0;56,966666;9,25
1659;"Løgstør";"middle";0;0;0;56,966666;9,25
1660;"Løgstør";"middle";0;0;0;56,966666;9,25
1661;"Løgstør";"middle";0;0;0;56,966666;9,25
1662;"Løgstør";"middle";0;0;0;56,966666;9,25
1663;"Løgstør";"middle";0;0;0;56,966666;9,25
1664;"Løgstør";"middle";0;0;0;56,966666;9,25
1665;"Løgstør";"middle";0;0;0;56,966666;9,25
1666;"Løgstør";"middle";0;0;0;56,966666;9,25
1667;"Løgstør";"middle";0;0;0;56,966666;9,25
1668;"Løgstør";"middle";0;0;0;56,966666;9,25
1669;"Løgstør";"middle";0;0;0;56,966666;9,25
1670;"Løgstør";"middle";0;0;0;56,966666;9,25
1671;"Løgstør";"middle";0;0;0;56,966666;9,25
1672;"Løgstør";"middle";0;0;0;56,966666;9,25
1673;"Løgstør";"middle";0;0;0;56,966666;9,25
1674;"Løgstør";"middle";0;0;0;56,966666;9,25
1675;"Løgstør";"middle";0;0;0;56,966666;9,25
1676;"Løgstør";"middle";0;0;0;56,966666;9,25
1677;"Løgstør";"middle";0;0;0;56,966666;9,25
1678;"Løgstør";"middle";0;0;0;56,966666;9,25
1679;"Løgstør";"middle";0;0;0;56,966666;9,25
1680;"Løgstør";"middle";0;0;0;56,966666;9,25
1681;"Løgstør";"middle";0;0;0;56,966666;9,25
1682;"Løgstør";"middle";0;0;0;56,966666;9,25
1683;"Løgstør";"middle";0;0;0;56,966666;9,25
1684;"Løgstør";"middle";0;0;0;56,966666;9,25
1685;"Løgstør";"middle";0;0;0;56,966666;9,25
1686;"Løgstør";"middle";0;0;0;56,966666;9,25
1687;"Løgstør";"middle";0;0;0;56,966666;9,25
1688;"Løgstør";"middle";0;0;0;56,966666;9,25
1689;"Løgstør";"middle";0;0;0;56,966666;9,25
1690;"Løgstør";"middle";0;0;0;56,966666;9,25
1691;"Løgstør";"middle";0;0;0;56,966666;9,25
1692;"Løgstør";"middle";0;0;0;56,966666;9,25
1693;"Løgstør";"middle";0;0;0;56,966666;9,25
1694;"Løgstør";"middle";0;0;0;56,966666;9,25
1695;"Løgstør";"middle";0;0;0;56,966666;9,25
1696;"Løgstør";"middle";0;0;0;56,966666;9,25
1697;"Løgstør";"middle";0;0;0;56,966666;9,25
1698;"Løgstør";"middle";0;0;0;56,966666;9,25
1699;"Løgstør";"middle";0;0;0;56,966666;9,25
1700;"Løgstør";"middle";0;0;0;56,966666;9,25
1701;"Løgstør";"middle";0;0;0;56,966666;9,25
1702;"Løgstør";"middle";0;0;0;56,966666;9,25
1703;"Løgstør";"middle";0;0;0;56,966666;9,25
1704;"Løgstør";"middle";0;0;0;56,966666;9,25
1705;"Løgstør";"middle";0;0;0;56,966666;9,25
1706;"Løgstør";"middle";0;0;0;56,966666;9,25
1707;"Løgstør";"middle";0;0;0;56,966666;9,25
1708;"Løgstør";"middle";0;0;0;56,966666;9,25
1709;"Løgstør";"middle";0;0;0;56,966666;9,25
1710;"Løgstør";"middle";0;0;0;56,966666;9,25
1711;"Løgstør";"middle";0;0;0;56,966666;9,25
1712;"Løgstør";"middle";0;0;0;56,966666;9,25
1713;"Løgstør";"middle";0;0;0;56,966666;9,25
1714;"Løgstør";"middle";0;0;0;56,966666;9,25
1715;"Løgstør";"middle";0;0;0;56,966666;9,25
1716;"Løgstør";"middle";0;0;0;56,966666;9,25
1717;"Løgstør";"middle";0;0;0;56,966666;9,25
1718;"Løgstør";"middle";0;0;0;56,966666;9,25
1719;"Løgstør";"middle";0;0;0;56,966666;9,25
1720;"Løgstør";"middle";0;0;0;56,966666;9,25
1721;"Løgstør";"middle";0;0;0;56,966666;9,25
1722;"Løgstør";"middle";0;0;0;56,966666;9,25
1723;"Løgstør";"middle";0;0;0;56,966666;9,25
1724;"Løgstør";"middle";0;0;0;56,966666;9,25
1725;"Løgstør";"middle";0;0;0;56,966666;9,25
1726;"Løgstør";"middle";0;0;0;56,966666;9,25
1727;"Løgstør";"middle";0;0;0;56,966666;9,25
1728;"Løgstør";"middle";0;0;0;56,966666;9,25
1729;"Løgstør";"middle";0;0;0;56,966666;9,25
1730;"Løgstør";"middle";0;0;0;56,966666;9,25
1731;"Løgstør";"middle";0;0;0;56,966666;9,25
1732;"Løgstør";"middle";0;0;0;56,966666;9,25
1733;"Løgstør";"middle";0;0;0;56,966666;9,25
1734;"Løgstør";"middle";0;0;0;56,966666;9,25
1735;"Løgstør";"middle";0;0;0;56,966666;9,25
1736;"Løgstør";"middle";0;0;0;56,966666;9,25
1737;"Løgstør";"middle";0;0;0;56,966666;9,25
1738;"Løgstør";"middle";0;0;0;56,966666;9,25
1739;"Løgstør";"middle";0;0;0;56,966666;9,25
1740;"Løgstør";"middle";0;0;0;56,966666;9,25
1741;"Løgstør";"middle";0;0;0;56,966666;9,25
1742;"Løgstør";"middle";0;0;0;56,966666;9,25
1743;"Løgstør";"middle";0;0;0;56,966666;9,25
1744;"Løgstør";"middle";0;0;0;56,966666;9,25
1745;"Løgstør";"middle";0;0;0;56,966666;9,25
1746;"Løgstør";"middle";0;0;0;56,966666;9,25
1747;"Løgstør";"middle";0;0;0;56,966666;9,25
1748;"Løgstør";"middle";0;0;0;56,966666;9,25
1749;"Løgstør";"middle";0;0;0;56,966666;9,25
1750;"Løgstør";"middle";0;0;0;56,966666;9,25
1751;"Løgstør";"middle";0;0;0;56,966666;9,25
1752;"Løgstør";"middle";0;0;0;56,966666;9,25
1753;"Løgstør";"middle";0;0;0;56,966666;9,25
1754;"Løgstør";"middle";0;0;0;56,966666;9,25
1755;"Løgstør";"middle";0;0;0;56,966666;9,25
1756;"Løgstør";"middle";0;0;0;56,966666;9,25
1757;"Løgstør";"middle";0;0;0;56,966666;9,25
1758;"Løgstør";"middle";0;0;0;56,966666;9,25
1759;"Løgstør";"middle";0;0;0;56,966666;9,25
1760;"Løgstør";"middle";0;0;0;56,966666;9,25
1761;"Løgstør";"middle";0;0;0;56,966666;9,25
1762;"Løgstør";"middle";0;0;0;56,966666;9,25
1763;"Løgstør";"middle";0;0;0;56,966666;9,25
1764;"Løgstør";"middle";0;0;0;56,966666;9,25
1765;"Løgstør";"middle";0;0;0;56,966666;9,25
1766;"Løgstør";"middle";0;0;0;56,966666;9,25
1767;"Løgstør";"middle";0;0;0;56,966666;9,25
1768;"Løgstør";"middle";0;0;0;56,966666;9,25
1769;"Løgstør";"middle";0;0;0;56,966666;9,25
1770;"Løgstør";"middle";0;0;0;56,966666;9,25
1771;"Løgstør";"middle";0;0;0;56,966666;9,25
1772;"Løgstør";"middle";0;0;0;56,966666;9,25
1773;"Løgstør";"middle";0;0;0;56,966666;9,25
1774;"Løgstør";"middle";0;0;0;56,966666;9,25
1775;"Løgstør";"middle";0;0;0;56,966666;9,25
1776;"Løgstør";"middle";0;0;0;56,966666;9,25
1777;"Løgstør";"middle";0;0;0;56,966666;9,25
1778;"Løgstør";"middle";0;0;0;56,966666;9,25
1779;"Løgstør";"middle";0;0;0;56,966666;9,25
1780;"Løgstør";"middle";0;0;0;56,966666;9,25
1781;"Løgstør";"middle";0;0;0;56,966666;9,25
1782;"Løgstør";"middle";0;0;0;56,966666;9,25
1783;"Løgstør";"middle";0;0;0;56,966666;9,25
1784;"Løgstør";"middle";0;0;0;56,966666;9,25
1785;"Løgstør";"middle";0;0;0;56,966666;9,25
1786;"Løgstør";"middle";0;0;0;56,966666;9,25
1787;"Løgstør";"middle";0;0;0;56,966666;9,25
1788;"Løgstør";"middle";0;0;0;56,966666;9,25
1789;"Løgstør";"middle";0;0;0;56,966666;9,25
1790;"Løgstør";"middle";0;0;0;56,966666;9,25
1791;"Løgstør";"middle";0;0;0;56,966666;9,25
1792;"Løgstør";"middle";0;0;0;56,966666;9,25
1793;"Løgstør";"middle";0;0;0;56,966666;9,25
1794;"Løgstør";"middle";0;0;0;56,966666;9,25
1795;"Løgstør";"middle";0;0;0;56,966666;9,25
1796;"Løgstør";"middle";0;0;0;56,966666;9,25
1797;"Løgstør";"middle";0;0;0;56,966666;9,25
1798;"Løgstør";"middle";0;0;0;56,966666;9,25
1799;"Løgstør";"middle";0;0;0;56,966666;9,25
1800;"Løgstør";"middle";0;0;0;56,966666;9,25
1801;"Løgstør";"middle";0;0;0;56,966666;9,25
1802;"Løgstør";"middle";0;0;0;56,966666;9,25
1803;"Løgstør";"middle";0;0;0;56,966666;9,25
1804;"Løgstør";"middle";0;0;0;56,966666;9,25
1805;"Løgstør";"middle";0;0;0;56,966666;9,25
1806;"Løgstør";"middle";0;0;0;56,966666;9,25
1807;"Løgstør";"middle";0;0;0;56,966666;9,25
1808;"Løgstør";"middle";0;0;0;56,966666;9,25
1809;"Løgstør";"middle";0;0;0;56,966666;9,25
1810;"Løgstør";"middle";0;0;0;56,966666;9,25
1811;"Løgstør";"middle";0;0;0;56,966666;9,25
1812;"Løgstør";"middle";0;0;0;56,966666;9,25
1813;"Løgstør";"middle";0;0;0;56,966666;9,25
1814;"Løgstør";"middle";0;0;0;56,966666;9,25
1815;"Løgstør";"middle";0;0;0;56,966666;9,25
1816;"Løgstør";"middle";0;0;0;56,966666;9,25
1817;"Løgstør";"middle";0;0;0;56,966666;9,25
1818;"Løgstør";"middle";0;0;0;56,966666;9,25
1819;"Løgstør";"middle";0;0;0;56,966666;9,25
1820;"Løgstør";"middle";0;0;0;56,966666;9,25
1821;"Løgstør";"middle";0;0;0;56,966666;9,25
1822;"Løgstør";"middle";0;0;0;56,966666;9,25
1823;"Løgstør";"middle";0;0;0;56,966666;9,25
1824;"Løgstør";"middle";0;0;0;56,966666;9,25
1825;"Løgstør";"middle";0;0;0;56,966666;9,25
1826;"Løgstør";"middle";0;0;0;56,966666;9,25
1827;"Løgstør";"middle";0;0;0;56,966666;9,25
1828;"Løgstør";"middle";0;1;1;56,966666;9,25
1829;"Løgstør";"middle";0;0;0;56,966666;9,25
1830;"Løgstør";"middle";0;0;0;56,966666;9,25
1831;"Løgstør";"middle";0;0;0;56,966666;9,25
1832;"Løgstør";"middle";0;0;0;56,966666;9,25
1833;"Løgstør";"middle";0;0;0;56,966666;9,25
1834;"Løgstør";"middle";0;0;0;56,966666;9,25
1835;"Løgstør";"middle";0;0;0;56,966666;9,25
1836;"Løgstør";"middle";0;0;0;56,966666;9,25
1837;"Løgstør";"middle";0;0;0;56,966666;9,25
1838;"Løgstør";"middle";0;0;0;56,966666;9,25
1839;"Løgstør";"middle";0;0;0;56,966666;9,25
1840;"Løgstør";"middle";0;0;0;56,966666;9,25
1841;"Løgstør";"middle";0;0;0;56,966666;9,25
1842;"Løgstør";"middle";1;3;4;56,966666;9,25
1843;"Løgstør";"middle";4;4;8;56,966666;9,25
1844;"Løgstør";"middle";5;1;6;56,966666;9,25
1845;"Løgstør";"middle";1;3;4;56,966666;9,25
1846;"Løgstør";"middle";5;5;10;56,966666;9,25
1847;"Løgstør";"middle";4;4;8;56,966666;9,25
1848;"Løgstør";"middle";3;2;5;56,966666;9,25
1849;"Løgstør";"middle";12;3;15;56,966666;9,25
1850;"Løgstør";"middle";17;5;22;56,966666;9,25
1851;"Løgstør";"middle";9;3;12;56,966666;9,25
1852;"Løgstør";"middle";14;3;17;56,966666;9,25
1853;"Løgstør";"middle";5;2;7;56,966666;9,25
1854;"Løgstør";"middle";7;5;12;56,966666;9,25
1855;"Løgstør";"middle";10;5;15;56,966666;9,25
1856;"Løgstør";"middle";10;3;13;56,966666;9,25
1857;"Løgstør";"middle";0;0;0;56,966666;9,25
1634;"Faxe";"no";0;0;0;55,2509;12,1121
1635;"Faxe";"no";0;0;0;55,2509;12,1121
1636;"Faxe";"no";0;0;0;55,2509;12,1121
1637;"Faxe";"no";0;0;0;55,2509;12,1121
1638;"Faxe";"no";0;0;0;55,2509;12,1121
1639;"Faxe";"no";0;0;0;55,2509;12,1121
1640;"Faxe";"no";0;0;0;55,2509;12,1121
1641;"Faxe";"no";0;0;0;55,2509;12,1121
1642;"Faxe";"no";0;0;0;55,2509;12,1121
1643;"Faxe";"no";0;0;0;55,2509;12,1121
1644;"Faxe";"no";0;0;0;55,2509;12,1121
1645;"Faxe";"no";0;0;0;55,2509;12,1121
1646;"Faxe";"no";0;0;0;55,2509;12,1121
1647;"Faxe";"no";0;0;0;55,2509;12,1121
1648;"Faxe";"no";0;0;0;55,2509;12,1121
1649;"Faxe";"no";0;0;0;55,2509;12,1121
1650;"Faxe";"no";0;0;0;55,2509;12,1121
1651;"Faxe";"no";0;0;0;55,2509;12,1121
1652;"Faxe";"no";0;0;0;55,2509;12,1121
1653;"Faxe";"no";0;0;0;55,2509;12,1121
1654;"Faxe";"no";0;0;0;55,2509;12,1121
1655;"Faxe";"no";0;0;0;55,2509;12,1121
1656;"Faxe";"no";0;0;0;55,2509;12,1121
1657;"Faxe";"no";0;0;0;55,2509;12,1121
1658;"Faxe";"no";0;0;0;55,2509;12,1121
1659;"Faxe";"no";0;0;0;55,2509;12,1121
1660;"Faxe";"no";0;0;0;55,2509;12,1121
1661;"Faxe";"no";0;0;0;55,2509;12,1121
1662;"Faxe";"no";0;0;0;55,2509;12,1121
1663;"Faxe";"no";0;0;0;55,2509;12,1121
1664;"Faxe";"no";0;0;0;55,2509;12,1121
1665;"Faxe";"no";0;0;0;55,2509;12,1121
1666;"Faxe";"no";0;0;0;55,2509;12,1121
1667;"Faxe";"no";0;0;0;55,2509;12,1121
1668;"Faxe";"no";0;0;0;55,2509;12,1121
1669;"Faxe";"no";0;0;0;55,2509;12,1121
1670;"Faxe";"no";0;0;0;55,2509;12,1121
1671;"Faxe";"no";0;0;0;55,2509;12,1121
1672;"Faxe";"no";0;0;0;55,2509;12,1121
1673;"Faxe";"no";0;0;0;55,2509;12,1121
1674;"Faxe";"no";0;0;0;55,2509;12,1121
1675;"Faxe";"no";0;0;0;55,2509;12,1121
1676;"Faxe";"no";0;0;0;55,2509;12,1121
1677;"Faxe";"no";0;0;0;55,2509;12,1121
1678;"Faxe";"no";0;0;0;55,2509;12,1121
1679;"Faxe";"no";0;0;0;55,2509;12,1121
1680;"Faxe";"no";0;0;0;55,2509;12,1121
1681;"Faxe";"no";0;0;0;55,2509;12,1121
1682;"Faxe";"no";0;0;0;55,2509;12,1121
1683;"Faxe";"no";0;0;0;55,2509;12,1121
1684;"Faxe";"no";0;0;0;55,2509;12,1121
1685;"Faxe";"no";0;0;0;55,2509;12,1121
1686;"Faxe";"no";0;0;0;55,2509;12,1121
1687;"Faxe";"no";0;0;0;55,2509;12,1121
1688;"Faxe";"no";0;0;0;55,2509;12,1121
1689;"Faxe";"no";0;0;0;55,2509;12,1121
1690;"Faxe";"no";0;0;0;55,2509;12,1121
1691;"Faxe";"no";0;0;0;55,2509;12,1121
1692;"Faxe";"no";0;0;0;55,2509;12,1121
1693;"Faxe";"no";0;0;0;55,2509;12,1121
1694;"Faxe";"no";0;0;0;55,2509;12,1121
1695;"Faxe";"no";0;0;0;55,2509;12,1121
1696;"Faxe";"no";0;0;0;55,2509;12,1121
1697;"Faxe";"no";0;0;0;55,2509;12,1121
1698;"Faxe";"no";0;0;0;55,2509;12,1121
1699;"Faxe";"no";0;0;0;55,2509;12,1121
1700;"Faxe";"no";0;0;0;55,2509;12,1121
1701;"Faxe";"no";0;0;0;55,2509;12,1121
1702;"Faxe";"no";0;0;0;55,2509;12,1121
1703;"Faxe";"no";0;0;0;55,2509;12,1121
1704;"Faxe";"no";0;0;0;55,2509;12,1121
1705;"Faxe";"no";0;0;0;55,2509;12,1121
1706;"Faxe";"no";0;0;0;55,2509;12,1121
1707;"Faxe";"no";0;0;0;55,2509;12,1121
1708;"Faxe";"no";0;0;0;55,2509;12,1121
1709;"Faxe";"no";0;0;0;55,2509;12,1121
1710;"Faxe";"no";0;0;0;55,2509;12,1121
1711;"Faxe";"no";0;0;0;55,2509;12,1121
1712;"Faxe";"no";0;0;0;55,2509;12,1121
1713;"Faxe";"no";0;0;0;55,2509;12,1121
1714;"Faxe";"no";0;0;0;55,2509;12,1121
1715;"Faxe";"no";0;0;0;55,2509;12,1121
1716;"Faxe";"no";0;0;0;55,2509;12,1121
1717;"Faxe";"no";0;0;0;55,2509;12,1121
1718;"Faxe";"no";0;0;0;55,2509;12,1121
1719;"Faxe";"no";0;0;0;55,2509;12,1121
1720;"Faxe";"no";0;0;0;55,2509;12,1121
1721;"Faxe";"no";0;0;0;55,2509;12,1121
1722;"Faxe";"no";0;0;0;55,2509;12,1121
1723;"Faxe";"no";0;0;0;55,2509;12,1121
1724;"Faxe";"no";0;0;0;55,2509;12,1121
1725;"Faxe";"no";0;0;0;55,2509;12,1121
1726;"Faxe";"no";0;0;0;55,2509;12,1121
1727;"Faxe";"no";0;0;0;55,2509;12,1121
1728;"Faxe";"no";0;0;0;55,2509;12,1121
1729;"Faxe";"no";0;0;0;55,2509;12,1121
1730;"Faxe";"no";0;0;0;55,2509;12,1121
1731;"Faxe";"no";0;0;0;55,2509;12,1121
1732;"Faxe";"no";0;0;0;55,2509;12,1121
1733;"Faxe";"no";0;0;0;55,2509;12,1121
1734;"Faxe";"no";0;0;0;55,2509;12,1121
1735;"Faxe";"no";0;0;0;55,2509;12,1121
1736;"Faxe";"no";0;0;0;55,2509;12,1121
1737;"Faxe";"no";0;0;0;55,2509;12,1121
1738;"Faxe";"no";0;0;0;55,2509;12,1121
1739;"Faxe";"no";0;0;0;55,2509;12,1121
1740;"Faxe";"no";0;0;0;55,2509;12,1121
1741;"Faxe";"no";0;0;0;55,2509;12,1121
1742;"Faxe";"no";0;0;0;55,2509;12,1121
1743;"Faxe";"no";0;0;0;55,2509;12,1121
1744;"Faxe";"no";0;0;0;55,2509;12,1121
1745;"Faxe";"no";0;0;0;55,2509;12,1121
1746;"Faxe";"no";0;0;0;55,2509;12,1121
1747;"Faxe";"no";0;0;0;55,2509;12,1121
1748;"Faxe";"no";0;0;0;55,2509;12,1121
1749;"Faxe";"no";0;0;0;55,2509;12,1121
1750;"Faxe";"no";0;0;0;55,2509;12,1121
1751;"Faxe";"no";0;0;0;55,2509;12,1121
1752;"Faxe";"no";0;0;0;55,2509;12,1121
1753;"Faxe";"no";0;0;0;55,2509;12,1121
1754;"Faxe";"no";0;0;0;55,2509;12,1121
1755;"Faxe";"no";0;0;0;55,2509;12,1121
1756;"Faxe";"no";0;0;0;55,2509;12,1121
1757;"Faxe";"no";0;0;0;55,2509;12,1121
1758;"Faxe";"no";0;0;0;55,2509;12,1121
1759;"Faxe";"no";0;0;0;55,2509;12,1121
1760;"Faxe";"no";0;0;0;55,2509;12,1121
1761;"Faxe";"no";0;0;0;55,2509;12,1121
1762;"Faxe";"no";0;0;0;55,2509;12,1121
1763;"Faxe";"no";0;0;0;55,2509;12,1121
1764;"Faxe";"no";0;0;0;55,2509;12,1121
1765;"Faxe";"no";0;0;0;55,2509;12,1121
1766;"Faxe";"no";0;0;0;55,2509;12,1121
1767;"Faxe";"no";0;0;0;55,2509;12,1121
1768;"Faxe";"no";0;0;0;55,2509;12,1121
1769;"Faxe";"no";0;0;0;55,2509;12,1121
1770;"Faxe";"no";0;0;0;55,2509;12,1121
1771;"Faxe";"no";0;0;0;55,2509;12,1121
1772;"Faxe";"no";0;0;0;55,2509;12,1121
1773;"Faxe";"no";0;0;0;55,2509;12,1121
1774;"Faxe";"no";0;0;0;55,2509;12,1121
1775;"Faxe";"no";0;0;0;55,2509;12,1121
1776;"Faxe";"no";0;0;0;55,2509;12,1121
1777;"Faxe";"no";0;0;0;55,2509;12,1121
1778;"Faxe";"no";0;0;0;55,2509;12,1121
1779;"Faxe";"no";0;0;0;55,2509;12,1121
1780;"Faxe";"no";0;0;0;55,2509;12,1121
1781;"Faxe";"no";0;0;0;55,2509;12,1121
1782;"Faxe";"no";0;0;0;55,2509;12,1121
1783;"Faxe";"no";0;0;0;55,2509;12,1121
1784;"Faxe";"no";0;0;0;55,2509;12,1121
1785;"Faxe";"no";0;0;0;55,2509;12,1121
1786;"Faxe";"no";0;0;0;55,2509;12,1121
1787;"Faxe";"no";0;0;0;55,2509;12,1121
1788;"Faxe";"no";0;0;0;55,2509;12,1121
1789;"Faxe";"no";0;0;0;55,2509;12,1121
1790;"Faxe";"no";0;0;0;55,2509;12,1121
1791;"Faxe";"no";0;0;0;55,2509;12,1121
1792;"Faxe";"no";0;0;0;55,2509;12,1121
1793;"Faxe";"no";0;0;0;55,2509;12,1121
1794;"Faxe";"no";0;0;0;55,2509;12,1121
1795;"Faxe";"no";0;0;0;55,2509;12,1121
1796;"Faxe";"no";0;0;0;55,2509;12,1121
1797;"Faxe";"no";0;0;0;55,2509;12,1121
1798;"Faxe";"no";0;0;0;55,2509;12,1121
1799;"Faxe";"no";0;0;0;55,2509;12,1121
1800;"Faxe";"no";0;0;0;55,2509;12,1121
1801;"Faxe";"no";0;0;0;55,2509;12,1121
1802;"Faxe";"no";0;0;0;55,2509;12,1121
1803;"Faxe";"no";0;0;0;55,2509;12,1121
1804;"Faxe";"no";0;0;0;55,2509;12,1121
1805;"Faxe";"no";0;0;0;55,2509;12,1121
1806;"Faxe";"no";0;1;1;55,2509;12,1121
1807;"Faxe";"no";0;0;0;55,2509;12,1121
1808;"Faxe";"no";0;0;0;55,2509;12,1121
1809;"Faxe";"no";0;0;0;55,2509;12,1121
1810;"Faxe";"no";0;0;0;55,2509;12,1121
1811;"Faxe";"no";0;0;0;55,2509;12,1121
1812;"Faxe";"no";0;0;0;55,2509;12,1121
1813;"Faxe";"no";0;0;0;55,2509;12,1121
1814;"Faxe";"no";0;0;0;55,2509;12,1121
1815;"Faxe";"no";0;0;0;55,2509;12,1121
1816;"Faxe";"no";0;0;0;55,2509;12,1121
1817;"Faxe";"no";0;0;0;55,2509;12,1121
1818;"Faxe";"no";0;0;0;55,2509;12,1121
1819;"Faxe";"no";0;0;0;55,2509;12,1121
1820;"Faxe";"no";0;0;0;55,2509;12,1121
1821;"Faxe";"no";0;0;0;55,2509;12,1121
1822;"Faxe";"no";0;0;0;55,2509;12,1121
1823;"Faxe";"no";0;0;0;55,2509;12,1121
1824;"Faxe";"no";0;0;0;55,2509;12,1121
1825;"Faxe";"no";0;0;0;55,2509;12,1121
1826;"Faxe";"no";0;0;0;55,2509;12,1121
1827;"Faxe";"no";0;0;0;55,2509;12,1121
1828;"Faxe";"no";0;0;0;55,2509;12,1121
1829;"Faxe";"no";0;0;0;55,2509;12,1121
1830;"Faxe";"no";0;0;0;55,2509;12,1121
1831;"Faxe";"no";0;0;0;55,2509;12,1121
1832;"Faxe";"no";0;0;0;55,2509;12,1121
1833;"Faxe";"no";0;0;0;55,2509;12,1121
1834;"Faxe";"no";0;0;0;55,2509;12,1121
1835;"Faxe";"no";0;0;0;55,2509;12,1121
1836;"Faxe";"no";0;0;0;55,2509;12,1121
1837;"Faxe";"no";0;0;0;55,2509;12,1121
1838;"Faxe";"no";0;0;0;55,2509;12,1121
1839;"Faxe";"no";0;2;2;55,2509;12,1121
1840;"Faxe";"no";0;2;2;55,2509;12,1121
1841;"Faxe";"no";0;2;2;55,2509;12,1121
1842;"Faxe";"no";0;1;1;55,2509;12,1121
1843;"Faxe";"no";4;1;5;55,2509;12,1121
1844;"Faxe";"no";3;2;5;55,2509;12,1121
1845;"Faxe";"no";2;3;5;55,2509;12,1121
1846;"Faxe";"no";4;2;6;55,2509;12,1121
1847;"Faxe";"no";4;2;6;55,2509;12,1121
1848;"Faxe";"no";4;2;6;55,2509;12,1121
1849;"Faxe";"no";4;1;5;55,2509;12,1121
1850;"Faxe";"no";3;3;6;55,2509;12,1121
1851;"Faxe";"no";1;2;3;55,2509;12,1121
1852;"Faxe";"no";3;4;7;55,2509;12,1121
1853;"Faxe";"no";4;1;5;55,2509;12,1121
1854;"Faxe";"no";2;7;9;55,2509;12,1121
1855;"Faxe";"no";2;4;6;55,2509;12,1121
1856;"Faxe";"no";1;3;4;55,2509;12,1121
1857;"Faxe";"no";0;0;0;55,2509;12,1121
1634;"Harboøre";"west";0;0;0;56,6175;8,180555
1635;"Harboøre";"west";0;0;0;56,6175;8,180555
1636;"Harboøre";"west";0;0;0;56,6175;8,180555
1637;"Harboøre";"west";0;0;0;56,6175;8,180555
1638;"Harboøre";"west";0;0;0;56,6175;8,180555
1639;"Harboøre";"west";0;0;0;56,6175;8,180555
1640;"Harboøre";"west";0;0;0;56,6175;8,180555
1641;"Harboøre";"west";0;0;0;56,6175;8,180555
1642;"Harboøre";"west";0;0;0;56,6175;8,180555
1643;"Harboøre";"west";0;0;0;56,6175;8,180555
1644;"Harboøre";"west";0;0;0;56,6175;8,180555
1645;"Harboøre";"west";0;0;0;56,6175;8,180555
1646;"Harboøre";"west";0;0;0;56,6175;8,180555
1647;"Harboøre";"west";0;0;0;56,6175;8,180555
1648;"Harboøre";"west";0;0;0;56,6175;8,180555
1649;"Harboøre";"west";0;0;0;56,6175;8,180555
1650;"Harboøre";"west";0;0;0;56,6175;8,180555
1651;"Harboøre";"west";0;0;0;56,6175;8,180555
1652;"Harboøre";"west";0;0;0;56,6175;8,180555
1653;"Harboøre";"west";0;0;0;56,6175;8,180555
1654;"Harboøre";"west";0;0;0;56,6175;8,180555
1655;"Harboøre";"west";0;0;0;56,6175;8,180555
1656;"Harboøre";"west";0;0;0;56,6175;8,180555
1657;"Harboøre";"west";0;0;0;56,6175;8,180555
1658;"Harboøre";"west";0;0;0;56,6175;8,180555
1659;"Harboøre";"west";0;0;0;56,6175;8,180555
1660;"Harboøre";"west";0;0;0;56,6175;8,180555
1661;"Harboøre";"west";0;0;0;56,6175;8,180555
1662;"Harboøre";"west";0;0;0;56,6175;8,180555
1663;"Harboøre";"west";0;0;0;56,6175;8,180555
1664;"Harboøre";"west";0;0;0;56,6175;8,180555
1665;"Harboøre";"west";0;0;0;56,6175;8,180555
1666;"Harboøre";"west";0;0;0;56,6175;8,180555
1667;"Harboøre";"west";0;0;0;56,6175;8,180555
1668;"Harboøre";"west";0;0;0;56,6175;8,180555
1669;"Harboøre";"west";0;0;0;56,6175;8,180555
1670;"Harboøre";"west";0;0;0;56,6175;8,180555
1671;"Harboøre";"west";0;0;0;56,6175;8,180555
1672;"Harboøre";"west";0;0;0;56,6175;8,180555
1673;"Harboøre";"west";0;0;0;56,6175;8,180555
1674;"Harboøre";"west";0;0;0;56,6175;8,180555
1675;"Harboøre";"west";0;0;0;56,6175;8,180555
1676;"Harboøre";"west";0;0;0;56,6175;8,180555
1677;"Harboøre";"west";0;0;0;56,6175;8,180555
1678;"Harboøre";"west";0;0;0;56,6175;8,180555
1679;"Harboøre";"west";0;0;0;56,6175;8,180555
1680;"Harboøre";"west";0;0;0;56,6175;8,180555
1681;"Harboøre";"west";0;0;0;56,6175;8,180555
1682;"Harboøre";"west";0;0;0;56,6175;8,180555
1683;"Harboøre";"west";0;0;0;56,6175;8,180555
1684;"Harboøre";"west";0;0;0;56,6175;8,180555
1685;"Harboøre";"west";0;0;0;56,6175;8,180555
1686;"Harboøre";"west";0;0;0;56,6175;8,180555
1687;"Harboøre";"west";0;0;0;56,6175;8,180555
1688;"Harboøre";"west";0;0;0;56,6175;8,180555
1689;"Harboøre";"west";0;0;0;56,6175;8,180555
1690;"Harboøre";"west";0;0;0;56,6175;8,180555
1691;"Harboøre";"west";0;0;0;56,6175;8,180555
1692;"Harboøre";"west";0;0;0;56,6175;8,180555
1693;"Harboøre";"west";0;0;0;56,6175;8,180555
1694;"Harboøre";"west";0;0;0;56,6175;8,180555
1695;"Harboøre";"west";0;0;0;56,6175;8,180555
1696;"Harboøre";"west";0;0;0;56,6175;8,180555
1697;"Harboøre";"west";0;0;0;56,6175;8,180555
1698;"Harboøre";"west";0;0;0;56,6175;8,180555
1699;"Harboøre";"west";0;0;0;56,6175;8,180555
1700;"Harboøre";"west";0;0;0;56,6175;8,180555
1701;"Harboøre";"west";0;0;0;56,6175;8,180555
1702;"Harboøre";"west";0;0;0;56,6175;8,180555
1703;"Harboøre";"west";0;0;0;56,6175;8,180555
1704;"Harboøre";"west";0;0;0;56,6175;8,180555
1705;"Harboøre";"west";0;0;0;56,6175;8,180555
1706;"Harboøre";"west";0;0;0;56,6175;8,180555
1707;"Harboøre";"west";0;0;0;56,6175;8,180555
1708;"Harboøre";"west";0;0;0;56,6175;8,180555
1709;"Harboøre";"west";0;0;0;56,6175;8,180555
1710;"Harboøre";"west";0;0;0;56,6175;8,180555
1711;"Harboøre";"west";0;0;0;56,6175;8,180555
1712;"Harboøre";"west";0;0;0;56,6175;8,180555
1713;"Harboøre";"west";0;0;0;56,6175;8,180555
1714;"Harboøre";"west";0;0;0;56,6175;8,180555
1715;"Harboøre";"west";0;0;0;56,6175;8,180555
1716;"Harboøre";"west";0;0;0;56,6175;8,180555
1717;"Harboøre";"west";0;0;0;56,6175;8,180555
1718;"Harboøre";"west";0;0;0;56,6175;8,180555
1719;"Harboøre";"west";0;0;0;56,6175;8,180555
1720;"Harboøre";"west";0;0;0;56,6175;8,180555
1721;"Harboøre";"west";0;0;0;56,6175;8,180555
1722;"Harboøre";"west";0;0;0;56,6175;8,180555
1723;"Harboøre";"west";0;0;0;56,6175;8,180555
1724;"Harboøre";"west";0;0;0;56,6175;8,180555
1725;"Harboøre";"west";0;0;0;56,6175;8,180555
1726;"Harboøre";"west";0;0;0;56,6175;8,180555
1727;"Harboøre";"west";0;0;0;56,6175;8,180555
1728;"Harboøre";"west";0;0;0;56,6175;8,180555
1729;"Harboøre";"west";0;0;0;56,6175;8,180555
1730;"Harboøre";"west";0;0;0;56,6175;8,180555
1731;"Harboøre";"west";0;0;0;56,6175;8,180555
1732;"Harboøre";"west";0;0;0;56,6175;8,180555
1733;"Harboøre";"west";0;0;0;56,6175;8,180555
1734;"Harboøre";"west";0;0;0;56,6175;8,180555
1735;"Harboøre";"west";0;0;0;56,6175;8,180555
1736;"Harboøre";"west";0;0;0;56,6175;8,180555
1737;"Harboøre";"west";0;0;0;56,6175;8,180555
1738;"Harboøre";"west";0;0;0;56,6175;8,180555
1739;"Harboøre";"west";0;0;0;56,6175;8,180555
1740;"Harboøre";"west";0;0;0;56,6175;8,180555
1741;"Harboøre";"west";0;0;0;56,6175;8,180555
1742;"Harboøre";"west";0;0;0;56,6175;8,180555
1743;"Harboøre";"west";0;0;0;56,6175;8,180555
1744;"Harboøre";"west";0;0;0;56,6175;8,180555
1745;"Harboøre";"west";0;0;0;56,6175;8,180555
1746;"Harboøre";"west";0;0;0;56,6175;8,180555
1747;"Harboøre";"west";0;0;0;56,6175;8,180555
1748;"Harboøre";"west";0;0;0;56,6175;8,180555
1749;"Harboøre";"west";0;0;0;56,6175;8,180555
1750;"Harboøre";"west";0;0;0;56,6175;8,180555
1751;"Harboøre";"west";0;0;0;56,6175;8,180555
1752;"Harboøre";"west";0;0;0;56,6175;8,180555
1753;"Harboøre";"west";0;0;0;56,6175;8,180555
1754;"Harboøre";"west";0;0;0;56,6175;8,180555
1755;"Harboøre";"west";0;0;0;56,6175;8,180555
1756;"Harboøre";"west";0;0;0;56,6175;8,180555
1757;"Harboøre";"west";0;0;0;56,6175;8,180555
1758;"Harboøre";"west";0;0;0;56,6175;8,180555
1759;"Harboøre";"west";0;0;0;56,6175;8,180555
1760;"Harboøre";"west";0;0;0;56,6175;8,180555
1761;"Harboøre";"west";0;0;0;56,6175;8,180555
1762;"Harboøre";"west";0;0;0;56,6175;8,180555
1763;"Harboøre";"west";0;0;0;56,6175;8,180555
1764;"Harboøre";"west";0;0;0;56,6175;8,180555
1765;"Harboøre";"west";0;0;0;56,6175;8,180555
1766;"Harboøre";"west";0;0;0;56,6175;8,180555
1767;"Harboøre";"west";0;0;0;56,6175;8,180555
1768;"Harboøre";"west";0;0;0;56,6175;8,180555
1769;"Harboøre";"west";0;0;0;56,6175;8,180555
1770;"Harboøre";"west";0;0;0;56,6175;8,180555
1771;"Harboøre";"west";0;0;0;56,6175;8,180555
1772;"Harboøre";"west";0;0;0;56,6175;8,180555
1773;"Harboøre";"west";0;0;0;56,6175;8,180555
1774;"Harboøre";"west";0;0;0;56,6175;8,180555
1775;"Harboøre";"west";0;0;0;56,6175;8,180555
1776;"Harboøre";"west";0;0;0;56,6175;8,180555
1777;"Harboøre";"west";0;0;0;56,6175;8,180555
1778;"Harboøre";"west";0;0;0;56,6175;8,180555
1779;"Harboøre";"west";0;0;0;56,6175;8,180555
1780;"Harboøre";"west";0;0;0;56,6175;8,180555
1781;"Harboøre";"west";0;0;0;56,6175;8,180555
1782;"Harboøre";"west";0;0;0;56,6175;8,180555
1783;"Harboøre";"west";0;0;0;56,6175;8,180555
1784;"Harboøre";"west";0;0;0;56,6175;8,180555
1785;"Harboøre";"west";0;0;0;56,6175;8,180555
1786;"Harboøre";"west";0;0;0;56,6175;8,180555
1787;"Harboøre";"west";0;0;0;56,6175;8,180555
1788;"Harboøre";"west";0;0;0;56,6175;8,180555
1789;"Harboøre";"west";0;0;0;56,6175;8,180555
1790;"Harboøre";"west";0;0;0;56,6175;8,180555
1791;"Harboøre";"west";0;0;0;56,6175;8,180555
1792;"Harboøre";"west";0;0;0;56,6175;8,180555
1793;"Harboøre";"west";0;0;0;56,6175;8,180555
1794;"Harboøre";"west";0;0;0;56,6175;8,180555
1795;"Harboøre";"west";0;0;0;56,6175;8,180555
1796;"Harboøre";"west";0;0;0;56,6175;8,180555
1797;"Harboøre";"west";0;0;0;56,6175;8,180555
1798;"Harboøre";"west";0;0;0;56,6175;8,180555
1799;"Harboøre";"west";0;0;0;56,6175;8,180555
1800;"Harboøre";"west";0;0;0;56,6175;8,180555
1801;"Harboøre";"west";0;0;0;56,6175;8,180555
1802;"Harboøre";"west";0;0;0;56,6175;8,180555
1803;"Harboøre";"west";0;0;0;56,6175;8,180555
1804;"Harboøre";"west";0;0;0;56,6175;8,180555
1805;"Harboøre";"west";0;0;0;56,6175;8,180555
1806;"Harboøre";"west";0;0;0;56,6175;8,180555
1807;"Harboøre";"west";0;0;0;56,6175;8,180555
1808;"Harboøre";"west";0;0;0;56,6175;8,180555
1809;"Harboøre";"west";0;0;0;56,6175;8,180555
1810;"Harboøre";"west";0;0;0;56,6175;8,180555
1811;"Harboøre";"west";0;0;0;56,6175;8,180555
1812;"Harboøre";"west";0;0;0;56,6175;8,180555
1813;"Harboøre";"west";0;0;0;56,6175;8,180555
1814;"Harboøre";"west";0;0;0;56,6175;8,180555
1815;"Harboøre";"west";0;0;0;56,6175;8,180555
1816;"Harboøre";"west";0;0;0;56,6175;8,180555
1817;"Harboøre";"west";0;0;0;56,6175;8,180555
1818;"Harboøre";"west";0;0;0;56,6175;8,180555
1819;"Harboøre";"west";0;0;0;56,6175;8,180555
1820;"Harboøre";"west";0;0;0;56,6175;8,180555
1821;"Harboøre";"west";0;0;0;56,6175;8,180555
1822;"Harboøre";"west";0;0;0;56,6175;8,180555
1823;"Harboøre";"west";0;0;0;56,6175;8,180555
1824;"Harboøre";"west";0;0;0;56,6175;8,180555
1825;"Harboøre";"west";0;0;0;56,6175;8,180555
1826;"Harboøre";"west";0;0;0;56,6175;8,180555
1827;"Harboøre";"west";0;0;0;56,6175;8,180555
1828;"Harboøre";"west";0;0;0;56,6175;8,180555
1829;"Harboøre";"west";0;0;0;56,6175;8,180555
1830;"Harboøre";"west";0;0;0;56,6175;8,180555
1831;"Harboøre";"west";0;0;0;56,6175;8,180555
1832;"Harboøre";"west";0;0;0;56,6175;8,180555
1833;"Harboøre";"west";0;0;0;56,6175;8,180555
1834;"Harboøre";"west";0;0;0;56,6175;8,180555
1835;"Harboøre";"west";0;0;0;56,6175;8,180555
1836;"Harboøre";"west";0;0;0;56,6175;8,180555
1837;"Harboøre";"west";0;0;0;56,6175;8,180555
1838;"Harboøre";"west";0;0;0;56,6175;8,180555
1839;"Harboøre";"west";0;0;0;56,6175;8,180555
1840;"Harboøre";"west";0;0;0;56,6175;8,180555
1841;"Harboøre";"west";0;0;0;56,6175;8,180555
1842;"Harboøre";"west";0;0;0;56,6175;8,180555
1843;"Harboøre";"west";1;0;1;56,6175;8,180555
1844;"Harboøre";"west";0;0;0;56,6175;8,180555
1845;"Harboøre";"west";0;0;0;56,6175;8,180555
1846;"Harboøre";"west";0;0;0;56,6175;8,180555
1847;"Harboøre";"west";0;0;0;56,6175;8,180555
1848;"Harboøre";"west";0;0;0;56,6175;8,180555
1849;"Harboøre";"west";0;0;0;56,6175;8,180555
1850;"Harboøre";"west";0;0;0;56,6175;8,180555
1851;"Harboøre";"west";0;0;0;56,6175;8,180555
1852;"Harboøre";"west";0;0;0;56,6175;8,180555
1853;"Harboøre";"west";0;0;0;56,6175;8,180555
1854;"Harboøre";"west";0;0;0;56,6175;8,180555
1855;"Harboøre";"west";0;0;0;56,6175;8,180555
1856;"Harboøre";"west";0;0;0;56,6175;8,180555
1857;"Harboøre";"west";0;0;0;56,6175;8,180555
1634;"Hjerting";"no";0;0;0;55,526111;8,357777
1635;"Hjerting";"no";0;0;0;55,526111;8,357777
1636;"Hjerting";"no";0;0;0;55,526111;8,357777
1637;"Hjerting";"no";0;0;0;55,526111;8,357777
1638;"Hjerting";"no";0;0;0;55,526111;8,357777
1639;"Hjerting";"no";0;0;0;55,526111;8,357777
1640;"Hjerting";"no";0;0;0;55,526111;8,357777
1641;"Hjerting";"no";0;0;0;55,526111;8,357777
1642;"Hjerting";"no";0;0;0;55,526111;8,357777
1643;"Hjerting";"no";0;0;0;55,526111;8,357777
1644;"Hjerting";"no";0;0;0;55,526111;8,357777
1645;"Hjerting";"no";0;0;0;55,526111;8,357777
1646;"Hjerting";"no";0;0;0;55,526111;8,357777
1647;"Hjerting";"no";0;0;0;55,526111;8,357777
1648;"Hjerting";"no";0;0;0;55,526111;8,357777
1649;"Hjerting";"no";0;0;0;55,526111;8,357777
1650;"Hjerting";"no";0;0;0;55,526111;8,357777
1651;"Hjerting";"no";0;0;0;55,526111;8,357777
1652;"Hjerting";"no";0;0;0;55,526111;8,357777
1653;"Hjerting";"no";0;0;0;55,526111;8,357777
1654;"Hjerting";"no";0;0;0;55,526111;8,357777
1655;"Hjerting";"no";0;0;0;55,526111;8,357777
1656;"Hjerting";"no";0;0;0;55,526111;8,357777
1657;"Hjerting";"no";0;0;0;55,526111;8,357777
1658;"Hjerting";"no";0;0;0;55,526111;8,357777
1659;"Hjerting";"no";0;0;0;55,526111;8,357777
1660;"Hjerting";"no";0;0;0;55,526111;8,357777
1661;"Hjerting";"no";0;0;0;55,526111;8,357777
1662;"Hjerting";"no";0;0;0;55,526111;8,357777
1663;"Hjerting";"no";0;0;0;55,526111;8,357777
1664;"Hjerting";"no";0;0;0;55,526111;8,357777
1665;"Hjerting";"no";0;0;0;55,526111;8,357777
1666;"Hjerting";"no";0;0;0;55,526111;8,357777
1667;"Hjerting";"no";0;0;0;55,526111;8,357777
1668;"Hjerting";"no";0;0;0;55,526111;8,357777
1669;"Hjerting";"no";0;0;0;55,526111;8,357777
1670;"Hjerting";"no";0;0;0;55,526111;8,357777
1671;"Hjerting";"no";0;0;0;55,526111;8,357777
1672;"Hjerting";"no";0;0;0;55,526111;8,357777
1673;"Hjerting";"no";0;0;0;55,526111;8,357777
1674;"Hjerting";"no";0;0;0;55,526111;8,357777
1675;"Hjerting";"no";0;0;0;55,526111;8,357777
1676;"Hjerting";"no";0;0;0;55,526111;8,357777
1677;"Hjerting";"no";0;0;0;55,526111;8,357777
1678;"Hjerting";"no";0;0;0;55,526111;8,357777
1679;"Hjerting";"no";0;0;0;55,526111;8,357777
1680;"Hjerting";"no";0;0;0;55,526111;8,357777
1681;"Hjerting";"no";0;0;0;55,526111;8,357777
1682;"Hjerting";"no";0;0;0;55,526111;8,357777
1683;"Hjerting";"no";0;0;0;55,526111;8,357777
1684;"Hjerting";"no";0;0;0;55,526111;8,357777
1685;"Hjerting";"no";0;0;0;55,526111;8,357777
1686;"Hjerting";"no";0;0;0;55,526111;8,357777
1687;"Hjerting";"no";0;0;0;55,526111;8,357777
1688;"Hjerting";"no";0;0;0;55,526111;8,357777
1689;"Hjerting";"no";0;0;0;55,526111;8,357777
1690;"Hjerting";"no";0;0;0;55,526111;8,357777
1691;"Hjerting";"no";0;0;0;55,526111;8,357777
1692;"Hjerting";"no";0;0;0;55,526111;8,357777
1693;"Hjerting";"no";0;0;0;55,526111;8,357777
1694;"Hjerting";"no";0;0;0;55,526111;8,357777
1695;"Hjerting";"no";0;0;0;55,526111;8,357777
1696;"Hjerting";"no";0;0;0;55,526111;8,357777
1697;"Hjerting";"no";0;0;0;55,526111;8,357777
1698;"Hjerting";"no";0;0;0;55,526111;8,357777
1699;"Hjerting";"no";0;0;0;55,526111;8,357777
1700;"Hjerting";"no";0;0;0;55,526111;8,357777
1701;"Hjerting";"no";0;0;0;55,526111;8,357777
1702;"Hjerting";"no";0;0;0;55,526111;8,357777
1703;"Hjerting";"no";0;0;0;55,526111;8,357777
1704;"Hjerting";"no";0;0;0;55,526111;8,357777
1705;"Hjerting";"no";0;0;0;55,526111;8,357777
1706;"Hjerting";"no";0;0;0;55,526111;8,357777
1707;"Hjerting";"no";0;0;0;55,526111;8,357777
1708;"Hjerting";"no";0;0;0;55,526111;8,357777
1709;"Hjerting";"no";0;0;0;55,526111;8,357777
1710;"Hjerting";"no";0;0;0;55,526111;8,357777
1711;"Hjerting";"no";0;0;0;55,526111;8,357777
1712;"Hjerting";"no";0;0;0;55,526111;8,357777
1713;"Hjerting";"no";0;0;0;55,526111;8,357777
1714;"Hjerting";"no";0;0;0;55,526111;8,357777
1715;"Hjerting";"no";0;0;0;55,526111;8,357777
1716;"Hjerting";"no";0;0;0;55,526111;8,357777
1717;"Hjerting";"no";0;0;0;55,526111;8,357777
1718;"Hjerting";"no";0;0;0;55,526111;8,357777
1719;"Hjerting";"no";0;0;0;55,526111;8,357777
1720;"Hjerting";"no";0;0;0;55,526111;8,357777
1721;"Hjerting";"no";0;0;0;55,526111;8,357777
1722;"Hjerting";"no";0;0;0;55,526111;8,357777
1723;"Hjerting";"no";0;0;0;55,526111;8,357777
1724;"Hjerting";"no";0;0;0;55,526111;8,357777
1725;"Hjerting";"no";0;0;0;55,526111;8,357777
1726;"Hjerting";"no";0;0;0;55,526111;8,357777
1727;"Hjerting";"no";0;0;0;55,526111;8,357777
1728;"Hjerting";"no";0;0;0;55,526111;8,357777
1729;"Hjerting";"no";0;0;0;55,526111;8,357777
1730;"Hjerting";"no";0;0;0;55,526111;8,357777
1731;"Hjerting";"no";0;0;0;55,526111;8,357777
1732;"Hjerting";"no";0;0;0;55,526111;8,357777
1733;"Hjerting";"no";0;0;0;55,526111;8,357777
1734;"Hjerting";"no";0;0;0;55,526111;8,357777
1735;"Hjerting";"no";0;0;0;55,526111;8,357777
1736;"Hjerting";"no";0;0;0;55,526111;8,357777
1737;"Hjerting";"no";0;0;0;55,526111;8,357777
1738;"Hjerting";"no";0;0;0;55,526111;8,357777
1739;"Hjerting";"no";0;0;0;55,526111;8,357777
1740;"Hjerting";"no";0;0;0;55,526111;8,357777
1741;"Hjerting";"no";0;0;0;55,526111;8,357777
1742;"Hjerting";"no";0;0;0;55,526111;8,357777
1743;"Hjerting";"no";0;0;0;55,526111;8,357777
1744;"Hjerting";"no";0;0;0;55,526111;8,357777
1745;"Hjerting";"no";0;0;0;55,526111;8,357777
1746;"Hjerting";"no";0;0;0;55,526111;8,357777
1747;"Hjerting";"no";0;0;0;55,526111;8,357777
1748;"Hjerting";"no";0;0;0;55,526111;8,357777
1749;"Hjerting";"no";0;0;0;55,526111;8,357777
1750;"Hjerting";"no";0;0;0;55,526111;8,357777
1751;"Hjerting";"no";0;0;0;55,526111;8,357777
1752;"Hjerting";"no";0;0;0;55,526111;8,357777
1753;"Hjerting";"no";0;0;0;55,526111;8,357777
1754;"Hjerting";"no";0;0;0;55,526111;8,357777
1755;"Hjerting";"no";0;0;0;55,526111;8,357777
1756;"Hjerting";"no";0;0;0;55,526111;8,357777
1757;"Hjerting";"no";0;0;0;55,526111;8,357777
1758;"Hjerting";"no";0;0;0;55,526111;8,357777
1759;"Hjerting";"no";0;0;0;55,526111;8,357777
1760;"Hjerting";"no";0;0;0;55,526111;8,357777
1761;"Hjerting";"no";0;0;0;55,526111;8,357777
1762;"Hjerting";"no";0;0;0;55,526111;8,357777
1763;"Hjerting";"no";0;0;0;55,526111;8,357777
1764;"Hjerting";"no";0;0;0;55,526111;8,357777
1765;"Hjerting";"no";0;0;0;55,526111;8,357777
1766;"Hjerting";"no";0;0;0;55,526111;8,357777
1767;"Hjerting";"no";0;0;0;55,526111;8,357777
1768;"Hjerting";"no";0;0;0;55,526111;8,357777
1769;"Hjerting";"no";0;0;0;55,526111;8,357777
1770;"Hjerting";"no";0;0;0;55,526111;8,357777
1771;"Hjerting";"no";0;0;0;55,526111;8,357777
1772;"Hjerting";"no";0;0;0;55,526111;8,357777
1773;"Hjerting";"no";0;0;0;55,526111;8,357777
1774;"Hjerting";"no";0;0;0;55,526111;8,357777
1775;"Hjerting";"no";0;0;0;55,526111;8,357777
1776;"Hjerting";"no";0;0;0;55,526111;8,357777
1777;"Hjerting";"no";0;0;0;55,526111;8,357777
1778;"Hjerting";"no";0;0;0;55,526111;8,357777
1779;"Hjerting";"no";0;0;0;55,526111;8,357777
1780;"Hjerting";"no";0;0;0;55,526111;8,357777
1781;"Hjerting";"no";0;0;0;55,526111;8,357777
1782;"Hjerting";"no";0;0;0;55,526111;8,357777
1783;"Hjerting";"no";0;0;0;55,526111;8,357777
1784;"Hjerting";"no";0;0;0;55,526111;8,357777
1785;"Hjerting";"no";0;0;0;55,526111;8,357777
1786;"Hjerting";"no";0;0;0;55,526111;8,357777
1787;"Hjerting";"no";0;0;0;55,526111;8,357777
1788;"Hjerting";"no";0;0;0;55,526111;8,357777
1789;"Hjerting";"no";0;0;0;55,526111;8,357777
1790;"Hjerting";"no";0;0;0;55,526111;8,357777
1791;"Hjerting";"no";0;0;0;55,526111;8,357777
1792;"Hjerting";"no";0;0;0;55,526111;8,357777
1793;"Hjerting";"no";0;0;0;55,526111;8,357777
1794;"Hjerting";"no";0;0;0;55,526111;8,357777
1795;"Hjerting";"no";0;0;0;55,526111;8,357777
1796;"Hjerting";"no";0;0;0;55,526111;8,357777
1797;"Hjerting";"no";0;0;0;55,526111;8,357777
1798;"Hjerting";"no";0;0;0;55,526111;8,357777
1799;"Hjerting";"no";0;0;0;55,526111;8,357777
1800;"Hjerting";"no";0;0;0;55,526111;8,357777
1801;"Hjerting";"no";0;0;0;55,526111;8,357777
1802;"Hjerting";"no";0;0;0;55,526111;8,357777
1803;"Hjerting";"no";0;0;0;55,526111;8,357777
1804;"Hjerting";"no";0;0;0;55,526111;8,357777
1805;"Hjerting";"no";0;0;0;55,526111;8,357777
1806;"Hjerting";"no";0;0;0;55,526111;8,357777
1807;"Hjerting";"no";0;0;0;55,526111;8,357777
1808;"Hjerting";"no";0;0;0;55,526111;8,357777
1809;"Hjerting";"no";0;0;0;55,526111;8,357777
1810;"Hjerting";"no";0;0;0;55,526111;8,357777
1811;"Hjerting";"no";0;0;0;55,526111;8,357777
1812;"Hjerting";"no";0;0;0;55,526111;8,357777
1813;"Hjerting";"no";0;0;0;55,526111;8,357777
1814;"Hjerting";"no";0;0;0;55,526111;8,357777
1815;"Hjerting";"no";0;0;0;55,526111;8,357777
1816;"Hjerting";"no";0;0;0;55,526111;8,357777
1817;"Hjerting";"no";0;0;0;55,526111;8,357777
1818;"Hjerting";"no";0;0;0;55,526111;8,357777
1819;"Hjerting";"no";0;0;0;55,526111;8,357777
1820;"Hjerting";"no";0;0;0;55,526111;8,357777
1821;"Hjerting";"no";0;0;0;55,526111;8,357777
1822;"Hjerting";"no";0;0;0;55,526111;8,357777
1823;"Hjerting";"no";0;0;0;55,526111;8,357777
1824;"Hjerting";"no";0;0;0;55,526111;8,357777
1825;"Hjerting";"no";0;0;0;55,526111;8,357777
1826;"Hjerting";"no";0;0;0;55,526111;8,357777
1827;"Hjerting";"no";0;0;0;55,526111;8,357777
1828;"Hjerting";"no";0;0;0;55,526111;8,357777
1829;"Hjerting";"no";0;0;0;55,526111;8,357777
1830;"Hjerting";"no";0;0;0;55,526111;8,357777
1831;"Hjerting";"no";0;0;0;55,526111;8,357777
1832;"Hjerting";"no";0;0;0;55,526111;8,357777
1833;"Hjerting";"no";0;0;0;55,526111;8,357777
1834;"Hjerting";"no";0;0;0;55,526111;8,357777
1835;"Hjerting";"no";0;0;0;55,526111;8,357777
1836;"Hjerting";"no";0;0;0;55,526111;8,357777
1837;"Hjerting";"no";0;0;0;55,526111;8,357777
1838;"Hjerting";"no";0;0;0;55,526111;8,357777
1839;"Hjerting";"no";0;0;0;55,526111;8,357777
1840;"Hjerting";"no";0;0;0;55,526111;8,357777
1841;"Hjerting";"no";0;0;0;55,526111;8,357777
1842;"Hjerting";"no";0;0;0;55,526111;8,357777
1843;"Hjerting";"no";1;1;2;55,526111;8,357777
1844;"Hjerting";"no";0;1;1;55,526111;8,357777
1845;"Hjerting";"no";1;0;1;55,526111;8,357777
1846;"Hjerting";"no";0;1;1;55,526111;8,357777
1847;"Hjerting";"no";0;1;1;55,526111;8,357777
1848;"Hjerting";"no";0;0;0;55,526111;8,357777
1849;"Hjerting";"no";4;0;4;55,526111;8,357777
1850;"Hjerting";"no";2;1;3;55,526111;8,357777
1851;"Hjerting";"no";2;3;5;55,526111;8,357777
1852;"Hjerting";"no";0;1;1;55,526111;8,357777
1853;"Hjerting";"no";0;0;0;55,526111;8,357777
1854;"Hjerting";"no";0;0;0;55,526111;8,357777
1855;"Hjerting";"no";1;0;1;55,526111;8,357777
1856;"Hjerting";"no";0;0;0;55,526111;8,357777
1857;"Hjerting";"no";0;0;0;55,526111;8,357777
1634;"Dronningmølle";"no";0;0;0;56,094722;12,385
1635;"Dronningmølle";"no";0;0;0;56,094722;12,385
1636;"Dronningmølle";"no";0;0;0;56,094722;12,385
1637;"Dronningmølle";"no";0;0;0;56,094722;12,385
1638;"Dronningmølle";"no";0;0;0;56,094722;12,385
1639;"Dronningmølle";"no";0;0;0;56,094722;12,385
1640;"Dronningmølle";"no";0;0;0;56,094722;12,385
1641;"Dronningmølle";"no";0;0;0;56,094722;12,385
1642;"Dronningmølle";"no";0;0;0;56,094722;12,385
1643;"Dronningmølle";"no";0;0;0;56,094722;12,385
1644;"Dronningmølle";"no";0;0;0;56,094722;12,385
1645;"Dronningmølle";"no";0;0;0;56,094722;12,385
1646;"Dronningmølle";"no";0;0;0;56,094722;12,385
1647;"Dronningmølle";"no";0;0;0;56,094722;12,385
1648;"Dronningmølle";"no";0;0;0;56,094722;12,385
1649;"Dronningmølle";"no";0;0;0;56,094722;12,385
1650;"Dronningmølle";"no";0;0;0;56,094722;12,385
1651;"Dronningmølle";"no";0;0;0;56,094722;12,385
1652;"Dronningmølle";"no";0;0;0;56,094722;12,385
1653;"Dronningmølle";"no";0;0;0;56,094722;12,385
1654;"Dronningmølle";"no";0;0;0;56,094722;12,385
1655;"Dronningmølle";"no";0;0;0;56,094722;12,385
1656;"Dronningmølle";"no";0;0;0;56,094722;12,385
1657;"Dronningmølle";"no";0;0;0;56,094722;12,385
1658;"Dronningmølle";"no";0;0;0;56,094722;12,385
1659;"Dronningmølle";"no";0;0;0;56,094722;12,385
1660;"Dronningmølle";"no";0;0;0;56,094722;12,385
1661;"Dronningmølle";"no";0;0;0;56,094722;12,385
1662;"Dronningmølle";"no";0;0;0;56,094722;12,385
1663;"Dronningmølle";"no";0;0;0;56,094722;12,385
1664;"Dronningmølle";"no";0;0;0;56,094722;12,385
1665;"Dronningmølle";"no";0;0;0;56,094722;12,385
1666;"Dronningmølle";"no";0;0;0;56,094722;12,385
1667;"Dronningmølle";"no";0;0;0;56,094722;12,385
1668;"Dronningmølle";"no";0;0;0;56,094722;12,385
1669;"Dronningmølle";"no";0;0;0;56,094722;12,385
1670;"Dronningmølle";"no";0;0;0;56,094722;12,385
1671;"Dronningmølle";"no";0;0;0;56,094722;12,385
1672;"Dronningmølle";"no";0;0;0;56,094722;12,385
1673;"Dronningmølle";"no";0;0;0;56,094722;12,385
1674;"Dronningmølle";"no";0;0;0;56,094722;12,385
1675;"Dronningmølle";"no";0;0;0;56,094722;12,385
1676;"Dronningmølle";"no";0;0;0;56,094722;12,385
1677;"Dronningmølle";"no";0;0;0;56,094722;12,385
1678;"Dronningmølle";"no";0;0;0;56,094722;12,385
1679;"Dronningmølle";"no";0;0;0;56,094722;12,385
1680;"Dronningmølle";"no";0;0;0;56,094722;12,385
1681;"Dronningmølle";"no";0;0;0;56,094722;12,385
1682;"Dronningmølle";"no";0;0;0;56,094722;12,385
1683;"Dronningmølle";"no";0;0;0;56,094722;12,385
1684;"Dronningmølle";"no";0;0;0;56,094722;12,385
1685;"Dronningmølle";"no";0;0;0;56,094722;12,385
1686;"Dronningmølle";"no";0;0;0;56,094722;12,385
1687;"Dronningmølle";"no";0;0;0;56,094722;12,385
1688;"Dronningmølle";"no";0;0;0;56,094722;12,385
1689;"Dronningmølle";"no";0;0;0;56,094722;12,385
1690;"Dronningmølle";"no";0;0;0;56,094722;12,385
1691;"Dronningmølle";"no";0;0;0;56,094722;12,385
1692;"Dronningmølle";"no";0;0;0;56,094722;12,385
1693;"Dronningmølle";"no";0;0;0;56,094722;12,385
1694;"Dronningmølle";"no";0;0;0;56,094722;12,385
1695;"Dronningmølle";"no";0;0;0;56,094722;12,385
1696;"Dronningmølle";"no";0;0;0;56,094722;12,385
1697;"Dronningmølle";"no";0;0;0;56,094722;12,385
1698;"Dronningmølle";"no";0;0;0;56,094722;12,385
1699;"Dronningmølle";"no";0;0;0;56,094722;12,385
1700;"Dronningmølle";"no";0;0;0;56,094722;12,385
1701;"Dronningmølle";"no";0;0;0;56,094722;12,385
1702;"Dronningmølle";"no";0;0;0;56,094722;12,385
1703;"Dronningmølle";"no";0;0;0;56,094722;12,385
1704;"Dronningmølle";"no";0;0;0;56,094722;12,385
1705;"Dronningmølle";"no";0;0;0;56,094722;12,385
1706;"Dronningmølle";"no";0;0;0;56,094722;12,385
1707;"Dronningmølle";"no";0;0;0;56,094722;12,385
1708;"Dronningmølle";"no";0;0;0;56,094722;12,385
1709;"Dronningmølle";"no";0;0;0;56,094722;12,385
1710;"Dronningmølle";"no";0;0;0;56,094722;12,385
1711;"Dronningmølle";"no";0;0;0;56,094722;12,385
1712;"Dronningmølle";"no";0;0;0;56,094722;12,385
1713;"Dronningmølle";"no";0;0;0;56,094722;12,385
1714;"Dronningmølle";"no";0;0;0;56,094722;12,385
1715;"Dronningmølle";"no";0;0;0;56,094722;12,385
1716;"Dronningmølle";"no";0;0;0;56,094722;12,385
1717;"Dronningmølle";"no";0;0;0;56,094722;12,385
1718;"Dronningmølle";"no";0;0;0;56,094722;12,385
1719;"Dronningmølle";"no";0;0;0;56,094722;12,385
1720;"Dronningmølle";"no";0;0;0;56,094722;12,385
1721;"Dronningmølle";"no";0;0;0;56,094722;12,385
1722;"Dronningmølle";"no";0;0;0;56,094722;12,385
1723;"Dronningmølle";"no";0;0;0;56,094722;12,385
1724;"Dronningmølle";"no";0;0;0;56,094722;12,385
1725;"Dronningmølle";"no";0;0;0;56,094722;12,385
1726;"Dronningmølle";"no";0;0;0;56,094722;12,385
1727;"Dronningmølle";"no";0;0;0;56,094722;12,385
1728;"Dronningmølle";"no";0;0;0;56,094722;12,385
1729;"Dronningmølle";"no";0;0;0;56,094722;12,385
1730;"Dronningmølle";"no";0;0;0;56,094722;12,385
1731;"Dronningmølle";"no";0;0;0;56,094722;12,385
1732;"Dronningmølle";"no";0;0;0;56,094722;12,385
1733;"Dronningmølle";"no";0;0;0;56,094722;12,385
1734;"Dronningmølle";"no";0;0;0;56,094722;12,385
1735;"Dronningmølle";"no";0;0;0;56,094722;12,385
1736;"Dronningmølle";"no";0;0;0;56,094722;12,385
1737;"Dronningmølle";"no";0;0;0;56,094722;12,385
1738;"Dronningmølle";"no";0;0;0;56,094722;12,385
1739;"Dronningmølle";"no";0;0;0;56,094722;12,385
1740;"Dronningmølle";"no";0;0;0;56,094722;12,385
1741;"Dronningmølle";"no";0;0;0;56,094722;12,385
1742;"Dronningmølle";"no";0;0;0;56,094722;12,385
1743;"Dronningmølle";"no";0;0;0;56,094722;12,385
1744;"Dronningmølle";"no";0;0;0;56,094722;12,385
1745;"Dronningmølle";"no";0;0;0;56,094722;12,385
1746;"Dronningmølle";"no";0;0;0;56,094722;12,385
1747;"Dronningmølle";"no";0;0;0;56,094722;12,385
1748;"Dronningmølle";"no";0;0;0;56,094722;12,385
1749;"Dronningmølle";"no";0;0;0;56,094722;12,385
1750;"Dronningmølle";"no";0;0;0;56,094722;12,385
1751;"Dronningmølle";"no";0;0;0;56,094722;12,385
1752;"Dronningmølle";"no";0;0;0;56,094722;12,385
1753;"Dronningmølle";"no";0;0;0;56,094722;12,385
1754;"Dronningmølle";"no";0;0;0;56,094722;12,385
1755;"Dronningmølle";"no";0;0;0;56,094722;12,385
1756;"Dronningmølle";"no";0;0;0;56,094722;12,385
1757;"Dronningmølle";"no";0;0;0;56,094722;12,385
1758;"Dronningmølle";"no";0;0;0;56,094722;12,385
1759;"Dronningmølle";"no";0;0;0;56,094722;12,385
1760;"Dronningmølle";"no";0;0;0;56,094722;12,385
1761;"Dronningmølle";"no";0;0;0;56,094722;12,385
1762;"Dronningmølle";"no";0;0;0;56,094722;12,385
1763;"Dronningmølle";"no";0;0;0;56,094722;12,385
1764;"Dronningmølle";"no";0;0;0;56,094722;12,385
1765;"Dronningmølle";"no";0;0;0;56,094722;12,385
1766;"Dronningmølle";"no";0;0;0;56,094722;12,385
1767;"Dronningmølle";"no";0;0;0;56,094722;12,385
1768;"Dronningmølle";"no";0;0;0;56,094722;12,385
1769;"Dronningmølle";"no";0;0;0;56,094722;12,385
1770;"Dronningmølle";"no";0;0;0;56,094722;12,385
1771;"Dronningmølle";"no";0;0;0;56,094722;12,385
1772;"Dronningmølle";"no";0;0;0;56,094722;12,385
1773;"Dronningmølle";"no";0;0;0;56,094722;12,385
1774;"Dronningmølle";"no";0;0;0;56,094722;12,385
1775;"Dronningmølle";"no";0;0;0;56,094722;12,385
1776;"Dronningmølle";"no";0;0;0;56,094722;12,385
1777;"Dronningmølle";"no";0;0;0;56,094722;12,385
1778;"Dronningmølle";"no";0;0;0;56,094722;12,385
1779;"Dronningmølle";"no";0;0;0;56,094722;12,385
1780;"Dronningmølle";"no";0;0;0;56,094722;12,385
1781;"Dronningmølle";"no";0;0;0;56,094722;12,385
1782;"Dronningmølle";"no";0;0;0;56,094722;12,385
1783;"Dronningmølle";"no";0;0;0;56,094722;12,385
1784;"Dronningmølle";"no";0;0;0;56,094722;12,385
1785;"Dronningmølle";"no";0;0;0;56,094722;12,385
1786;"Dronningmølle";"no";0;0;0;56,094722;12,385
1787;"Dronningmølle";"no";0;0;0;56,094722;12,385
1788;"Dronningmølle";"no";0;0;0;56,094722;12,385
1789;"Dronningmølle";"no";0;0;0;56,094722;12,385
1790;"Dronningmølle";"no";0;0;0;56,094722;12,385
1791;"Dronningmølle";"no";0;0;0;56,094722;12,385
1792;"Dronningmølle";"no";0;0;0;56,094722;12,385
1793;"Dronningmølle";"no";0;0;0;56,094722;12,385
1794;"Dronningmølle";"no";0;0;0;56,094722;12,385
1795;"Dronningmølle";"no";0;0;0;56,094722;12,385
1796;"Dronningmølle";"no";0;0;0;56,094722;12,385
1797;"Dronningmølle";"no";0;0;0;56,094722;12,385
1798;"Dronningmølle";"no";0;0;0;56,094722;12,385
1799;"Dronningmølle";"no";0;0;0;56,094722;12,385
1800;"Dronningmølle";"no";0;0;0;56,094722;12,385
1801;"Dronningmølle";"no";0;0;0;56,094722;12,385
1802;"Dronningmølle";"no";0;0;0;56,094722;12,385
1803;"Dronningmølle";"no";0;0;0;56,094722;12,385
1804;"Dronningmølle";"no";0;0;0;56,094722;12,385
1805;"Dronningmølle";"no";0;0;0;56,094722;12,385
1806;"Dronningmølle";"no";0;0;0;56,094722;12,385
1807;"Dronningmølle";"no";0;0;0;56,094722;12,385
1808;"Dronningmølle";"no";0;0;0;56,094722;12,385
1809;"Dronningmølle";"no";0;0;0;56,094722;12,385
1810;"Dronningmølle";"no";0;0;0;56,094722;12,385
1811;"Dronningmølle";"no";0;1;1;56,094722;12,385
1812;"Dronningmølle";"no";0;0;0;56,094722;12,385
1813;"Dronningmølle";"no";0;0;0;56,094722;12,385
1814;"Dronningmølle";"no";0;0;0;56,094722;12,385
1815;"Dronningmølle";"no";0;0;0;56,094722;12,385
1816;"Dronningmølle";"no";0;0;0;56,094722;12,385
1817;"Dronningmølle";"no";0;0;0;56,094722;12,385
1818;"Dronningmølle";"no";0;0;0;56,094722;12,385
1819;"Dronningmølle";"no";0;0;0;56,094722;12,385
1820;"Dronningmølle";"no";0;0;0;56,094722;12,385
1821;"Dronningmølle";"no";0;0;0;56,094722;12,385
1822;"Dronningmølle";"no";0;0;0;56,094722;12,385
1823;"Dronningmølle";"no";0;0;0;56,094722;12,385
1824;"Dronningmølle";"no";0;0;0;56,094722;12,385
1825;"Dronningmølle";"no";0;0;0;56,094722;12,385
1826;"Dronningmølle";"no";0;0;0;56,094722;12,385
1827;"Dronningmølle";"no";0;0;0;56,094722;12,385
1828;"Dronningmølle";"no";0;0;0;56,094722;12,385
1829;"Dronningmølle";"no";0;0;0;56,094722;12,385
1830;"Dronningmølle";"no";0;0;0;56,094722;12,385
1831;"Dronningmølle";"no";0;0;0;56,094722;12,385
1832;"Dronningmølle";"no";0;0;0;56,094722;12,385
1833;"Dronningmølle";"no";0;0;0;56,094722;12,385
1834;"Dronningmølle";"no";0;0;0;56,094722;12,385
1835;"Dronningmølle";"no";0;0;0;56,094722;12,385
1836;"Dronningmølle";"no";0;0;0;56,094722;12,385
1837;"Dronningmølle";"no";0;0;0;56,094722;12,385
1838;"Dronningmølle";"no";0;0;0;56,094722;12,385
1839;"Dronningmølle";"no";0;0;0;56,094722;12,385
1840;"Dronningmølle";"no";0;0;0;56,094722;12,385
1841;"Dronningmølle";"no";0;0;0;56,094722;12,385
1842;"Dronningmølle";"no";0;0;0;56,094722;12,385
1843;"Dronningmølle";"no";0;0;0;56,094722;12,385
1844;"Dronningmølle";"no";0;0;0;56,094722;12,385
1845;"Dronningmølle";"no";1;1;2;56,094722;12,385
1846;"Dronningmølle";"no";0;0;0;56,094722;12,385
1847;"Dronningmølle";"no";0;0;0;56,094722;12,385
1848;"Dronningmølle";"no";0;0;0;56,094722;12,385
1849;"Dronningmølle";"no";0;0;0;56,094722;12,385
1850;"Dronningmølle";"no";0;0;0;56,094722;12,385
1851;"Dronningmølle";"no";0;0;0;56,094722;12,385
1852;"Dronningmølle";"no";0;1;1;56,094722;12,385
1853;"Dronningmølle";"no";0;0;0;56,094722;12,385
1854;"Dronningmølle";"no";0;0;0;56,094722;12,385
1855;"Dronningmølle";"no";0;0;0;56,094722;12,385
1856;"Dronningmølle";"no";0;0;0;56,094722;12,385
1857;"Dronningmølle";"no";0;0;0;56,094722;12,385
1634;"Kjargaard";"no";0;0;0;54,98354;8,706111
1635;"Kjargaard";"no";0;0;0;54,98354;8,706111
1636;"Kjargaard";"no";0;0;0;54,98354;8,706111
1637;"Kjargaard";"no";0;0;0;54,98354;8,706111
1638;"Kjargaard";"no";0;0;0;54,98354;8,706111
1639;"Kjargaard";"no";0;0;0;54,98354;8,706111
1640;"Kjargaard";"no";0;0;0;54,98354;8,706111
1641;"Kjargaard";"no";0;0;0;54,98354;8,706111
1642;"Kjargaard";"no";0;0;0;54,98354;8,706111
1643;"Kjargaard";"no";0;0;0;54,98354;8,706111
1644;"Kjargaard";"no";0;0;0;54,98354;8,706111
1645;"Kjargaard";"no";0;0;0;54,98354;8,706111
1646;"Kjargaard";"no";0;0;0;54,98354;8,706111
1647;"Kjargaard";"no";0;0;0;54,98354;8,706111
1648;"Kjargaard";"no";0;0;0;54,98354;8,706111
1649;"Kjargaard";"no";0;0;0;54,98354;8,706111
1650;"Kjargaard";"no";0;0;0;54,98354;8,706111
1651;"Kjargaard";"no";0;0;0;54,98354;8,706111
1652;"Kjargaard";"no";0;0;0;54,98354;8,706111
1653;"Kjargaard";"no";0;0;0;54,98354;8,706111
1654;"Kjargaard";"no";0;0;0;54,98354;8,706111
1655;"Kjargaard";"no";0;0;0;54,98354;8,706111
1656;"Kjargaard";"no";0;0;0;54,98354;8,706111
1657;"Kjargaard";"no";0;0;0;54,98354;8,706111
1658;"Kjargaard";"no";0;0;0;54,98354;8,706111
1659;"Kjargaard";"no";0;0;0;54,98354;8,706111
1660;"Kjargaard";"no";0;0;0;54,98354;8,706111
1661;"Kjargaard";"no";0;0;0;54,98354;8,706111
1662;"Kjargaard";"no";0;0;0;54,98354;8,706111
1663;"Kjargaard";"no";0;0;0;54,98354;8,706111
1664;"Kjargaard";"no";0;0;0;54,98354;8,706111
1665;"Kjargaard";"no";0;0;0;54,98354;8,706111
1666;"Kjargaard";"no";0;0;0;54,98354;8,706111
1667;"Kjargaard";"no";0;0;0;54,98354;8,706111
1668;"Kjargaard";"no";0;0;0;54,98354;8,706111
1669;"Kjargaard";"no";0;0;0;54,98354;8,706111
1670;"Kjargaard";"no";0;0;0;54,98354;8,706111
1671;"Kjargaard";"no";0;0;0;54,98354;8,706111
1672;"Kjargaard";"no";0;0;0;54,98354;8,706111
1673;"Kjargaard";"no";0;0;0;54,98354;8,706111
1674;"Kjargaard";"no";0;0;0;54,98354;8,706111
1675;"Kjargaard";"no";0;0;0;54,98354;8,706111
1676;"Kjargaard";"no";0;0;0;54,98354;8,706111
1677;"Kjargaard";"no";0;0;0;54,98354;8,706111
1678;"Kjargaard";"no";0;0;0;54,98354;8,706111
1679;"Kjargaard";"no";0;0;0;54,98354;8,706111
1680;"Kjargaard";"no";0;0;0;54,98354;8,706111
1681;"Kjargaard";"no";0;0;0;54,98354;8,706111
1682;"Kjargaard";"no";0;0;0;54,98354;8,706111
1683;"Kjargaard";"no";0;0;0;54,98354;8,706111
1684;"Kjargaard";"no";0;0;0;54,98354;8,706111
1685;"Kjargaard";"no";0;0;0;54,98354;8,706111
1686;"Kjargaard";"no";0;0;0;54,98354;8,706111
1687;"Kjargaard";"no";0;0;0;54,98354;8,706111
1688;"Kjargaard";"no";0;0;0;54,98354;8,706111
1689;"Kjargaard";"no";0;0;0;54,98354;8,706111
1690;"Kjargaard";"no";0;0;0;54,98354;8,706111
1691;"Kjargaard";"no";0;0;0;54,98354;8,706111
1692;"Kjargaard";"no";0;0;0;54,98354;8,706111
1693;"Kjargaard";"no";0;0;0;54,98354;8,706111
1694;"Kjargaard";"no";0;0;0;54,98354;8,706111
1695;"Kjargaard";"no";0;0;0;54,98354;8,706111
1696;"Kjargaard";"no";0;0;0;54,98354;8,706111
1697;"Kjargaard";"no";0;0;0;54,98354;8,706111
1698;"Kjargaard";"no";0;0;0;54,98354;8,706111
1699;"Kjargaard";"no";0;0;0;54,98354;8,706111
1700;"Kjargaard";"no";0;0;0;54,98354;8,706111
1701;"Kjargaard";"no";0;0;0;54,98354;8,706111
1702;"Kjargaard";"no";0;0;0;54,98354;8,706111
1703;"Kjargaard";"no";0;0;0;54,98354;8,706111
1704;"Kjargaard";"no";0;0;0;54,98354;8,706111
1705;"Kjargaard";"no";0;0;0;54,98354;8,706111
1706;"Kjargaard";"no";0;0;0;54,98354;8,706111
1707;"Kjargaard";"no";0;0;0;54,98354;8,706111
1708;"Kjargaard";"no";0;0;0;54,98354;8,706111
1709;"Kjargaard";"no";0;0;0;54,98354;8,706111
1710;"Kjargaard";"no";0;0;0;54,98354;8,706111
1711;"Kjargaard";"no";0;0;0;54,98354;8,706111
1712;"Kjargaard";"no";0;0;0;54,98354;8,706111
1713;"Kjargaard";"no";0;0;0;54,98354;8,706111
1714;"Kjargaard";"no";0;0;0;54,98354;8,706111
1715;"Kjargaard";"no";0;0;0;54,98354;8,706111
1716;"Kjargaard";"no";0;0;0;54,98354;8,706111
1717;"Kjargaard";"no";0;0;0;54,98354;8,706111
1718;"Kjargaard";"no";0;0;0;54,98354;8,706111
1719;"Kjargaard";"no";0;0;0;54,98354;8,706111
1720;"Kjargaard";"no";0;0;0;54,98354;8,706111
1721;"Kjargaard";"no";0;0;0;54,98354;8,706111
1722;"Kjargaard";"no";0;0;0;54,98354;8,706111
1723;"Kjargaard";"no";0;0;0;54,98354;8,706111
1724;"Kjargaard";"no";0;0;0;54,98354;8,706111
1725;"Kjargaard";"no";0;0;0;54,98354;8,706111
1726;"Kjargaard";"no";0;0;0;54,98354;8,706111
1727;"Kjargaard";"no";0;0;0;54,98354;8,706111
1728;"Kjargaard";"no";0;0;0;54,98354;8,706111
1729;"Kjargaard";"no";0;0;0;54,98354;8,706111
1730;"Kjargaard";"no";0;0;0;54,98354;8,706111
1731;"Kjargaard";"no";0;0;0;54,98354;8,706111
1732;"Kjargaard";"no";0;0;0;54,98354;8,706111
1733;"Kjargaard";"no";0;0;0;54,98354;8,706111
1734;"Kjargaard";"no";0;0;0;54,98354;8,706111
1735;"Kjargaard";"no";0;0;0;54,98354;8,706111
1736;"Kjargaard";"no";0;0;0;54,98354;8,706111
1737;"Kjargaard";"no";0;0;0;54,98354;8,706111
1738;"Kjargaard";"no";0;0;0;54,98354;8,706111
1739;"Kjargaard";"no";0;0;0;54,98354;8,706111
1740;"Kjargaard";"no";0;0;0;54,98354;8,706111
1741;"Kjargaard";"no";0;0;0;54,98354;8,706111
1742;"Kjargaard";"no";0;0;0;54,98354;8,706111
1743;"Kjargaard";"no";0;0;0;54,98354;8,706111
1744;"Kjargaard";"no";0;0;0;54,98354;8,706111
1745;"Kjargaard";"no";0;0;0;54,98354;8,706111
1746;"Kjargaard";"no";0;0;0;54,98354;8,706111
1747;"Kjargaard";"no";0;0;0;54,98354;8,706111
1748;"Kjargaard";"no";0;0;0;54,98354;8,706111
1749;"Kjargaard";"no";0;0;0;54,98354;8,706111
1750;"Kjargaard";"no";0;0;0;54,98354;8,706111
1751;"Kjargaard";"no";0;0;0;54,98354;8,706111
1752;"Kjargaard";"no";0;0;0;54,98354;8,706111
1753;"Kjargaard";"no";0;0;0;54,98354;8,706111
1754;"Kjargaard";"no";0;0;0;54,98354;8,706111
1755;"Kjargaard";"no";0;0;0;54,98354;8,706111
1756;"Kjargaard";"no";0;0;0;54,98354;8,706111
1757;"Kjargaard";"no";0;0;0;54,98354;8,706111
1758;"Kjargaard";"no";0;0;0;54,98354;8,706111
1759;"Kjargaard";"no";0;0;0;54,98354;8,706111
1760;"Kjargaard";"no";0;0;0;54,98354;8,706111
1761;"Kjargaard";"no";0;0;0;54,98354;8,706111
1762;"Kjargaard";"no";0;0;0;54,98354;8,706111
1763;"Kjargaard";"no";0;0;0;54,98354;8,706111
1764;"Kjargaard";"no";0;0;0;54,98354;8,706111
1765;"Kjargaard";"no";0;0;0;54,98354;8,706111
1766;"Kjargaard";"no";0;0;0;54,98354;8,706111
1767;"Kjargaard";"no";0;0;0;54,98354;8,706111
1768;"Kjargaard";"no";0;0;0;54,98354;8,706111
1769;"Kjargaard";"no";0;0;0;54,98354;8,706111
1770;"Kjargaard";"no";0;0;0;54,98354;8,706111
1771;"Kjargaard";"no";0;0;0;54,98354;8,706111
1772;"Kjargaard";"no";0;0;0;54,98354;8,706111
1773;"Kjargaard";"no";0;0;0;54,98354;8,706111
1774;"Kjargaard";"no";0;0;0;54,98354;8,706111
1775;"Kjargaard";"no";0;0;0;54,98354;8,706111
1776;"Kjargaard";"no";0;0;0;54,98354;8,706111
1777;"Kjargaard";"no";0;0;0;54,98354;8,706111
1778;"Kjargaard";"no";0;0;0;54,98354;8,706111
1779;"Kjargaard";"no";0;0;0;54,98354;8,706111
1780;"Kjargaard";"no";0;0;0;54,98354;8,706111
1781;"Kjargaard";"no";0;0;0;54,98354;8,706111
1782;"Kjargaard";"no";0;0;0;54,98354;8,706111
1783;"Kjargaard";"no";0;0;0;54,98354;8,706111
1784;"Kjargaard";"no";0;0;0;54,98354;8,706111
1785;"Kjargaard";"no";0;0;0;54,98354;8,706111
1786;"Kjargaard";"no";0;0;0;54,98354;8,706111
1787;"Kjargaard";"no";0;0;0;54,98354;8,706111
1788;"Kjargaard";"no";0;0;0;54,98354;8,706111
1789;"Kjargaard";"no";0;0;0;54,98354;8,706111
1790;"Kjargaard";"no";0;0;0;54,98354;8,706111
1791;"Kjargaard";"no";0;0;0;54,98354;8,706111
1792;"Kjargaard";"no";0;0;0;54,98354;8,706111
1793;"Kjargaard";"no";0;0;0;54,98354;8,706111
1794;"Kjargaard";"no";0;0;0;54,98354;8,706111
1795;"Kjargaard";"no";0;0;0;54,98354;8,706111
1796;"Kjargaard";"no";0;0;0;54,98354;8,706111
1797;"Kjargaard";"no";0;0;0;54,98354;8,706111
1798;"Kjargaard";"no";0;0;0;54,98354;8,706111
1799;"Kjargaard";"no";0;0;0;54,98354;8,706111
1800;"Kjargaard";"no";0;0;0;54,98354;8,706111
1801;"Kjargaard";"no";0;0;0;54,98354;8,706111
1802;"Kjargaard";"no";0;0;0;54,98354;8,706111
1803;"Kjargaard";"no";0;0;0;54,98354;8,706111
1804;"Kjargaard";"no";0;0;0;54,98354;8,706111
1805;"Kjargaard";"no";0;0;0;54,98354;8,706111
1806;"Kjargaard";"no";0;0;0;54,98354;8,706111
1807;"Kjargaard";"no";0;0;0;54,98354;8,706111
1808;"Kjargaard";"no";0;0;0;54,98354;8,706111
1809;"Kjargaard";"no";0;0;0;54,98354;8,706111
1810;"Kjargaard";"no";0;0;0;54,98354;8,706111
1811;"Kjargaard";"no";0;0;0;54,98354;8,706111
1812;"Kjargaard";"no";0;0;0;54,98354;8,706111
1813;"Kjargaard";"no";0;0;0;54,98354;8,706111
1814;"Kjargaard";"no";0;0;0;54,98354;8,706111
1815;"Kjargaard";"no";0;0;0;54,98354;8,706111
1816;"Kjargaard";"no";0;0;0;54,98354;8,706111
1817;"Kjargaard";"no";0;0;0;54,98354;8,706111
1818;"Kjargaard";"no";0;0;0;54,98354;8,706111
1819;"Kjargaard";"no";0;0;0;54,98354;8,706111
1820;"Kjargaard";"no";0;0;0;54,98354;8,706111
1821;"Kjargaard";"no";0;0;0;54,98354;8,706111
1822;"Kjargaard";"no";0;0;0;54,98354;8,706111
1823;"Kjargaard";"no";0;0;0;54,98354;8,706111
1824;"Kjargaard";"no";0;0;0;54,98354;8,706111
1825;"Kjargaard";"no";0;0;0;54,98354;8,706111
1826;"Kjargaard";"no";0;0;0;54,98354;8,706111
1827;"Kjargaard";"no";0;0;0;54,98354;8,706111
1828;"Kjargaard";"no";0;0;0;54,98354;8,706111
1829;"Kjargaard";"no";0;0;0;54,98354;8,706111
1830;"Kjargaard";"no";0;0;0;54,98354;8,706111
1831;"Kjargaard";"no";0;0;0;54,98354;8,706111
1832;"Kjargaard";"no";0;0;0;54,98354;8,706111
1833;"Kjargaard";"no";0;0;0;54,98354;8,706111
1834;"Kjargaard";"no";0;0;0;54,98354;8,706111
1835;"Kjargaard";"no";0;0;0;54,98354;8,706111
1836;"Kjargaard";"no";0;0;0;54,98354;8,706111
1837;"Kjargaard";"no";0;0;0;54,98354;8,706111
1838;"Kjargaard";"no";0;0;0;54,98354;8,706111
1839;"Kjargaard";"no";0;0;0;54,98354;8,706111
1840;"Kjargaard";"no";0;0;0;54,98354;8,706111
1841;"Kjargaard";"no";0;0;0;54,98354;8,706111
1842;"Kjargaard";"no";0;0;0;54,98354;8,706111
1843;"Kjargaard";"no";0;0;0;54,98354;8,706111
1844;"Kjargaard";"no";0;0;0;54,98354;8,706111
1845;"Kjargaard";"no";1;0;1;54,98354;8,706111
1846;"Kjargaard";"no";0;0;0;54,98354;8,706111
1847;"Kjargaard";"no";0;0;0;54,98354;8,706111
1848;"Kjargaard";"no";0;0;0;54,98354;8,706111
1849;"Kjargaard";"no";0;0;0;54,98354;8,706111
1850;"Kjargaard";"no";0;0;0;54,98354;8,706111
1851;"Kjargaard";"no";0;0;0;54,98354;8,706111
1852;"Kjargaard";"no";0;0;0;54,98354;8,706111
1853;"Kjargaard";"no";0;0;0;54,98354;8,706111
1854;"Kjargaard";"no";0;0;0;54,98354;8,706111
1855;"Kjargaard";"no";0;0;0;54,98354;8,706111
1856;"Kjargaard";"no";0;0;0;54,98354;8,706111
1857;"Kjargaard";"no";0;0;0;54,98354;8,706111
1634;"Mullerup";"no";0;0;0;55,491666;11,2
1635;"Mullerup";"no";0;0;0;55,491666;11,2
1636;"Mullerup";"no";0;0;0;55,491666;11,2
1637;"Mullerup";"no";0;0;0;55,491666;11,2
1638;"Mullerup";"no";0;0;0;55,491666;11,2
1639;"Mullerup";"no";0;0;0;55,491666;11,2
1640;"Mullerup";"no";0;0;0;55,491666;11,2
1641;"Mullerup";"no";0;0;0;55,491666;11,2
1642;"Mullerup";"no";0;0;0;55,491666;11,2
1643;"Mullerup";"no";0;0;0;55,491666;11,2
1644;"Mullerup";"no";0;0;0;55,491666;11,2
1645;"Mullerup";"no";0;0;0;55,491666;11,2
1646;"Mullerup";"no";0;0;0;55,491666;11,2
1647;"Mullerup";"no";0;0;0;55,491666;11,2
1648;"Mullerup";"no";0;0;0;55,491666;11,2
1649;"Mullerup";"no";0;0;0;55,491666;11,2
1650;"Mullerup";"no";0;0;0;55,491666;11,2
1651;"Mullerup";"no";0;0;0;55,491666;11,2
1652;"Mullerup";"no";0;0;0;55,491666;11,2
1653;"Mullerup";"no";0;0;0;55,491666;11,2
1654;"Mullerup";"no";0;0;0;55,491666;11,2
1655;"Mullerup";"no";0;0;0;55,491666;11,2
1656;"Mullerup";"no";0;0;0;55,491666;11,2
1657;"Mullerup";"no";0;0;0;55,491666;11,2
1658;"Mullerup";"no";0;0;0;55,491666;11,2
1659;"Mullerup";"no";0;0;0;55,491666;11,2
1660;"Mullerup";"no";0;0;0;55,491666;11,2
1661;"Mullerup";"no";0;0;0;55,491666;11,2
1662;"Mullerup";"no";0;0;0;55,491666;11,2
1663;"Mullerup";"no";0;0;0;55,491666;11,2
1664;"Mullerup";"no";0;0;0;55,491666;11,2
1665;"Mullerup";"no";0;0;0;55,491666;11,2
1666;"Mullerup";"no";0;0;0;55,491666;11,2
1667;"Mullerup";"no";0;0;0;55,491666;11,2
1668;"Mullerup";"no";0;0;0;55,491666;11,2
1669;"Mullerup";"no";0;0;0;55,491666;11,2
1670;"Mullerup";"no";0;0;0;55,491666;11,2
1671;"Mullerup";"no";0;0;0;55,491666;11,2
1672;"Mullerup";"no";0;0;0;55,491666;11,2
1673;"Mullerup";"no";0;0;0;55,491666;11,2
1674;"Mullerup";"no";0;0;0;55,491666;11,2
1675;"Mullerup";"no";0;0;0;55,491666;11,2
1676;"Mullerup";"no";0;0;0;55,491666;11,2
1677;"Mullerup";"no";0;0;0;55,491666;11,2
1678;"Mullerup";"no";0;0;0;55,491666;11,2
1679;"Mullerup";"no";0;0;0;55,491666;11,2
1680;"Mullerup";"no";0;0;0;55,491666;11,2
1681;"Mullerup";"no";0;0;0;55,491666;11,2
1682;"Mullerup";"no";0;0;0;55,491666;11,2
1683;"Mullerup";"no";0;0;0;55,491666;11,2
1684;"Mullerup";"no";0;0;0;55,491666;11,2
1685;"Mullerup";"no";0;0;0;55,491666;11,2
1686;"Mullerup";"no";0;0;0;55,491666;11,2
1687;"Mullerup";"no";0;0;0;55,491666;11,2
1688;"Mullerup";"no";0;0;0;55,491666;11,2
1689;"Mullerup";"no";0;0;0;55,491666;11,2
1690;"Mullerup";"no";0;0;0;55,491666;11,2
1691;"Mullerup";"no";0;0;0;55,491666;11,2
1692;"Mullerup";"no";0;0;0;55,491666;11,2
1693;"Mullerup";"no";0;0;0;55,491666;11,2
1694;"Mullerup";"no";0;0;0;55,491666;11,2
1695;"Mullerup";"no";0;0;0;55,491666;11,2
1696;"Mullerup";"no";0;0;0;55,491666;11,2
1697;"Mullerup";"no";0;0;0;55,491666;11,2
1698;"Mullerup";"no";0;0;0;55,491666;11,2
1699;"Mullerup";"no";0;0;0;55,491666;11,2
1700;"Mullerup";"no";0;0;0;55,491666;11,2
1701;"Mullerup";"no";0;0;0;55,491666;11,2
1702;"Mullerup";"no";0;0;0;55,491666;11,2
1703;"Mullerup";"no";0;0;0;55,491666;11,2
1704;"Mullerup";"no";0;0;0;55,491666;11,2
1705;"Mullerup";"no";0;0;0;55,491666;11,2
1706;"Mullerup";"no";0;0;0;55,491666;11,2
1707;"Mullerup";"no";0;0;0;55,491666;11,2
1708;"Mullerup";"no";0;0;0;55,491666;11,2
1709;"Mullerup";"no";0;0;0;55,491666;11,2
1710;"Mullerup";"no";0;0;0;55,491666;11,2
1711;"Mullerup";"no";0;0;0;55,491666;11,2
1712;"Mullerup";"no";0;0;0;55,491666;11,2
1713;"Mullerup";"no";0;0;0;55,491666;11,2
1714;"Mullerup";"no";0;0;0;55,491666;11,2
1715;"Mullerup";"no";0;0;0;55,491666;11,2
1716;"Mullerup";"no";0;0;0;55,491666;11,2
1717;"Mullerup";"no";0;0;0;55,491666;11,2
1718;"Mullerup";"no";0;0;0;55,491666;11,2
1719;"Mullerup";"no";0;0;0;55,491666;11,2
1720;"Mullerup";"no";0;0;0;55,491666;11,2
1721;"Mullerup";"no";0;0;0;55,491666;11,2
1722;"Mullerup";"no";0;0;0;55,491666;11,2
1723;"Mullerup";"no";0;0;0;55,491666;11,2
1724;"Mullerup";"no";0;0;0;55,491666;11,2
1725;"Mullerup";"no";0;0;0;55,491666;11,2
1726;"Mullerup";"no";0;0;0;55,491666;11,2
1727;"Mullerup";"no";0;0;0;55,491666;11,2
1728;"Mullerup";"no";0;0;0;55,491666;11,2
1729;"Mullerup";"no";0;0;0;55,491666;11,2
1730;"Mullerup";"no";0;0;0;55,491666;11,2
1731;"Mullerup";"no";0;0;0;55,491666;11,2
1732;"Mullerup";"no";0;0;0;55,491666;11,2
1733;"Mullerup";"no";0;0;0;55,491666;11,2
1734;"Mullerup";"no";0;0;0;55,491666;11,2
1735;"Mullerup";"no";0;0;0;55,491666;11,2
1736;"Mullerup";"no";0;0;0;55,491666;11,2
1737;"Mullerup";"no";0;0;0;55,491666;11,2
1738;"Mullerup";"no";0;0;0;55,491666;11,2
1739;"Mullerup";"no";0;0;0;55,491666;11,2
1740;"Mullerup";"no";0;0;0;55,491666;11,2
1741;"Mullerup";"no";0;0;0;55,491666;11,2
1742;"Mullerup";"no";0;0;0;55,491666;11,2
1743;"Mullerup";"no";0;0;0;55,491666;11,2
1744;"Mullerup";"no";0;0;0;55,491666;11,2
1745;"Mullerup";"no";0;0;0;55,491666;11,2
1746;"Mullerup";"no";0;0;0;55,491666;11,2
1747;"Mullerup";"no";0;0;0;55,491666;11,2
1748;"Mullerup";"no";0;0;0;55,491666;11,2
1749;"Mullerup";"no";0;0;0;55,491666;11,2
1750;"Mullerup";"no";0;0;0;55,491666;11,2
1751;"Mullerup";"no";0;0;0;55,491666;11,2
1752;"Mullerup";"no";0;0;0;55,491666;11,2
1753;"Mullerup";"no";0;0;0;55,491666;11,2
1754;"Mullerup";"no";0;0;0;55,491666;11,2
1755;"Mullerup";"no";0;0;0;55,491666;11,2
1756;"Mullerup";"no";0;0;0;55,491666;11,2
1757;"Mullerup";"no";0;0;0;55,491666;11,2
1758;"Mullerup";"no";0;0;0;55,491666;11,2
1759;"Mullerup";"no";0;0;0;55,491666;11,2
1760;"Mullerup";"no";0;0;0;55,491666;11,2
1761;"Mullerup";"no";0;0;0;55,491666;11,2
1762;"Mullerup";"no";0;0;0;55,491666;11,2
1763;"Mullerup";"no";0;0;0;55,491666;11,2
1764;"Mullerup";"no";0;0;0;55,491666;11,2
1765;"Mullerup";"no";0;0;0;55,491666;11,2
1766;"Mullerup";"no";0;0;0;55,491666;11,2
1767;"Mullerup";"no";0;0;0;55,491666;11,2
1768;"Mullerup";"no";0;0;0;55,491666;11,2
1769;"Mullerup";"no";0;0;0;55,491666;11,2
1770;"Mullerup";"no";0;0;0;55,491666;11,2
1771;"Mullerup";"no";0;0;0;55,491666;11,2
1772;"Mullerup";"no";0;0;0;55,491666;11,2
1773;"Mullerup";"no";0;0;0;55,491666;11,2
1774;"Mullerup";"no";0;0;0;55,491666;11,2
1775;"Mullerup";"no";0;0;0;55,491666;11,2
1776;"Mullerup";"no";0;0;0;55,491666;11,2
1777;"Mullerup";"no";0;0;0;55,491666;11,2
1778;"Mullerup";"no";0;0;0;55,491666;11,2
1779;"Mullerup";"no";0;0;0;55,491666;11,2
1780;"Mullerup";"no";0;0;0;55,491666;11,2
1781;"Mullerup";"no";0;0;0;55,491666;11,2
1782;"Mullerup";"no";0;0;0;55,491666;11,2
1783;"Mullerup";"no";0;0;0;55,491666;11,2
1784;"Mullerup";"no";0;0;0;55,491666;11,2
1785;"Mullerup";"no";0;0;0;55,491666;11,2
1786;"Mullerup";"no";0;0;0;55,491666;11,2
1787;"Mullerup";"no";0;0;0;55,491666;11,2
1788;"Mullerup";"no";0;0;0;55,491666;11,2
1789;"Mullerup";"no";0;0;0;55,491666;11,2
1790;"Mullerup";"no";0;0;0;55,491666;11,2
1791;"Mullerup";"no";0;0;0;55,491666;11,2
1792;"Mullerup";"no";0;0;0;55,491666;11,2
1793;"Mullerup";"no";0;0;0;55,491666;11,2
1794;"Mullerup";"no";0;0;0;55,491666;11,2
1795;"Mullerup";"no";0;0;0;55,491666;11,2
1796;"Mullerup";"no";0;0;0;55,491666;11,2
1797;"Mullerup";"no";0;0;0;55,491666;11,2
1798;"Mullerup";"no";0;0;0;55,491666;11,2
1799;"Mullerup";"no";0;0;0;55,491666;11,2
1800;"Mullerup";"no";0;0;0;55,491666;11,2
1801;"Mullerup";"no";0;0;0;55,491666;11,2
1802;"Mullerup";"no";0;0;0;55,491666;11,2
1803;"Mullerup";"no";0;0;0;55,491666;11,2
1804;"Mullerup";"no";0;0;0;55,491666;11,2
1805;"Mullerup";"no";0;0;0;55,491666;11,2
1806;"Mullerup";"no";0;0;0;55,491666;11,2
1807;"Mullerup";"no";0;0;0;55,491666;11,2
1808;"Mullerup";"no";0;0;0;55,491666;11,2
1809;"Mullerup";"no";0;0;0;55,491666;11,2
1810;"Mullerup";"no";0;0;0;55,491666;11,2
1811;"Mullerup";"no";0;0;0;55,491666;11,2
1812;"Mullerup";"no";0;0;0;55,491666;11,2
1813;"Mullerup";"no";0;0;0;55,491666;11,2
1814;"Mullerup";"no";0;0;0;55,491666;11,2
1815;"Mullerup";"no";0;0;0;55,491666;11,2
1816;"Mullerup";"no";0;0;0;55,491666;11,2
1817;"Mullerup";"no";0;0;0;55,491666;11,2
1818;"Mullerup";"no";0;0;0;55,491666;11,2
1819;"Mullerup";"no";0;0;0;55,491666;11,2
1820;"Mullerup";"no";0;0;0;55,491666;11,2
1821;"Mullerup";"no";0;0;0;55,491666;11,2
1822;"Mullerup";"no";0;0;0;55,491666;11,2
1823;"Mullerup";"no";0;0;0;55,491666;11,2
1824;"Mullerup";"no";0;0;0;55,491666;11,2
1825;"Mullerup";"no";0;0;0;55,491666;11,2
1826;"Mullerup";"no";0;0;0;55,491666;11,2
1827;"Mullerup";"no";0;0;0;55,491666;11,2
1828;"Mullerup";"no";0;0;0;55,491666;11,2
1829;"Mullerup";"no";0;0;0;55,491666;11,2
1830;"Mullerup";"no";0;0;0;55,491666;11,2
1831;"Mullerup";"no";0;0;0;55,491666;11,2
1832;"Mullerup";"no";0;0;0;55,491666;11,2
1833;"Mullerup";"no";0;0;0;55,491666;11,2
1834;"Mullerup";"no";0;0;0;55,491666;11,2
1835;"Mullerup";"no";0;0;0;55,491666;11,2
1836;"Mullerup";"no";0;0;0;55,491666;11,2
1837;"Mullerup";"no";0;0;0;55,491666;11,2
1838;"Mullerup";"no";0;0;0;55,491666;11,2
1839;"Mullerup";"no";0;0;0;55,491666;11,2
1840;"Mullerup";"no";0;0;0;55,491666;11,2
1841;"Mullerup";"no";0;0;0;55,491666;11,2
1842;"Mullerup";"no";0;0;0;55,491666;11,2
1843;"Mullerup";"no";0;0;0;55,491666;11,2
1844;"Mullerup";"no";0;0;0;55,491666;11,2
1845;"Mullerup";"no";0;0;0;55,491666;11,2
1846;"Mullerup";"no";0;0;0;55,491666;11,2
1847;"Mullerup";"no";1;0;1;55,491666;11,2
1848;"Mullerup";"no";0;0;0;55,491666;11,2
1849;"Mullerup";"no";0;0;0;55,491666;11,2
1850;"Mullerup";"no";0;0;0;55,491666;11,2
1851;"Mullerup";"no";0;0;0;55,491666;11,2
1852;"Mullerup";"no";0;0;0;55,491666;11,2
1853;"Mullerup";"no";0;1;1;55,491666;11,2
1854;"Mullerup";"no";0;0;0;55,491666;11,2
1855;"Mullerup";"no";0;0;0;55,491666;11,2
1856;"Mullerup";"no";0;0;0;55,491666;11,2
1857;"Mullerup";"no";0;0;0;55,491666;11,2
1634;"Thorup";"no";0;0;0;57,005277;9,239444
1635;"Thorup";"no";0;0;0;57,005277;9,239444
1636;"Thorup";"no";0;0;0;57,005277;9,239444
1637;"Thorup";"no";0;0;0;57,005277;9,239444
1638;"Thorup";"no";0;0;0;57,005277;9,239444
1639;"Thorup";"no";0;0;0;57,005277;9,239444
1640;"Thorup";"no";0;0;0;57,005277;9,239444
1641;"Thorup";"no";0;0;0;57,005277;9,239444
1642;"Thorup";"no";0;0;0;57,005277;9,239444
1643;"Thorup";"no";0;0;0;57,005277;9,239444
1644;"Thorup";"no";0;0;0;57,005277;9,239444
1645;"Thorup";"no";0;0;0;57,005277;9,239444
1646;"Thorup";"no";0;0;0;57,005277;9,239444
1647;"Thorup";"no";0;0;0;57,005277;9,239444
1648;"Thorup";"no";0;0;0;57,005277;9,239444
1649;"Thorup";"no";0;0;0;57,005277;9,239444
1650;"Thorup";"no";0;0;0;57,005277;9,239444
1651;"Thorup";"no";0;0;0;57,005277;9,239444
1652;"Thorup";"no";0;0;0;57,005277;9,239444
1653;"Thorup";"no";0;0;0;57,005277;9,239444
1654;"Thorup";"no";0;0;0;57,005277;9,239444
1655;"Thorup";"no";0;0;0;57,005277;9,239444
1656;"Thorup";"no";0;0;0;57,005277;9,239444
1657;"Thorup";"no";0;0;0;57,005277;9,239444
1658;"Thorup";"no";0;0;0;57,005277;9,239444
1659;"Thorup";"no";0;0;0;57,005277;9,239444
1660;"Thorup";"no";0;0;0;57,005277;9,239444
1661;"Thorup";"no";0;0;0;57,005277;9,239444
1662;"Thorup";"no";0;0;0;57,005277;9,239444
1663;"Thorup";"no";0;0;0;57,005277;9,239444
1664;"Thorup";"no";0;0;0;57,005277;9,239444
1665;"Thorup";"no";0;0;0;57,005277;9,239444
1666;"Thorup";"no";0;0;0;57,005277;9,239444
1667;"Thorup";"no";0;0;0;57,005277;9,239444
1668;"Thorup";"no";0;0;0;57,005277;9,239444
1669;"Thorup";"no";0;0;0;57,005277;9,239444
1670;"Thorup";"no";0;0;0;57,005277;9,239444
1671;"Thorup";"no";0;0;0;57,005277;9,239444
1672;"Thorup";"no";0;0;0;57,005277;9,239444
1673;"Thorup";"no";0;0;0;57,005277;9,239444
1674;"Thorup";"no";0;0;0;57,005277;9,239444
1675;"Thorup";"no";0;0;0;57,005277;9,239444
1676;"Thorup";"no";0;0;0;57,005277;9,239444
1677;"Thorup";"no";0;0;0;57,005277;9,239444
1678;"Thorup";"no";0;0;0;57,005277;9,239444
1679;"Thorup";"no";0;0;0;57,005277;9,239444
1680;"Thorup";"no";0;0;0;57,005277;9,239444
1681;"Thorup";"no";0;0;0;57,005277;9,239444
1682;"Thorup";"no";0;0;0;57,005277;9,239444
1683;"Thorup";"no";0;0;0;57,005277;9,239444
1684;"Thorup";"no";0;0;0;57,005277;9,239444
1685;"Thorup";"no";0;0;0;57,005277;9,239444
1686;"Thorup";"no";0;0;0;57,005277;9,239444
1687;"Thorup";"no";0;0;0;57,005277;9,239444
1688;"Thorup";"no";0;0;0;57,005277;9,239444
1689;"Thorup";"no";0;0;0;57,005277;9,239444
1690;"Thorup";"no";0;0;0;57,005277;9,239444
1691;"Thorup";"no";0;0;0;57,005277;9,239444
1692;"Thorup";"no";0;0;0;57,005277;9,239444
1693;"Thorup";"no";0;0;0;57,005277;9,239444
1694;"Thorup";"no";0;0;0;57,005277;9,239444
1695;"Thorup";"no";0;0;0;57,005277;9,239444
1696;"Thorup";"no";0;0;0;57,005277;9,239444
1697;"Thorup";"no";0;0;0;57,005277;9,239444
1698;"Thorup";"no";0;0;0;57,005277;9,239444
1699;"Thorup";"no";0;0;0;57,005277;9,239444
1700;"Thorup";"no";0;0;0;57,005277;9,239444
1701;"Thorup";"no";0;0;0;57,005277;9,239444
1702;"Thorup";"no";0;0;0;57,005277;9,239444
1703;"Thorup";"no";0;0;0;57,005277;9,239444
1704;"Thorup";"no";0;0;0;57,005277;9,239444
1705;"Thorup";"no";0;0;0;57,005277;9,239444
1706;"Thorup";"no";0;0;0;57,005277;9,239444
1707;"Thorup";"no";0;0;0;57,005277;9,239444
1708;"Thorup";"no";0;0;0;57,005277;9,239444
1709;"Thorup";"no";0;0;0;57,005277;9,239444
1710;"Thorup";"no";0;0;0;57,005277;9,239444
1711;"Thorup";"no";0;0;0;57,005277;9,239444
1712;"Thorup";"no";0;0;0;57,005277;9,239444
1713;"Thorup";"no";0;0;0;57,005277;9,239444
1714;"Thorup";"no";0;0;0;57,005277;9,239444
1715;"Thorup";"no";0;0;0;57,005277;9,239444
1716;"Thorup";"no";0;0;0;57,005277;9,239444
1717;"Thorup";"no";0;0;0;57,005277;9,239444
1718;"Thorup";"no";0;0;0;57,005277;9,239444
1719;"Thorup";"no";0;0;0;57,005277;9,239444
1720;"Thorup";"no";0;0;0;57,005277;9,239444
1721;"Thorup";"no";0;0;0;57,005277;9,239444
1722;"Thorup";"no";0;0;0;57,005277;9,239444
1723;"Thorup";"no";0;0;0;57,005277;9,239444
1724;"Thorup";"no";0;0;0;57,005277;9,239444
1725;"Thorup";"no";0;0;0;57,005277;9,239444
1726;"Thorup";"no";0;0;0;57,005277;9,239444
1727;"Thorup";"no";0;0;0;57,005277;9,239444
1728;"Thorup";"no";0;0;0;57,005277;9,239444
1729;"Thorup";"no";0;0;0;57,005277;9,239444
1730;"Thorup";"no";0;0;0;57,005277;9,239444
1731;"Thorup";"no";0;0;0;57,005277;9,239444
1732;"Thorup";"no";0;0;0;57,005277;9,239444
1733;"Thorup";"no";0;0;0;57,005277;9,239444
1734;"Thorup";"no";0;0;0;57,005277;9,239444
1735;"Thorup";"no";0;0;0;57,005277;9,239444
1736;"Thorup";"no";0;0;0;57,005277;9,239444
1737;"Thorup";"no";0;0;0;57,005277;9,239444
1738;"Thorup";"no";0;0;0;57,005277;9,239444
1739;"Thorup";"no";0;0;0;57,005277;9,239444
1740;"Thorup";"no";0;0;0;57,005277;9,239444
1741;"Thorup";"no";0;0;0;57,005277;9,239444
1742;"Thorup";"no";0;0;0;57,005277;9,239444
1743;"Thorup";"no";0;0;0;57,005277;9,239444
1744;"Thorup";"no";0;0;0;57,005277;9,239444
1745;"Thorup";"no";0;0;0;57,005277;9,239444
1746;"Thorup";"no";0;0;0;57,005277;9,239444
1747;"Thorup";"no";0;0;0;57,005277;9,239444
1748;"Thorup";"no";0;0;0;57,005277;9,239444
1749;"Thorup";"no";0;0;0;57,005277;9,239444
1750;"Thorup";"no";0;0;0;57,005277;9,239444
1751;"Thorup";"no";0;0;0;57,005277;9,239444
1752;"Thorup";"no";0;0;0;57,005277;9,239444
1753;"Thorup";"no";0;0;0;57,005277;9,239444
1754;"Thorup";"no";0;0;0;57,005277;9,239444
1755;"Thorup";"no";0;0;0;57,005277;9,239444
1756;"Thorup";"no";0;0;0;57,005277;9,239444
1757;"Thorup";"no";0;0;0;57,005277;9,239444
1758;"Thorup";"no";0;0;0;57,005277;9,239444
1759;"Thorup";"no";0;0;0;57,005277;9,239444
1760;"Thorup";"no";0;0;0;57,005277;9,239444
1761;"Thorup";"no";0;0;0;57,005277;9,239444
1762;"Thorup";"no";0;0;0;57,005277;9,239444
1763;"Thorup";"no";0;0;0;57,005277;9,239444
1764;"Thorup";"no";0;0;0;57,005277;9,239444
1765;"Thorup";"no";0;0;0;57,005277;9,239444
1766;"Thorup";"no";0;0;0;57,005277;9,239444
1767;"Thorup";"no";0;0;0;57,005277;9,239444
1768;"Thorup";"no";0;0;0;57,005277;9,239444
1769;"Thorup";"no";0;0;0;57,005277;9,239444
1770;"Thorup";"no";0;0;0;57,005277;9,239444
1771;"Thorup";"no";0;0;0;57,005277;9,239444
1772;"Thorup";"no";0;0;0;57,005277;9,239444
1773;"Thorup";"no";0;0;0;57,005277;9,239444
1774;"Thorup";"no";0;0;0;57,005277;9,239444
1775;"Thorup";"no";0;0;0;57,005277;9,239444
1776;"Thorup";"no";0;0;0;57,005277;9,239444
1777;"Thorup";"no";0;0;0;57,005277;9,239444
1778;"Thorup";"no";0;0;0;57,005277;9,239444
1779;"Thorup";"no";0;0;0;57,005277;9,239444
1780;"Thorup";"no";0;0;0;57,005277;9,239444
1781;"Thorup";"no";0;0;0;57,005277;9,239444
1782;"Thorup";"no";0;0;0;57,005277;9,239444
1783;"Thorup";"no";0;0;0;57,005277;9,239444
1784;"Thorup";"no";0;0;0;57,005277;9,239444
1785;"Thorup";"no";0;0;0;57,005277;9,239444
1786;"Thorup";"no";0;0;0;57,005277;9,239444
1787;"Thorup";"no";0;0;0;57,005277;9,239444
1788;"Thorup";"no";0;0;0;57,005277;9,239444
1789;"Thorup";"no";0;0;0;57,005277;9,239444
1790;"Thorup";"no";0;0;0;57,005277;9,239444
1791;"Thorup";"no";0;0;0;57,005277;9,239444
1792;"Thorup";"no";0;0;0;57,005277;9,239444
1793;"Thorup";"no";0;0;0;57,005277;9,239444
1794;"Thorup";"no";0;0;0;57,005277;9,239444
1795;"Thorup";"no";0;0;0;57,005277;9,239444
1796;"Thorup";"no";0;0;0;57,005277;9,239444
1797;"Thorup";"no";0;0;0;57,005277;9,239444
1798;"Thorup";"no";0;0;0;57,005277;9,239444
1799;"Thorup";"no";0;0;0;57,005277;9,239444
1800;"Thorup";"no";0;0;0;57,005277;9,239444
1801;"Thorup";"no";0;0;0;57,005277;9,239444
1802;"Thorup";"no";0;0;0;57,005277;9,239444
1803;"Thorup";"no";0;0;0;57,005277;9,239444
1804;"Thorup";"no";0;0;0;57,005277;9,239444
1805;"Thorup";"no";0;0;0;57,005277;9,239444
1806;"Thorup";"no";0;0;0;57,005277;9,239444
1807;"Thorup";"no";0;0;0;57,005277;9,239444
1808;"Thorup";"no";0;0;0;57,005277;9,239444
1809;"Thorup";"no";0;0;0;57,005277;9,239444
1810;"Thorup";"no";0;0;0;57,005277;9,239444
1811;"Thorup";"no";0;0;0;57,005277;9,239444
1812;"Thorup";"no";0;0;0;57,005277;9,239444
1813;"Thorup";"no";0;0;0;57,005277;9,239444
1814;"Thorup";"no";0;0;0;57,005277;9,239444
1815;"Thorup";"no";0;0;0;57,005277;9,239444
1816;"Thorup";"no";0;0;0;57,005277;9,239444
1817;"Thorup";"no";0;0;0;57,005277;9,239444
1818;"Thorup";"no";0;0;0;57,005277;9,239444
1819;"Thorup";"no";0;0;0;57,005277;9,239444
1820;"Thorup";"no";0;0;0;57,005277;9,239444
1821;"Thorup";"no";0;0;0;57,005277;9,239444
1822;"Thorup";"no";0;0;0;57,005277;9,239444
1823;"Thorup";"no";0;0;0;57,005277;9,239444
1824;"Thorup";"no";0;0;0;57,005277;9,239444
1825;"Thorup";"no";0;0;0;57,005277;9,239444
1826;"Thorup";"no";0;0;0;57,005277;9,239444
1827;"Thorup";"no";0;0;0;57,005277;9,239444
1828;"Thorup";"no";0;0;0;57,005277;9,239444
1829;"Thorup";"no";0;0;0;57,005277;9,239444
1830;"Thorup";"no";0;0;0;57,005277;9,239444
1831;"Thorup";"no";0;0;0;57,005277;9,239444
1832;"Thorup";"no";0;0;0;57,005277;9,239444
1833;"Thorup";"no";0;0;0;57,005277;9,239444
1834;"Thorup";"no";0;0;0;57,005277;9,239444
1835;"Thorup";"no";0;0;0;57,005277;9,239444
1836;"Thorup";"no";0;0;0;57,005277;9,239444
1837;"Thorup";"no";0;0;0;57,005277;9,239444
1838;"Thorup";"no";0;0;0;57,005277;9,239444
1839;"Thorup";"no";0;0;0;57,005277;9,239444
1840;"Thorup";"no";0;0;0;57,005277;9,239444
1841;"Thorup";"no";0;0;0;57,005277;9,239444
1842;"Thorup";"no";0;0;0;57,005277;9,239444
1843;"Thorup";"no";0;0;0;57,005277;9,239444
1844;"Thorup";"no";0;0;0;57,005277;9,239444
1845;"Thorup";"no";0;0;0;57,005277;9,239444
1846;"Thorup";"no";0;0;0;57,005277;9,239444
1847;"Thorup";"no";0;0;0;57,005277;9,239444
1848;"Thorup";"no";1;0;1;57,005277;9,239444
1849;"Thorup";"no";0;0;0;57,005277;9,239444
1850;"Thorup";"no";0;0;0;57,005277;9,239444
1851;"Thorup";"no";0;0;0;57,005277;9,239444
1852;"Thorup";"no";0;0;0;57,005277;9,239444
1853;"Thorup";"no";0;0;0;57,005277;9,239444
1854;"Thorup";"no";0;0;0;57,005277;9,239444
1855;"Thorup";"no";0;0;0;57,005277;9,239444
1856;"Thorup";"no";0;0;0;57,005277;9,239444
1857;"Thorup";"no";0;0;0;57,005277;9,239444
1634;"Agger";"west";0;0;0;56,779061;8,255306
1635;"Agger";"west";0;0;0;56,779061;8,255306
1636;"Agger";"west";0;0;0;56,779061;8,255306
1637;"Agger";"west";0;0;0;56,779061;8,255306
1638;"Agger";"west";0;0;0;56,779061;8,255306
1639;"Agger";"west";0;0;0;56,779061;8,255306
1640;"Agger";"west";0;0;0;56,779061;8,255306
1641;"Agger";"west";0;0;0;56,779061;8,255306
1642;"Agger";"west";0;0;0;56,779061;8,255306
1643;"Agger";"west";0;0;0;56,779061;8,255306
1644;"Agger";"west";0;0;0;56,779061;8,255306
1645;"Agger";"west";0;0;0;56,779061;8,255306
1646;"Agger";"west";0;0;0;56,779061;8,255306
1647;"Agger";"west";0;0;0;56,779061;8,255306
1648;"Agger";"west";0;0;0;56,779061;8,255306
1649;"Agger";"west";0;0;0;56,779061;8,255306
1650;"Agger";"west";0;0;0;56,779061;8,255306
1651;"Agger";"west";0;0;0;56,779061;8,255306
1652;"Agger";"west";0;0;0;56,779061;8,255306
1653;"Agger";"west";0;0;0;56,779061;8,255306
1654;"Agger";"west";0;0;0;56,779061;8,255306
1655;"Agger";"west";0;0;0;56,779061;8,255306
1656;"Agger";"west";0;0;0;56,779061;8,255306
1657;"Agger";"west";0;0;0;56,779061;8,255306
1658;"Agger";"west";0;0;0;56,779061;8,255306
1659;"Agger";"west";0;0;0;56,779061;8,255306
1660;"Agger";"west";0;0;0;56,779061;8,255306
1661;"Agger";"west";0;0;0;56,779061;8,255306
1662;"Agger";"west";0;0;0;56,779061;8,255306
1663;"Agger";"west";0;0;0;56,779061;8,255306
1664;"Agger";"west";0;0;0;56,779061;8,255306
1665;"Agger";"west";0;0;0;56,779061;8,255306
1666;"Agger";"west";0;0;0;56,779061;8,255306
1667;"Agger";"west";0;0;0;56,779061;8,255306
1668;"Agger";"west";0;0;0;56,779061;8,255306
1669;"Agger";"west";0;0;0;56,779061;8,255306
1670;"Agger";"west";0;0;0;56,779061;8,255306
1671;"Agger";"west";0;0;0;56,779061;8,255306
1672;"Agger";"west";0;0;0;56,779061;8,255306
1673;"Agger";"west";0;0;0;56,779061;8,255306
1674;"Agger";"west";0;0;0;56,779061;8,255306
1675;"Agger";"west";0;0;0;56,779061;8,255306
1676;"Agger";"west";0;0;0;56,779061;8,255306
1677;"Agger";"west";0;0;0;56,779061;8,255306
1678;"Agger";"west";0;0;0;56,779061;8,255306
1679;"Agger";"west";0;0;0;56,779061;8,255306
1680;"Agger";"west";0;0;0;56,779061;8,255306
1681;"Agger";"west";0;0;0;56,779061;8,255306
1682;"Agger";"west";0;0;0;56,779061;8,255306
1683;"Agger";"west";0;0;0;56,779061;8,255306
1684;"Agger";"west";0;0;0;56,779061;8,255306
1685;"Agger";"west";0;0;0;56,779061;8,255306
1686;"Agger";"west";0;0;0;56,779061;8,255306
1687;"Agger";"west";0;0;0;56,779061;8,255306
1688;"Agger";"west";0;0;0;56,779061;8,255306
1689;"Agger";"west";0;0;0;56,779061;8,255306
1690;"Agger";"west";0;0;0;56,779061;8,255306
1691;"Agger";"west";0;0;0;56,779061;8,255306
1692;"Agger";"west";0;0;0;56,779061;8,255306
1693;"Agger";"west";0;0;0;56,779061;8,255306
1694;"Agger";"west";0;0;0;56,779061;8,255306
1695;"Agger";"west";0;0;0;56,779061;8,255306
1696;"Agger";"west";0;0;0;56,779061;8,255306
1697;"Agger";"west";0;0;0;56,779061;8,255306
1698;"Agger";"west";0;0;0;56,779061;8,255306
1699;"Agger";"west";0;0;0;56,779061;8,255306
1700;"Agger";"west";0;0;0;56,779061;8,255306
1701;"Agger";"west";0;0;0;56,779061;8,255306
1702;"Agger";"west";0;0;0;56,779061;8,255306
1703;"Agger";"west";0;0;0;56,779061;8,255306
1704;"Agger";"west";0;0;0;56,779061;8,255306
1705;"Agger";"west";0;0;0;56,779061;8,255306
1706;"Agger";"west";0;0;0;56,779061;8,255306
1707;"Agger";"west";0;0;0;56,779061;8,255306
1708;"Agger";"west";0;0;0;56,779061;8,255306
1709;"Agger";"west";0;0;0;56,779061;8,255306
1710;"Agger";"west";0;0;0;56,779061;8,255306
1711;"Agger";"west";0;0;0;56,779061;8,255306
1712;"Agger";"west";0;0;0;56,779061;8,255306
1713;"Agger";"west";0;0;0;56,779061;8,255306
1714;"Agger";"west";0;0;0;56,779061;8,255306
1715;"Agger";"west";0;0;0;56,779061;8,255306
1716;"Agger";"west";0;0;0;56,779061;8,255306
1717;"Agger";"west";0;0;0;56,779061;8,255306
1718;"Agger";"west";0;0;0;56,779061;8,255306
1719;"Agger";"west";0;0;0;56,779061;8,255306
1720;"Agger";"west";0;0;0;56,779061;8,255306
1721;"Agger";"west";0;0;0;56,779061;8,255306
1722;"Agger";"west";0;0;0;56,779061;8,255306
1723;"Agger";"west";0;0;0;56,779061;8,255306
1724;"Agger";"west";0;0;0;56,779061;8,255306
1725;"Agger";"west";0;0;0;56,779061;8,255306
1726;"Agger";"west";0;0;0;56,779061;8,255306
1727;"Agger";"west";0;0;0;56,779061;8,255306
1728;"Agger";"west";0;0;0;56,779061;8,255306
1729;"Agger";"west";0;0;0;56,779061;8,255306
1730;"Agger";"west";0;0;0;56,779061;8,255306
1731;"Agger";"west";0;0;0;56,779061;8,255306
1732;"Agger";"west";0;0;0;56,779061;8,255306
1733;"Agger";"west";0;0;0;56,779061;8,255306
1734;"Agger";"west";0;0;0;56,779061;8,255306
1735;"Agger";"west";0;0;0;56,779061;8,255306
1736;"Agger";"west";0;0;0;56,779061;8,255306
1737;"Agger";"west";0;0;0;56,779061;8,255306
1738;"Agger";"west";0;0;0;56,779061;8,255306
1739;"Agger";"west";0;0;0;56,779061;8,255306
1740;"Agger";"west";0;0;0;56,779061;8,255306
1741;"Agger";"west";0;0;0;56,779061;8,255306
1742;"Agger";"west";0;0;0;56,779061;8,255306
1743;"Agger";"west";0;0;0;56,779061;8,255306
1744;"Agger";"west";0;0;0;56,779061;8,255306
1745;"Agger";"west";0;0;0;56,779061;8,255306
1746;"Agger";"west";0;0;0;56,779061;8,255306
1747;"Agger";"west";0;0;0;56,779061;8,255306
1748;"Agger";"west";0;0;0;56,779061;8,255306
1749;"Agger";"west";0;0;0;56,779061;8,255306
1750;"Agger";"west";0;0;0;56,779061;8,255306
1751;"Agger";"west";0;0;0;56,779061;8,255306
1752;"Agger";"west";0;0;0;56,779061;8,255306
1753;"Agger";"west";0;0;0;56,779061;8,255306
1754;"Agger";"west";0;0;0;56,779061;8,255306
1755;"Agger";"west";0;0;0;56,779061;8,255306
1756;"Agger";"west";0;0;0;56,779061;8,255306
1757;"Agger";"west";0;0;0;56,779061;8,255306
1758;"Agger";"west";0;0;0;56,779061;8,255306
1759;"Agger";"west";0;0;0;56,779061;8,255306
1760;"Agger";"west";0;0;0;56,779061;8,255306
1761;"Agger";"west";0;0;0;56,779061;8,255306
1762;"Agger";"west";0;0;0;56,779061;8,255306
1763;"Agger";"west";0;0;0;56,779061;8,255306
1764;"Agger";"west";0;0;0;56,779061;8,255306
1765;"Agger";"west";0;0;0;56,779061;8,255306
1766;"Agger";"west";0;0;0;56,779061;8,255306
1767;"Agger";"west";0;0;0;56,779061;8,255306
1768;"Agger";"west";0;0;0;56,779061;8,255306
1769;"Agger";"west";0;0;0;56,779061;8,255306
1770;"Agger";"west";0;0;0;56,779061;8,255306
1771;"Agger";"west";0;0;0;56,779061;8,255306
1772;"Agger";"west";0;0;0;56,779061;8,255306
1773;"Agger";"west";0;0;0;56,779061;8,255306
1774;"Agger";"west";0;0;0;56,779061;8,255306
1775;"Agger";"west";0;0;0;56,779061;8,255306
1776;"Agger";"west";0;0;0;56,779061;8,255306
1777;"Agger";"west";0;0;0;56,779061;8,255306
1778;"Agger";"west";0;0;0;56,779061;8,255306
1779;"Agger";"west";0;0;0;56,779061;8,255306
1780;"Agger";"west";0;0;0;56,779061;8,255306
1781;"Agger";"west";0;0;0;56,779061;8,255306
1782;"Agger";"west";0;0;0;56,779061;8,255306
1783;"Agger";"west";0;0;0;56,779061;8,255306
1784;"Agger";"west";0;0;0;56,779061;8,255306
1785;"Agger";"west";0;0;0;56,779061;8,255306
1786;"Agger";"west";0;0;0;56,779061;8,255306
1787;"Agger";"west";0;0;0;56,779061;8,255306
1788;"Agger";"west";0;0;0;56,779061;8,255306
1789;"Agger";"west";0;0;0;56,779061;8,255306
1790;"Agger";"west";0;0;0;56,779061;8,255306
1791;"Agger";"west";0;0;0;56,779061;8,255306
1792;"Agger";"west";0;0;0;56,779061;8,255306
1793;"Agger";"west";0;0;0;56,779061;8,255306
1794;"Agger";"west";0;0;0;56,779061;8,255306
1795;"Agger";"west";0;0;0;56,779061;8,255306
1796;"Agger";"west";0;0;0;56,779061;8,255306
1797;"Agger";"west";0;0;0;56,779061;8,255306
1798;"Agger";"west";0;0;0;56,779061;8,255306
1799;"Agger";"west";0;0;0;56,779061;8,255306
1800;"Agger";"west";0;0;0;56,779061;8,255306
1801;"Agger";"west";0;0;0;56,779061;8,255306
1802;"Agger";"west";0;0;0;56,779061;8,255306
1803;"Agger";"west";0;0;0;56,779061;8,255306
1804;"Agger";"west";0;0;0;56,779061;8,255306
1805;"Agger";"west";0;0;0;56,779061;8,255306
1806;"Agger";"west";0;0;0;56,779061;8,255306
1807;"Agger";"west";0;0;0;56,779061;8,255306
1808;"Agger";"west";0;0;0;56,779061;8,255306
1809;"Agger";"west";0;0;0;56,779061;8,255306
1810;"Agger";"west";0;0;0;56,779061;8,255306
1811;"Agger";"west";0;0;0;56,779061;8,255306
1812;"Agger";"west";0;0;0;56,779061;8,255306
1813;"Agger";"west";0;0;0;56,779061;8,255306
1814;"Agger";"west";0;0;0;56,779061;8,255306
1815;"Agger";"west";0;0;0;56,779061;8,255306
1816;"Agger";"west";0;0;0;56,779061;8,255306
1817;"Agger";"west";0;0;0;56,779061;8,255306
1818;"Agger";"west";0;0;0;56,779061;8,255306
1819;"Agger";"west";0;0;0;56,779061;8,255306
1820;"Agger";"west";0;0;0;56,779061;8,255306
1821;"Agger";"west";0;0;0;56,779061;8,255306
1822;"Agger";"west";0;0;0;56,779061;8,255306
1823;"Agger";"west";0;0;0;56,779061;8,255306
1824;"Agger";"west";0;0;0;56,779061;8,255306
1825;"Agger";"west";0;0;0;56,779061;8,255306
1826;"Agger";"west";0;0;0;56,779061;8,255306
1827;"Agger";"west";0;0;0;56,779061;8,255306
1828;"Agger";"west";0;0;0;56,779061;8,255306
1829;"Agger";"west";0;0;0;56,779061;8,255306
1830;"Agger";"west";0;0;0;56,779061;8,255306
1831;"Agger";"west";0;0;0;56,779061;8,255306
1832;"Agger";"west";0;0;0;56,779061;8,255306
1833;"Agger";"west";0;0;0;56,779061;8,255306
1834;"Agger";"west";0;0;0;56,779061;8,255306
1835;"Agger";"west";0;0;0;56,779061;8,255306
1836;"Agger";"west";0;0;0;56,779061;8,255306
1837;"Agger";"west";0;0;0;56,779061;8,255306
1838;"Agger";"west";0;0;0;56,779061;8,255306
1839;"Agger";"west";0;0;0;56,779061;8,255306
1840;"Agger";"west";0;0;0;56,779061;8,255306
1841;"Agger";"west";0;0;0;56,779061;8,255306
1842;"Agger";"west";0;0;0;56,779061;8,255306
1843;"Agger";"west";0;0;0;56,779061;8,255306
1844;"Agger";"west";0;0;0;56,779061;8,255306
1845;"Agger";"west";0;0;0;56,779061;8,255306
1846;"Agger";"west";0;0;0;56,779061;8,255306
1847;"Agger";"west";0;0;0;56,779061;8,255306
1848;"Agger";"west";0;0;0;56,779061;8,255306
1849;"Agger";"west";0;0;0;56,779061;8,255306
1850;"Agger";"west";1;0;1;56,779061;8,255306
1851;"Agger";"west";0;0;0;56,779061;8,255306
1852;"Agger";"west";0;0;0;56,779061;8,255306
1853;"Agger";"west";0;0;0;56,779061;8,255306
1854;"Agger";"west";0;0;0;56,779061;8,255306
1855;"Agger";"west";0;0;0;56,779061;8,255306
1856;"Agger";"west";0;0;0;56,779061;8,255306
1857;"Agger";"west";0;0;0;56,779061;8,255306
1634;"Hesselø";"no";0;0;0;56,1963;11,7056
1635;"Hesselø";"no";0;0;0;56,1963;11,7056
1636;"Hesselø";"no";0;0;0;56,1963;11,7056
1637;"Hesselø";"no";0;0;0;56,1963;11,7056
1638;"Hesselø";"no";0;0;0;56,1963;11,7056
1639;"Hesselø";"no";0;0;0;56,1963;11,7056
1640;"Hesselø";"no";0;0;0;56,1963;11,7056
1641;"Hesselø";"no";0;0;0;56,1963;11,7056
1642;"Hesselø";"no";0;0;0;56,1963;11,7056
1643;"Hesselø";"no";0;0;0;56,1963;11,7056
1644;"Hesselø";"no";0;0;0;56,1963;11,7056
1645;"Hesselø";"no";0;0;0;56,1963;11,7056
1646;"Hesselø";"no";0;0;0;56,1963;11,7056
1647;"Hesselø";"no";0;0;0;56,1963;11,7056
1648;"Hesselø";"no";0;0;0;56,1963;11,7056
1649;"Hesselø";"no";0;0;0;56,1963;11,7056
1650;"Hesselø";"no";0;0;0;56,1963;11,7056
1651;"Hesselø";"no";0;0;0;56,1963;11,7056
1652;"Hesselø";"no";0;0;0;56,1963;11,7056
1653;"Hesselø";"no";0;0;0;56,1963;11,7056
1654;"Hesselø";"no";0;0;0;56,1963;11,7056
1655;"Hesselø";"no";0;0;0;56,1963;11,7056
1656;"Hesselø";"no";0;0;0;56,1963;11,7056
1657;"Hesselø";"no";0;0;0;56,1963;11,7056
1658;"Hesselø";"no";0;0;0;56,1963;11,7056
1659;"Hesselø";"no";0;0;0;56,1963;11,7056
1660;"Hesselø";"no";0;0;0;56,1963;11,7056
1661;"Hesselø";"no";0;0;0;56,1963;11,7056
1662;"Hesselø";"no";0;0;0;56,1963;11,7056
1663;"Hesselø";"no";0;0;0;56,1963;11,7056
1664;"Hesselø";"no";0;0;0;56,1963;11,7056
1665;"Hesselø";"no";0;0;0;56,1963;11,7056
1666;"Hesselø";"no";0;0;0;56,1963;11,7056
1667;"Hesselø";"no";0;0;0;56,1963;11,7056
1668;"Hesselø";"no";0;0;0;56,1963;11,7056
1669;"Hesselø";"no";0;0;0;56,1963;11,7056
1670;"Hesselø";"no";0;0;0;56,1963;11,7056
1671;"Hesselø";"no";0;0;0;56,1963;11,7056
1672;"Hesselø";"no";0;0;0;56,1963;11,7056
1673;"Hesselø";"no";0;0;0;56,1963;11,7056
1674;"Hesselø";"no";0;0;0;56,1963;11,7056
1675;"Hesselø";"no";0;0;0;56,1963;11,7056
1676;"Hesselø";"no";0;0;0;56,1963;11,7056
1677;"Hesselø";"no";0;0;0;56,1963;11,7056
1678;"Hesselø";"no";0;0;0;56,1963;11,7056
1679;"Hesselø";"no";0;0;0;56,1963;11,7056
1680;"Hesselø";"no";0;0;0;56,1963;11,7056
1681;"Hesselø";"no";0;0;0;56,1963;11,7056
1682;"Hesselø";"no";0;0;0;56,1963;11,7056
1683;"Hesselø";"no";0;0;0;56,1963;11,7056
1684;"Hesselø";"no";0;0;0;56,1963;11,7056
1685;"Hesselø";"no";0;0;0;56,1963;11,7056
1686;"Hesselø";"no";0;0;0;56,1963;11,7056
1687;"Hesselø";"no";0;0;0;56,1963;11,7056
1688;"Hesselø";"no";0;0;0;56,1963;11,7056
1689;"Hesselø";"no";0;0;0;56,1963;11,7056
1690;"Hesselø";"no";0;0;0;56,1963;11,7056
1691;"Hesselø";"no";0;0;0;56,1963;11,7056
1692;"Hesselø";"no";0;0;0;56,1963;11,7056
1693;"Hesselø";"no";0;0;0;56,1963;11,7056
1694;"Hesselø";"no";0;0;0;56,1963;11,7056
1695;"Hesselø";"no";0;0;0;56,1963;11,7056
1696;"Hesselø";"no";0;0;0;56,1963;11,7056
1697;"Hesselø";"no";0;0;0;56,1963;11,7056
1698;"Hesselø";"no";0;0;0;56,1963;11,7056
1699;"Hesselø";"no";0;0;0;56,1963;11,7056
1700;"Hesselø";"no";0;0;0;56,1963;11,7056
1701;"Hesselø";"no";0;0;0;56,1963;11,7056
1702;"Hesselø";"no";0;0;0;56,1963;11,7056
1703;"Hesselø";"no";0;0;0;56,1963;11,7056
1704;"Hesselø";"no";0;0;0;56,1963;11,7056
1705;"Hesselø";"no";0;0;0;56,1963;11,7056
1706;"Hesselø";"no";0;0;0;56,1963;11,7056
1707;"Hesselø";"no";0;0;0;56,1963;11,7056
1708;"Hesselø";"no";0;0;0;56,1963;11,7056
1709;"Hesselø";"no";0;0;0;56,1963;11,7056
1710;"Hesselø";"no";0;0;0;56,1963;11,7056
1711;"Hesselø";"no";0;0;0;56,1963;11,7056
1712;"Hesselø";"no";0;0;0;56,1963;11,7056
1713;"Hesselø";"no";0;0;0;56,1963;11,7056
1714;"Hesselø";"no";0;0;0;56,1963;11,7056
1715;"Hesselø";"no";0;0;0;56,1963;11,7056
1716;"Hesselø";"no";0;0;0;56,1963;11,7056
1717;"Hesselø";"no";0;0;0;56,1963;11,7056
1718;"Hesselø";"no";0;0;0;56,1963;11,7056
1719;"Hesselø";"no";0;0;0;56,1963;11,7056
1720;"Hesselø";"no";0;0;0;56,1963;11,7056
1721;"Hesselø";"no";0;0;0;56,1963;11,7056
1722;"Hesselø";"no";0;0;0;56,1963;11,7056
1723;"Hesselø";"no";0;0;0;56,1963;11,7056
1724;"Hesselø";"no";0;0;0;56,1963;11,7056
1725;"Hesselø";"no";0;0;0;56,1963;11,7056
1726;"Hesselø";"no";0;0;0;56,1963;11,7056
1727;"Hesselø";"no";0;0;0;56,1963;11,7056
1728;"Hesselø";"no";0;0;0;56,1963;11,7056
1729;"Hesselø";"no";0;0;0;56,1963;11,7056
1730;"Hesselø";"no";0;0;0;56,1963;11,7056
1731;"Hesselø";"no";0;0;0;56,1963;11,7056
1732;"Hesselø";"no";0;0;0;56,1963;11,7056
1733;"Hesselø";"no";0;0;0;56,1963;11,7056
1734;"Hesselø";"no";0;0;0;56,1963;11,7056
1735;"Hesselø";"no";0;0;0;56,1963;11,7056
1736;"Hesselø";"no";0;0;0;56,1963;11,7056
1737;"Hesselø";"no";0;0;0;56,1963;11,7056
1738;"Hesselø";"no";0;0;0;56,1963;11,7056
1739;"Hesselø";"no";0;0;0;56,1963;11,7056
1740;"Hesselø";"no";0;0;0;56,1963;11,7056
1741;"Hesselø";"no";0;0;0;56,1963;11,7056
1742;"Hesselø";"no";0;0;0;56,1963;11,7056
1743;"Hesselø";"no";0;0;0;56,1963;11,7056
1744;"Hesselø";"no";0;0;0;56,1963;11,7056
1745;"Hesselø";"no";0;0;0;56,1963;11,7056
1746;"Hesselø";"no";0;0;0;56,1963;11,7056
1747;"Hesselø";"no";0;0;0;56,1963;11,7056
1748;"Hesselø";"no";0;0;0;56,1963;11,7056
1749;"Hesselø";"no";0;0;0;56,1963;11,7056
1750;"Hesselø";"no";0;0;0;56,1963;11,7056
1751;"Hesselø";"no";0;0;0;56,1963;11,7056
1752;"Hesselø";"no";0;0;0;56,1963;11,7056
1753;"Hesselø";"no";0;0;0;56,1963;11,7056
1754;"Hesselø";"no";0;0;0;56,1963;11,7056
1755;"Hesselø";"no";0;0;0;56,1963;11,7056
1756;"Hesselø";"no";0;0;0;56,1963;11,7056
1757;"Hesselø";"no";0;0;0;56,1963;11,7056
1758;"Hesselø";"no";0;0;0;56,1963;11,7056
1759;"Hesselø";"no";0;0;0;56,1963;11,7056
1760;"Hesselø";"no";0;0;0;56,1963;11,7056
1761;"Hesselø";"no";0;0;0;56,1963;11,7056
1762;"Hesselø";"no";0;0;0;56,1963;11,7056
1763;"Hesselø";"no";0;0;0;56,1963;11,7056
1764;"Hesselø";"no";0;0;0;56,1963;11,7056
1765;"Hesselø";"no";0;0;0;56,1963;11,7056
1766;"Hesselø";"no";0;0;0;56,1963;11,7056
1767;"Hesselø";"no";0;0;0;56,1963;11,7056
1768;"Hesselø";"no";0;0;0;56,1963;11,7056
1769;"Hesselø";"no";0;0;0;56,1963;11,7056
1770;"Hesselø";"no";0;0;0;56,1963;11,7056
1771;"Hesselø";"no";0;0;0;56,1963;11,7056
1772;"Hesselø";"no";0;0;0;56,1963;11,7056
1773;"Hesselø";"no";0;0;0;56,1963;11,7056
1774;"Hesselø";"no";0;0;0;56,1963;11,7056
1775;"Hesselø";"no";0;0;0;56,1963;11,7056
1776;"Hesselø";"no";0;0;0;56,1963;11,7056
1777;"Hesselø";"no";0;0;0;56,1963;11,7056
1778;"Hesselø";"no";0;0;0;56,1963;11,7056
1779;"Hesselø";"no";0;0;0;56,1963;11,7056
1780;"Hesselø";"no";0;0;0;56,1963;11,7056
1781;"Hesselø";"no";0;0;0;56,1963;11,7056
1782;"Hesselø";"no";0;0;0;56,1963;11,7056
1783;"Hesselø";"no";0;0;0;56,1963;11,7056
1784;"Hesselø";"no";0;0;0;56,1963;11,7056
1785;"Hesselø";"no";0;0;0;56,1963;11,7056
1786;"Hesselø";"no";0;0;0;56,1963;11,7056
1787;"Hesselø";"no";0;0;0;56,1963;11,7056
1788;"Hesselø";"no";0;0;0;56,1963;11,7056
1789;"Hesselø";"no";0;0;0;56,1963;11,7056
1790;"Hesselø";"no";0;0;0;56,1963;11,7056
1791;"Hesselø";"no";0;0;0;56,1963;11,7056
1792;"Hesselø";"no";0;0;0;56,1963;11,7056
1793;"Hesselø";"no";0;0;0;56,1963;11,7056
1794;"Hesselø";"no";0;0;0;56,1963;11,7056
1795;"Hesselø";"no";0;0;0;56,1963;11,7056
1796;"Hesselø";"no";0;0;0;56,1963;11,7056
1797;"Hesselø";"no";0;0;0;56,1963;11,7056
1798;"Hesselø";"no";0;0;0;56,1963;11,7056
1799;"Hesselø";"no";0;0;0;56,1963;11,7056
1800;"Hesselø";"no";0;0;0;56,1963;11,7056
1801;"Hesselø";"no";0;0;0;56,1963;11,7056
1802;"Hesselø";"no";0;0;0;56,1963;11,7056
1803;"Hesselø";"no";0;0;0;56,1963;11,7056
1804;"Hesselø";"no";0;0;0;56,1963;11,7056
1805;"Hesselø";"no";0;0;0;56,1963;11,7056
1806;"Hesselø";"no";0;0;0;56,1963;11,7056
1807;"Hesselø";"no";0;0;0;56,1963;11,7056
1808;"Hesselø";"no";0;0;0;56,1963;11,7056
1809;"Hesselø";"no";0;0;0;56,1963;11,7056
1810;"Hesselø";"no";0;0;0;56,1963;11,7056
1811;"Hesselø";"no";0;0;0;56,1963;11,7056
1812;"Hesselø";"no";0;0;0;56,1963;11,7056
1813;"Hesselø";"no";0;0;0;56,1963;11,7056
1814;"Hesselø";"no";0;0;0;56,1963;11,7056
1815;"Hesselø";"no";0;0;0;56,1963;11,7056
1816;"Hesselø";"no";0;0;0;56,1963;11,7056
1817;"Hesselø";"no";0;0;0;56,1963;11,7056
1818;"Hesselø";"no";0;0;0;56,1963;11,7056
1819;"Hesselø";"no";0;0;0;56,1963;11,7056
1820;"Hesselø";"no";0;0;0;56,1963;11,7056
1821;"Hesselø";"no";0;0;0;56,1963;11,7056
1822;"Hesselø";"no";0;0;0;56,1963;11,7056
1823;"Hesselø";"no";0;0;0;56,1963;11,7056
1824;"Hesselø";"no";0;0;0;56,1963;11,7056
1825;"Hesselø";"no";0;0;0;56,1963;11,7056
1826;"Hesselø";"no";0;0;0;56,1963;11,7056
1827;"Hesselø";"no";0;0;0;56,1963;11,7056
1828;"Hesselø";"no";0;0;0;56,1963;11,7056
1829;"Hesselø";"no";0;0;0;56,1963;11,7056
1830;"Hesselø";"no";0;0;0;56,1963;11,7056
1831;"Hesselø";"no";0;0;0;56,1963;11,7056
1832;"Hesselø";"no";0;0;0;56,1963;11,7056
1833;"Hesselø";"no";0;0;0;56,1963;11,7056
1834;"Hesselø";"no";0;0;0;56,1963;11,7056
1835;"Hesselø";"no";0;0;0;56,1963;11,7056
1836;"Hesselø";"no";0;0;0;56,1963;11,7056
1837;"Hesselø";"no";0;0;0;56,1963;11,7056
1838;"Hesselø";"no";0;0;0;56,1963;11,7056
1839;"Hesselø";"no";0;0;0;56,1963;11,7056
1840;"Hesselø";"no";0;0;0;56,1963;11,7056
1841;"Hesselø";"no";0;0;0;56,1963;11,7056
1842;"Hesselø";"no";0;0;0;56,1963;11,7056
1843;"Hesselø";"no";0;0;0;56,1963;11,7056
1844;"Hesselø";"no";0;0;0;56,1963;11,7056
1845;"Hesselø";"no";0;0;0;56,1963;11,7056
1846;"Hesselø";"no";0;0;0;56,1963;11,7056
1847;"Hesselø";"no";0;0;0;56,1963;11,7056
1848;"Hesselø";"no";0;0;0;56,1963;11,7056
1849;"Hesselø";"no";0;0;0;56,1963;11,7056
1850;"Hesselø";"no";0;0;0;56,1963;11,7056
1851;"Hesselø";"no";1;0;1;56,1963;11,7056
1852;"Hesselø";"no";0;0;0;56,1963;11,7056
1853;"Hesselø";"no";0;0;0;56,1963;11,7056
1854;"Hesselø";"no";4;0;4;56,1963;11,7056
1855;"Hesselø";"no";1;0;1;56,1963;11,7056
1856;"Hesselø";"no";0;0;0;56,1963;11,7056
1857;"Hesselø";"no";0;0;0;56,1963;11,7056
1634;"Hasle";"no";0;0;0;55,183333;14,716666
1635;"Hasle";"no";0;0;0;55,183333;14,716666
1636;"Hasle";"no";0;0;0;55,183333;14,716666
1637;"Hasle";"no";0;0;0;55,183333;14,716666
1638;"Hasle";"no";0;0;0;55,183333;14,716666
1639;"Hasle";"no";0;0;0;55,183333;14,716666
1640;"Hasle";"no";0;0;0;55,183333;14,716666
1641;"Hasle";"no";0;0;0;55,183333;14,716666
1642;"Hasle";"no";0;0;0;55,183333;14,716666
1643;"Hasle";"no";0;0;0;55,183333;14,716666
1644;"Hasle";"no";0;0;0;55,183333;14,716666
1645;"Hasle";"no";0;0;0;55,183333;14,716666
1646;"Hasle";"no";0;0;0;55,183333;14,716666
1647;"Hasle";"no";0;0;0;55,183333;14,716666
1648;"Hasle";"no";0;0;0;55,183333;14,716666
1649;"Hasle";"no";0;0;0;55,183333;14,716666
1650;"Hasle";"no";0;0;0;55,183333;14,716666
1651;"Hasle";"no";0;0;0;55,183333;14,716666
1652;"Hasle";"no";0;0;0;55,183333;14,716666
1653;"Hasle";"no";0;0;0;55,183333;14,716666
1654;"Hasle";"no";0;0;0;55,183333;14,716666
1655;"Hasle";"no";0;0;0;55,183333;14,716666
1656;"Hasle";"no";0;0;0;55,183333;14,716666
1657;"Hasle";"no";0;0;0;55,183333;14,716666
1658;"Hasle";"no";0;0;0;55,183333;14,716666
1659;"Hasle";"no";0;0;0;55,183333;14,716666
1660;"Hasle";"no";0;0;0;55,183333;14,716666
1661;"Hasle";"no";0;0;0;55,183333;14,716666
1662;"Hasle";"no";0;0;0;55,183333;14,716666
1663;"Hasle";"no";0;0;0;55,183333;14,716666
1664;"Hasle";"no";0;0;0;55,183333;14,716666
1665;"Hasle";"no";0;0;0;55,183333;14,716666
1666;"Hasle";"no";0;0;0;55,183333;14,716666
1667;"Hasle";"no";0;0;0;55,183333;14,716666
1668;"Hasle";"no";0;0;0;55,183333;14,716666
1669;"Hasle";"no";0;0;0;55,183333;14,716666
1670;"Hasle";"no";0;0;0;55,183333;14,716666
1671;"Hasle";"no";0;0;0;55,183333;14,716666
1672;"Hasle";"no";0;0;0;55,183333;14,716666
1673;"Hasle";"no";0;0;0;55,183333;14,716666
1674;"Hasle";"no";0;0;0;55,183333;14,716666
1675;"Hasle";"no";0;0;0;55,183333;14,716666
1676;"Hasle";"no";0;0;0;55,183333;14,716666
1677;"Hasle";"no";0;0;0;55,183333;14,716666
1678;"Hasle";"no";0;0;0;55,183333;14,716666
1679;"Hasle";"no";0;0;0;55,183333;14,716666
1680;"Hasle";"no";0;0;0;55,183333;14,716666
1681;"Hasle";"no";0;0;0;55,183333;14,716666
1682;"Hasle";"no";0;0;0;55,183333;14,716666
1683;"Hasle";"no";0;0;0;55,183333;14,716666
1684;"Hasle";"no";0;0;0;55,183333;14,716666
1685;"Hasle";"no";0;0;0;55,183333;14,716666
1686;"Hasle";"no";0;0;0;55,183333;14,716666
1687;"Hasle";"no";0;0;0;55,183333;14,716666
1688;"Hasle";"no";0;0;0;55,183333;14,716666
1689;"Hasle";"no";0;0;0;55,183333;14,716666
1690;"Hasle";"no";0;0;0;55,183333;14,716666
1691;"Hasle";"no";0;0;0;55,183333;14,716666
1692;"Hasle";"no";0;0;0;55,183333;14,716666
1693;"Hasle";"no";0;0;0;55,183333;14,716666
1694;"Hasle";"no";0;0;0;55,183333;14,716666
1695;"Hasle";"no";0;0;0;55,183333;14,716666
1696;"Hasle";"no";0;0;0;55,183333;14,716666
1697;"Hasle";"no";0;0;0;55,183333;14,716666
1698;"Hasle";"no";0;0;0;55,183333;14,716666
1699;"Hasle";"no";0;0;0;55,183333;14,716666
1700;"Hasle";"no";0;0;0;55,183333;14,716666
1701;"Hasle";"no";0;0;0;55,183333;14,716666
1702;"Hasle";"no";0;0;0;55,183333;14,716666
1703;"Hasle";"no";0;0;0;55,183333;14,716666
1704;"Hasle";"no";0;0;0;55,183333;14,716666
1705;"Hasle";"no";0;0;0;55,183333;14,716666
1706;"Hasle";"no";0;0;0;55,183333;14,716666
1707;"Hasle";"no";0;0;0;55,183333;14,716666
1708;"Hasle";"no";0;0;0;55,183333;14,716666
1709;"Hasle";"no";0;0;0;55,183333;14,716666
1710;"Hasle";"no";0;0;0;55,183333;14,716666
1711;"Hasle";"no";0;0;0;55,183333;14,716666
1712;"Hasle";"no";0;0;0;55,183333;14,716666
1713;"Hasle";"no";0;0;0;55,183333;14,716666
1714;"Hasle";"no";0;0;0;55,183333;14,716666
1715;"Hasle";"no";0;0;0;55,183333;14,716666
1716;"Hasle";"no";0;0;0;55,183333;14,716666
1717;"Hasle";"no";0;0;0;55,183333;14,716666
1718;"Hasle";"no";0;0;0;55,183333;14,716666
1719;"Hasle";"no";0;0;0;55,183333;14,716666
1720;"Hasle";"no";0;0;0;55,183333;14,716666
1721;"Hasle";"no";0;0;0;55,183333;14,716666
1722;"Hasle";"no";0;0;0;55,183333;14,716666
1723;"Hasle";"no";0;0;0;55,183333;14,716666
1724;"Hasle";"no";0;0;0;55,183333;14,716666
1725;"Hasle";"no";0;0;0;55,183333;14,716666
1726;"Hasle";"no";0;0;0;55,183333;14,716666
1727;"Hasle";"no";0;0;0;55,183333;14,716666
1728;"Hasle";"no";0;0;0;55,183333;14,716666
1729;"Hasle";"no";0;0;0;55,183333;14,716666
1730;"Hasle";"no";0;0;0;55,183333;14,716666
1731;"Hasle";"no";0;0;0;55,183333;14,716666
1732;"Hasle";"no";0;0;0;55,183333;14,716666
1733;"Hasle";"no";0;0;0;55,183333;14,716666
1734;"Hasle";"no";0;0;0;55,183333;14,716666
1735;"Hasle";"no";0;0;0;55,183333;14,716666
1736;"Hasle";"no";0;0;0;55,183333;14,716666
1737;"Hasle";"no";0;0;0;55,183333;14,716666
1738;"Hasle";"no";0;0;0;55,183333;14,716666
1739;"Hasle";"no";0;0;0;55,183333;14,716666
1740;"Hasle";"no";0;0;0;55,183333;14,716666
1741;"Hasle";"no";0;0;0;55,183333;14,716666
1742;"Hasle";"no";0;0;0;55,183333;14,716666
1743;"Hasle";"no";0;0;0;55,183333;14,716666
1744;"Hasle";"no";0;0;0;55,183333;14,716666
1745;"Hasle";"no";0;0;0;55,183333;14,716666
1746;"Hasle";"no";0;0;0;55,183333;14,716666
1747;"Hasle";"no";0;0;0;55,183333;14,716666
1748;"Hasle";"no";0;0;0;55,183333;14,716666
1749;"Hasle";"no";0;0;0;55,183333;14,716666
1750;"Hasle";"no";0;0;0;55,183333;14,716666
1751;"Hasle";"no";0;0;0;55,183333;14,716666
1752;"Hasle";"no";0;0;0;55,183333;14,716666
1753;"Hasle";"no";0;0;0;55,183333;14,716666
1754;"Hasle";"no";0;0;0;55,183333;14,716666
1755;"Hasle";"no";0;0;0;55,183333;14,716666
1756;"Hasle";"no";0;0;0;55,183333;14,716666
1757;"Hasle";"no";0;0;0;55,183333;14,716666
1758;"Hasle";"no";0;0;0;55,183333;14,716666
1759;"Hasle";"no";0;0;0;55,183333;14,716666
1760;"Hasle";"no";0;0;0;55,183333;14,716666
1761;"Hasle";"no";0;0;0;55,183333;14,716666
1762;"Hasle";"no";0;0;0;55,183333;14,716666
1763;"Hasle";"no";0;0;0;55,183333;14,716666
1764;"Hasle";"no";0;0;0;55,183333;14,716666
1765;"Hasle";"no";0;0;0;55,183333;14,716666
1766;"Hasle";"no";0;0;0;55,183333;14,716666
1767;"Hasle";"no";0;0;0;55,183333;14,716666
1768;"Hasle";"no";0;0;0;55,183333;14,716666
1769;"Hasle";"no";0;0;0;55,183333;14,716666
1770;"Hasle";"no";0;0;0;55,183333;14,716666
1771;"Hasle";"no";0;0;0;55,183333;14,716666
1772;"Hasle";"no";0;0;0;55,183333;14,716666
1773;"Hasle";"no";0;0;0;55,183333;14,716666
1774;"Hasle";"no";0;0;0;55,183333;14,716666
1775;"Hasle";"no";0;0;0;55,183333;14,716666
1776;"Hasle";"no";0;0;0;55,183333;14,716666
1777;"Hasle";"no";0;0;0;55,183333;14,716666
1778;"Hasle";"no";0;0;0;55,183333;14,716666
1779;"Hasle";"no";0;0;0;55,183333;14,716666
1780;"Hasle";"no";0;0;0;55,183333;14,716666
1781;"Hasle";"no";0;0;0;55,183333;14,716666
1782;"Hasle";"no";0;0;0;55,183333;14,716666
1783;"Hasle";"no";0;0;0;55,183333;14,716666
1784;"Hasle";"no";0;0;0;55,183333;14,716666
1785;"Hasle";"no";0;0;0;55,183333;14,716666
1786;"Hasle";"no";0;0;0;55,183333;14,716666
1787;"Hasle";"no";0;0;0;55,183333;14,716666
1788;"Hasle";"no";0;0;0;55,183333;14,716666
1789;"Hasle";"no";0;0;0;55,183333;14,716666
1790;"Hasle";"no";0;0;0;55,183333;14,716666
1791;"Hasle";"no";0;0;0;55,183333;14,716666
1792;"Hasle";"no";0;0;0;55,183333;14,716666
1793;"Hasle";"no";0;0;0;55,183333;14,716666
1794;"Hasle";"no";0;0;0;55,183333;14,716666
1795;"Hasle";"no";0;0;0;55,183333;14,716666
1796;"Hasle";"no";0;0;0;55,183333;14,716666
1797;"Hasle";"no";0;0;0;55,183333;14,716666
1798;"Hasle";"no";0;0;0;55,183333;14,716666
1799;"Hasle";"no";0;0;0;55,183333;14,716666
1800;"Hasle";"no";0;0;0;55,183333;14,716666
1801;"Hasle";"no";0;0;0;55,183333;14,716666
1802;"Hasle";"no";0;0;0;55,183333;14,716666
1803;"Hasle";"no";0;0;0;55,183333;14,716666
1804;"Hasle";"no";0;0;0;55,183333;14,716666
1805;"Hasle";"no";0;0;0;55,183333;14,716666
1806;"Hasle";"no";0;0;0;55,183333;14,716666
1807;"Hasle";"no";0;0;0;55,183333;14,716666
1808;"Hasle";"no";0;0;0;55,183333;14,716666
1809;"Hasle";"no";0;0;0;55,183333;14,716666
1810;"Hasle";"no";0;0;0;55,183333;14,716666
1811;"Hasle";"no";0;0;0;55,183333;14,716666
1812;"Hasle";"no";0;0;0;55,183333;14,716666
1813;"Hasle";"no";0;0;0;55,183333;14,716666
1814;"Hasle";"no";0;0;0;55,183333;14,716666
1815;"Hasle";"no";0;0;0;55,183333;14,716666
1816;"Hasle";"no";0;0;0;55,183333;14,716666
1817;"Hasle";"no";0;0;0;55,183333;14,716666
1818;"Hasle";"no";0;0;0;55,183333;14,716666
1819;"Hasle";"no";0;0;0;55,183333;14,716666
1820;"Hasle";"no";0;0;0;55,183333;14,716666
1821;"Hasle";"no";0;0;0;55,183333;14,716666
1822;"Hasle";"no";0;0;0;55,183333;14,716666
1823;"Hasle";"no";0;0;0;55,183333;14,716666
1824;"Hasle";"no";0;0;0;55,183333;14,716666
1825;"Hasle";"no";0;0;0;55,183333;14,716666
1826;"Hasle";"no";0;0;0;55,183333;14,716666
1827;"Hasle";"no";0;0;0;55,183333;14,716666
1828;"Hasle";"no";0;0;0;55,183333;14,716666
1829;"Hasle";"no";0;0;0;55,183333;14,716666
1830;"Hasle";"no";0;0;0;55,183333;14,716666
1831;"Hasle";"no";0;0;0;55,183333;14,716666
1832;"Hasle";"no";0;0;0;55,183333;14,716666
1833;"Hasle";"no";0;0;0;55,183333;14,716666
1834;"Hasle";"no";0;0;0;55,183333;14,716666
1835;"Hasle";"no";0;0;0;55,183333;14,716666
1836;"Hasle";"no";0;0;0;55,183333;14,716666
1837;"Hasle";"no";0;0;0;55,183333;14,716666
1838;"Hasle";"no";0;0;0;55,183333;14,716666
1839;"Hasle";"no";0;0;0;55,183333;14,716666
1840;"Hasle";"no";0;0;0;55,183333;14,716666
1841;"Hasle";"no";0;0;0;55,183333;14,716666
1842;"Hasle";"no";0;0;0;55,183333;14,716666
1843;"Hasle";"no";0;0;0;55,183333;14,716666
1844;"Hasle";"no";0;0;0;55,183333;14,716666
1845;"Hasle";"no";0;0;0;55,183333;14,716666
1846;"Hasle";"no";0;0;0;55,183333;14,716666
1847;"Hasle";"no";0;0;0;55,183333;14,716666
1848;"Hasle";"no";0;2;2;55,183333;14,716666
1849;"Hasle";"no";0;0;0;55,183333;14,716666
1850;"Hasle";"no";0;0;0;55,183333;14,716666
1851;"Hasle";"no";0;0;0;55,183333;14,716666
1852;"Hasle";"no";1;0;1;55,183333;14,716666
1853;"Hasle";"no";0;0;0;55,183333;14,716666
1854;"Hasle";"no";0;0;0;55,183333;14,716666
1855;"Hasle";"no";0;0;0;55,183333;14,716666
1856;"Hasle";"no";0;0;0;55,183333;14,716666
1857;"Hasle";"no";0;0;0;55,183333;14,716666
1634;"Løkken";"no";0;0;0;57,370277;9,714444
1635;"Løkken";"no";0;0;0;57,370277;9,714444
1636;"Løkken";"no";0;0;0;57,370277;9,714444
1637;"Løkken";"no";0;0;0;57,370277;9,714444
1638;"Løkken";"no";0;0;0;57,370277;9,714444
1639;"Løkken";"no";0;0;0;57,370277;9,714444
1640;"Løkken";"no";0;0;0;57,370277;9,714444
1641;"Løkken";"no";0;0;0;57,370277;9,714444
1642;"Løkken";"no";0;0;0;57,370277;9,714444
1643;"Løkken";"no";0;0;0;57,370277;9,714444
1644;"Løkken";"no";0;0;0;57,370277;9,714444
1645;"Løkken";"no";0;0;0;57,370277;9,714444
1646;"Løkken";"no";0;0;0;57,370277;9,714444
1647;"Løkken";"no";0;0;0;57,370277;9,714444
1648;"Løkken";"no";0;0;0;57,370277;9,714444
1649;"Løkken";"no";0;0;0;57,370277;9,714444
1650;"Løkken";"no";0;0;0;57,370277;9,714444
1651;"Løkken";"no";0;0;0;57,370277;9,714444
1652;"Løkken";"no";0;0;0;57,370277;9,714444
1653;"Løkken";"no";0;0;0;57,370277;9,714444
1654;"Løkken";"no";0;0;0;57,370277;9,714444
1655;"Løkken";"no";0;0;0;57,370277;9,714444
1656;"Løkken";"no";0;0;0;57,370277;9,714444
1657;"Løkken";"no";0;0;0;57,370277;9,714444
1658;"Løkken";"no";0;0;0;57,370277;9,714444
1659;"Løkken";"no";0;0;0;57,370277;9,714444
1660;"Løkken";"no";0;0;0;57,370277;9,714444
1661;"Løkken";"no";0;0;0;57,370277;9,714444
1662;"Løkken";"no";0;0;0;57,370277;9,714444
1663;"Løkken";"no";0;0;0;57,370277;9,714444
1664;"Løkken";"no";0;0;0;57,370277;9,714444
1665;"Løkken";"no";0;0;0;57,370277;9,714444
1666;"Løkken";"no";0;0;0;57,370277;9,714444
1667;"Løkken";"no";0;0;0;57,370277;9,714444
1668;"Løkken";"no";0;0;0;57,370277;9,714444
1669;"Løkken";"no";0;0;0;57,370277;9,714444
1670;"Løkken";"no";0;0;0;57,370277;9,714444
1671;"Løkken";"no";0;0;0;57,370277;9,714444
1672;"Løkken";"no";0;0;0;57,370277;9,714444
1673;"Løkken";"no";0;0;0;57,370277;9,714444
1674;"Løkken";"no";0;0;0;57,370277;9,714444
1675;"Løkken";"no";0;0;0;57,370277;9,714444
1676;"Løkken";"no";0;0;0;57,370277;9,714444
1677;"Løkken";"no";0;0;0;57,370277;9,714444
1678;"Løkken";"no";0;0;0;57,370277;9,714444
1679;"Løkken";"no";0;0;0;57,370277;9,714444
1680;"Løkken";"no";0;0;0;57,370277;9,714444
1681;"Løkken";"no";0;0;0;57,370277;9,714444
1682;"Løkken";"no";0;0;0;57,370277;9,714444
1683;"Løkken";"no";0;0;0;57,370277;9,714444
1684;"Løkken";"no";0;0;0;57,370277;9,714444
1685;"Løkken";"no";0;0;0;57,370277;9,714444
1686;"Løkken";"no";0;0;0;57,370277;9,714444
1687;"Løkken";"no";0;0;0;57,370277;9,714444
1688;"Løkken";"no";0;0;0;57,370277;9,714444
1689;"Løkken";"no";0;0;0;57,370277;9,714444
1690;"Løkken";"no";0;0;0;57,370277;9,714444
1691;"Løkken";"no";0;0;0;57,370277;9,714444
1692;"Løkken";"no";0;0;0;57,370277;9,714444
1693;"Løkken";"no";0;0;0;57,370277;9,714444
1694;"Løkken";"no";0;0;0;57,370277;9,714444
1695;"Løkken";"no";0;0;0;57,370277;9,714444
1696;"Løkken";"no";0;0;0;57,370277;9,714444
1697;"Løkken";"no";0;0;0;57,370277;9,714444
1698;"Løkken";"no";0;0;0;57,370277;9,714444
1699;"Løkken";"no";0;0;0;57,370277;9,714444
1700;"Løkken";"no";0;0;0;57,370277;9,714444
1701;"Løkken";"no";0;0;0;57,370277;9,714444
1702;"Løkken";"no";0;0;0;57,370277;9,714444
1703;"Løkken";"no";0;0;0;57,370277;9,714444
1704;"Løkken";"no";0;0;0;57,370277;9,714444
1705;"Løkken";"no";0;0;0;57,370277;9,714444
1706;"Løkken";"no";0;0;0;57,370277;9,714444
1707;"Løkken";"no";0;0;0;57,370277;9,714444
1708;"Løkken";"no";0;0;0;57,370277;9,714444
1709;"Løkken";"no";0;0;0;57,370277;9,714444
1710;"Løkken";"no";0;0;0;57,370277;9,714444
1711;"Løkken";"no";0;0;0;57,370277;9,714444
1712;"Løkken";"no";0;0;0;57,370277;9,714444
1713;"Løkken";"no";0;0;0;57,370277;9,714444
1714;"Løkken";"no";0;0;0;57,370277;9,714444
1715;"Løkken";"no";0;0;0;57,370277;9,714444
1716;"Løkken";"no";0;0;0;57,370277;9,714444
1717;"Løkken";"no";0;0;0;57,370277;9,714444
1718;"Løkken";"no";0;0;0;57,370277;9,714444
1719;"Løkken";"no";0;0;0;57,370277;9,714444
1720;"Løkken";"no";0;0;0;57,370277;9,714444
1721;"Løkken";"no";0;0;0;57,370277;9,714444
1722;"Løkken";"no";0;0;0;57,370277;9,714444
1723;"Løkken";"no";0;0;0;57,370277;9,714444
1724;"Løkken";"no";0;0;0;57,370277;9,714444
1725;"Løkken";"no";0;0;0;57,370277;9,714444
1726;"Løkken";"no";0;0;0;57,370277;9,714444
1727;"Løkken";"no";0;0;0;57,370277;9,714444
1728;"Løkken";"no";0;0;0;57,370277;9,714444
1729;"Løkken";"no";0;0;0;57,370277;9,714444
1730;"Løkken";"no";0;0;0;57,370277;9,714444
1731;"Løkken";"no";0;0;0;57,370277;9,714444
1732;"Løkken";"no";0;0;0;57,370277;9,714444
1733;"Løkken";"no";0;0;0;57,370277;9,714444
1734;"Løkken";"no";0;0;0;57,370277;9,714444
1735;"Løkken";"no";0;0;0;57,370277;9,714444
1736;"Løkken";"no";0;0;0;57,370277;9,714444
1737;"Løkken";"no";0;0;0;57,370277;9,714444
1738;"Løkken";"no";0;0;0;57,370277;9,714444
1739;"Løkken";"no";0;0;0;57,370277;9,714444
1740;"Løkken";"no";0;0;0;57,370277;9,714444
1741;"Løkken";"no";0;0;0;57,370277;9,714444
1742;"Løkken";"no";0;0;0;57,370277;9,714444
1743;"Løkken";"no";0;0;0;57,370277;9,714444
1744;"Løkken";"no";0;0;0;57,370277;9,714444
1745;"Løkken";"no";0;0;0;57,370277;9,714444
1746;"Løkken";"no";0;0;0;57,370277;9,714444
1747;"Løkken";"no";0;0;0;57,370277;9,714444
1748;"Løkken";"no";0;0;0;57,370277;9,714444
1749;"Løkken";"no";0;0;0;57,370277;9,714444
1750;"Løkken";"no";0;0;0;57,370277;9,714444
1751;"Løkken";"no";0;0;0;57,370277;9,714444
1752;"Løkken";"no";0;0;0;57,370277;9,714444
1753;"Løkken";"no";0;0;0;57,370277;9,714444
1754;"Løkken";"no";0;0;0;57,370277;9,714444
1755;"Løkken";"no";0;0;0;57,370277;9,714444
1756;"Løkken";"no";0;0;0;57,370277;9,714444
1757;"Løkken";"no";0;0;0;57,370277;9,714444
1758;"Løkken";"no";0;0;0;57,370277;9,714444
1759;"Løkken";"no";0;0;0;57,370277;9,714444
1760;"Løkken";"no";0;0;0;57,370277;9,714444
1761;"Løkken";"no";0;0;0;57,370277;9,714444
1762;"Løkken";"no";0;0;0;57,370277;9,714444
1763;"Løkken";"no";0;0;0;57,370277;9,714444
1764;"Løkken";"no";0;0;0;57,370277;9,714444
1765;"Løkken";"no";0;0;0;57,370277;9,714444
1766;"Løkken";"no";0;0;0;57,370277;9,714444
1767;"Løkken";"no";0;0;0;57,370277;9,714444
1768;"Løkken";"no";0;0;0;57,370277;9,714444
1769;"Løkken";"no";0;0;0;57,370277;9,714444
1770;"Løkken";"no";0;0;0;57,370277;9,714444
1771;"Løkken";"no";0;0;0;57,370277;9,714444
1772;"Løkken";"no";0;0;0;57,370277;9,714444
1773;"Løkken";"no";0;0;0;57,370277;9,714444
1774;"Løkken";"no";0;0;0;57,370277;9,714444
1775;"Løkken";"no";0;0;0;57,370277;9,714444
1776;"Løkken";"no";0;0;0;57,370277;9,714444
1777;"Løkken";"no";0;0;0;57,370277;9,714444
1778;"Løkken";"no";0;0;0;57,370277;9,714444
1779;"Løkken";"no";0;0;0;57,370277;9,714444
1780;"Løkken";"no";0;0;0;57,370277;9,714444
1781;"Løkken";"no";0;0;0;57,370277;9,714444
1782;"Løkken";"no";0;0;0;57,370277;9,714444
1783;"Løkken";"no";0;0;0;57,370277;9,714444
1784;"Løkken";"no";0;0;0;57,370277;9,714444
1785;"Løkken";"no";0;0;0;57,370277;9,714444
1786;"Løkken";"no";0;0;0;57,370277;9,714444
1787;"Løkken";"no";0;0;0;57,370277;9,714444
1788;"Løkken";"no";0;0;0;57,370277;9,714444
1789;"Løkken";"no";0;0;0;57,370277;9,714444
1790;"Løkken";"no";0;0;0;57,370277;9,714444
1791;"Løkken";"no";0;0;0;57,370277;9,714444
1792;"Løkken";"no";0;0;0;57,370277;9,714444
1793;"Løkken";"no";0;0;0;57,370277;9,714444
1794;"Løkken";"no";0;0;0;57,370277;9,714444
1795;"Løkken";"no";0;0;0;57,370277;9,714444
1796;"Løkken";"no";0;0;0;57,370277;9,714444
1797;"Løkken";"no";0;0;0;57,370277;9,714444
1798;"Løkken";"no";0;0;0;57,370277;9,714444
1799;"Løkken";"no";0;0;0;57,370277;9,714444
1800;"Løkken";"no";0;0;0;57,370277;9,714444
1801;"Løkken";"no";0;0;0;57,370277;9,714444
1802;"Løkken";"no";0;0;0;57,370277;9,714444
1803;"Løkken";"no";0;0;0;57,370277;9,714444
1804;"Løkken";"no";0;0;0;57,370277;9,714444
1805;"Løkken";"no";0;0;0;57,370277;9,714444
1806;"Løkken";"no";0;0;0;57,370277;9,714444
1807;"Løkken";"no";0;0;0;57,370277;9,714444
1808;"Løkken";"no";0;0;0;57,370277;9,714444
1809;"Løkken";"no";0;0;0;57,370277;9,714444
1810;"Løkken";"no";0;0;0;57,370277;9,714444
1811;"Løkken";"no";0;0;0;57,370277;9,714444
1812;"Løkken";"no";0;0;0;57,370277;9,714444
1813;"Løkken";"no";0;0;0;57,370277;9,714444
1814;"Løkken";"no";0;0;0;57,370277;9,714444
1815;"Løkken";"no";0;0;0;57,370277;9,714444
1816;"Løkken";"no";0;0;0;57,370277;9,714444
1817;"Løkken";"no";0;1;1;57,370277;9,714444
1818;"Løkken";"no";0;0;0;57,370277;9,714444
1819;"Løkken";"no";0;1;1;57,370277;9,714444
1820;"Løkken";"no";0;0;0;57,370277;9,714444
1821;"Løkken";"no";0;1;1;57,370277;9,714444
1822;"Løkken";"no";0;0;0;57,370277;9,714444
1823;"Løkken";"no";0;0;0;57,370277;9,714444
1824;"Løkken";"no";0;0;0;57,370277;9,714444
1825;"Løkken";"no";0;0;0;57,370277;9,714444
1826;"Løkken";"no";0;0;0;57,370277;9,714444
1827;"Løkken";"no";0;1;1;57,370277;9,714444
1828;"Løkken";"no";0;1;1;57,370277;9,714444
1829;"Løkken";"no";0;0;0;57,370277;9,714444
1830;"Løkken";"no";0;0;0;57,370277;9,714444
1831;"Løkken";"no";0;0;0;57,370277;9,714444
1832;"Løkken";"no";0;0;0;57,370277;9,714444
1833;"Løkken";"no";0;0;0;57,370277;9,714444
1834;"Løkken";"no";0;0;0;57,370277;9,714444
1835;"Løkken";"no";0;0;0;57,370277;9,714444
1836;"Løkken";"no";0;0;0;57,370277;9,714444
1837;"Løkken";"no";0;0;0;57,370277;9,714444
1838;"Løkken";"no";0;0;0;57,370277;9,714444
1839;"Løkken";"no";0;0;0;57,370277;9,714444
1840;"Løkken";"no";0;0;0;57,370277;9,714444
1841;"Løkken";"no";0;0;0;57,370277;9,714444
1842;"Løkken";"no";0;0;0;57,370277;9,714444
1843;"Løkken";"no";0;1;1;57,370277;9,714444
1844;"Løkken";"no";0;0;0;57,370277;9,714444
1845;"Løkken";"no";0;0;0;57,370277;9,714444
1846;"Løkken";"no";0;0;0;57,370277;9,714444
1847;"Løkken";"no";0;0;0;57,370277;9,714444
1848;"Løkken";"no";0;0;0;57,370277;9,714444
1849;"Løkken";"no";0;0;0;57,370277;9,714444
1850;"Løkken";"no";0;0;0;57,370277;9,714444
1851;"Løkken";"no";0;0;0;57,370277;9,714444
1852;"Løkken";"no";2;0;2;57,370277;9,714444
1853;"Løkken";"no";2;0;2;57,370277;9,714444
1854;"Løkken";"no";0;0;0;57,370277;9,714444
1855;"Løkken";"no";0;0;0;57,370277;9,714444
1856;"Løkken";"no";0;0;0;57,370277;9,714444
1857;"Løkken";"no";0;0;0;57,370277;9,714444
1634;"Kalø";"no";0;0;0;56,3;10,5
1635;"Kalø";"no";0;0;0;56,3;10,5
1636;"Kalø";"no";0;0;0;56,3;10,5
1637;"Kalø";"no";0;0;0;56,3;10,5
1638;"Kalø";"no";0;0;0;56,3;10,5
1639;"Kalø";"no";0;0;0;56,3;10,5
1640;"Kalø";"no";0;0;0;56,3;10,5
1641;"Kalø";"no";0;0;0;56,3;10,5
1642;"Kalø";"no";0;0;0;56,3;10,5
1643;"Kalø";"no";0;0;0;56,3;10,5
1644;"Kalø";"no";0;0;0;56,3;10,5
1645;"Kalø";"no";0;0;0;56,3;10,5
1646;"Kalø";"no";0;0;0;56,3;10,5
1647;"Kalø";"no";0;0;0;56,3;10,5
1648;"Kalø";"no";0;0;0;56,3;10,5
1649;"Kalø";"no";0;0;0;56,3;10,5
1650;"Kalø";"no";0;0;0;56,3;10,5
1651;"Kalø";"no";0;0;0;56,3;10,5
1652;"Kalø";"no";0;0;0;56,3;10,5
1653;"Kalø";"no";0;0;0;56,3;10,5
1654;"Kalø";"no";0;0;0;56,3;10,5
1655;"Kalø";"no";0;0;0;56,3;10,5
1656;"Kalø";"no";0;0;0;56,3;10,5
1657;"Kalø";"no";0;0;0;56,3;10,5
1658;"Kalø";"no";0;0;0;56,3;10,5
1659;"Kalø";"no";0;0;0;56,3;10,5
1660;"Kalø";"no";0;0;0;56,3;10,5
1661;"Kalø";"no";0;0;0;56,3;10,5
1662;"Kalø";"no";0;0;0;56,3;10,5
1663;"Kalø";"no";0;0;0;56,3;10,5
1664;"Kalø";"no";0;0;0;56,3;10,5
1665;"Kalø";"no";0;0;0;56,3;10,5
1666;"Kalø";"no";0;0;0;56,3;10,5
1667;"Kalø";"no";0;0;0;56,3;10,5
1668;"Kalø";"no";0;0;0;56,3;10,5
1669;"Kalø";"no";0;0;0;56,3;10,5
1670;"Kalø";"no";0;0;0;56,3;10,5
1671;"Kalø";"no";0;0;0;56,3;10,5
1672;"Kalø";"no";0;0;0;56,3;10,5
1673;"Kalø";"no";0;0;0;56,3;10,5
1674;"Kalø";"no";0;0;0;56,3;10,5
1675;"Kalø";"no";0;0;0;56,3;10,5
1676;"Kalø";"no";0;0;0;56,3;10,5
1677;"Kalø";"no";0;0;0;56,3;10,5
1678;"Kalø";"no";0;0;0;56,3;10,5
1679;"Kalø";"no";0;0;0;56,3;10,5
1680;"Kalø";"no";0;0;0;56,3;10,5
1681;"Kalø";"no";0;0;0;56,3;10,5
1682;"Kalø";"no";0;0;0;56,3;10,5
1683;"Kalø";"no";0;0;0;56,3;10,5
1684;"Kalø";"no";0;0;0;56,3;10,5
1685;"Kalø";"no";0;0;0;56,3;10,5
1686;"Kalø";"no";0;0;0;56,3;10,5
1687;"Kalø";"no";0;0;0;56,3;10,5
1688;"Kalø";"no";0;0;0;56,3;10,5
1689;"Kalø";"no";0;0;0;56,3;10,5
1690;"Kalø";"no";0;0;0;56,3;10,5
1691;"Kalø";"no";0;0;0;56,3;10,5
1692;"Kalø";"no";0;0;0;56,3;10,5
1693;"Kalø";"no";0;0;0;56,3;10,5
1694;"Kalø";"no";0;0;0;56,3;10,5
1695;"Kalø";"no";0;0;0;56,3;10,5
1696;"Kalø";"no";0;0;0;56,3;10,5
1697;"Kalø";"no";0;0;0;56,3;10,5
1698;"Kalø";"no";0;0;0;56,3;10,5
1699;"Kalø";"no";0;0;0;56,3;10,5
1700;"Kalø";"no";0;0;0;56,3;10,5
1701;"Kalø";"no";0;0;0;56,3;10,5
1702;"Kalø";"no";0;0;0;56,3;10,5
1703;"Kalø";"no";0;0;0;56,3;10,5
1704;"Kalø";"no";0;0;0;56,3;10,5
1705;"Kalø";"no";0;0;0;56,3;10,5
1706;"Kalø";"no";0;0;0;56,3;10,5
1707;"Kalø";"no";0;0;0;56,3;10,5
1708;"Kalø";"no";0;0;0;56,3;10,5
1709;"Kalø";"no";0;0;0;56,3;10,5
1710;"Kalø";"no";0;0;0;56,3;10,5
1711;"Kalø";"no";0;0;0;56,3;10,5
1712;"Kalø";"no";0;0;0;56,3;10,5
1713;"Kalø";"no";0;0;0;56,3;10,5
1714;"Kalø";"no";0;0;0;56,3;10,5
1715;"Kalø";"no";0;0;0;56,3;10,5
1716;"Kalø";"no";0;0;0;56,3;10,5
1717;"Kalø";"no";0;0;0;56,3;10,5
1718;"Kalø";"no";0;0;0;56,3;10,5
1719;"Kalø";"no";0;0;0;56,3;10,5
1720;"Kalø";"no";0;0;0;56,3;10,5
1721;"Kalø";"no";0;0;0;56,3;10,5
1722;"Kalø";"no";0;0;0;56,3;10,5
1723;"Kalø";"no";0;0;0;56,3;10,5
1724;"Kalø";"no";0;0;0;56,3;10,5
1725;"Kalø";"no";0;0;0;56,3;10,5
1726;"Kalø";"no";0;0;0;56,3;10,5
1727;"Kalø";"no";0;0;0;56,3;10,5
1728;"Kalø";"no";0;0;0;56,3;10,5
1729;"Kalø";"no";0;0;0;56,3;10,5
1730;"Kalø";"no";0;0;0;56,3;10,5
1731;"Kalø";"no";0;0;0;56,3;10,5
1732;"Kalø";"no";0;0;0;56,3;10,5
1733;"Kalø";"no";0;0;0;56,3;10,5
1734;"Kalø";"no";0;0;0;56,3;10,5
1735;"Kalø";"no";0;0;0;56,3;10,5
1736;"Kalø";"no";0;0;0;56,3;10,5
1737;"Kalø";"no";0;0;0;56,3;10,5
1738;"Kalø";"no";0;0;0;56,3;10,5
1739;"Kalø";"no";0;0;0;56,3;10,5
1740;"Kalø";"no";0;0;0;56,3;10,5
1741;"Kalø";"no";0;0;0;56,3;10,5
1742;"Kalø";"no";0;0;0;56,3;10,5
1743;"Kalø";"no";0;0;0;56,3;10,5
1744;"Kalø";"no";0;0;0;56,3;10,5
1745;"Kalø";"no";0;0;0;56,3;10,5
1746;"Kalø";"no";0;0;0;56,3;10,5
1747;"Kalø";"no";0;0;0;56,3;10,5
1748;"Kalø";"no";0;0;0;56,3;10,5
1749;"Kalø";"no";0;0;0;56,3;10,5
1750;"Kalø";"no";0;0;0;56,3;10,5
1751;"Kalø";"no";0;0;0;56,3;10,5
1752;"Kalø";"no";0;0;0;56,3;10,5
1753;"Kalø";"no";0;0;0;56,3;10,5
1754;"Kalø";"no";0;0;0;56,3;10,5
1755;"Kalø";"no";0;0;0;56,3;10,5
1756;"Kalø";"no";0;0;0;56,3;10,5
1757;"Kalø";"no";0;0;0;56,3;10,5
1758;"Kalø";"no";0;0;0;56,3;10,5
1759;"Kalø";"no";0;0;0;56,3;10,5
1760;"Kalø";"no";0;0;0;56,3;10,5
1761;"Kalø";"no";0;0;0;56,3;10,5
1762;"Kalø";"no";0;0;0;56,3;10,5
1763;"Kalø";"no";0;0;0;56,3;10,5
1764;"Kalø";"no";0;0;0;56,3;10,5
1765;"Kalø";"no";0;0;0;56,3;10,5
1766;"Kalø";"no";0;0;0;56,3;10,5
1767;"Kalø";"no";0;0;0;56,3;10,5
1768;"Kalø";"no";0;0;0;56,3;10,5
1769;"Kalø";"no";0;0;0;56,3;10,5
1770;"Kalø";"no";0;0;0;56,3;10,5
1771;"Kalø";"no";0;0;0;56,3;10,5
1772;"Kalø";"no";0;0;0;56,3;10,5
1773;"Kalø";"no";0;0;0;56,3;10,5
1774;"Kalø";"no";0;0;0;56,3;10,5
1775;"Kalø";"no";0;0;0;56,3;10,5
1776;"Kalø";"no";0;0;0;56,3;10,5
1777;"Kalø";"no";0;0;0;56,3;10,5
1778;"Kalø";"no";0;0;0;56,3;10,5
1779;"Kalø";"no";0;0;0;56,3;10,5
1780;"Kalø";"no";0;0;0;56,3;10,5
1781;"Kalø";"no";0;0;0;56,3;10,5
1782;"Kalø";"no";0;0;0;56,3;10,5
1783;"Kalø";"no";0;0;0;56,3;10,5
1784;"Kalø";"no";0;0;0;56,3;10,5
1785;"Kalø";"no";0;0;0;56,3;10,5
1786;"Kalø";"no";0;0;0;56,3;10,5
1787;"Kalø";"no";0;0;0;56,3;10,5
1788;"Kalø";"no";0;0;0;56,3;10,5
1789;"Kalø";"no";0;0;0;56,3;10,5
1790;"Kalø";"no";0;0;0;56,3;10,5
1791;"Kalø";"no";0;0;0;56,3;10,5
1792;"Kalø";"no";0;0;0;56,3;10,5
1793;"Kalø";"no";0;0;0;56,3;10,5
1794;"Kalø";"no";0;0;0;56,3;10,5
1795;"Kalø";"no";0;0;0;56,3;10,5
1796;"Kalø";"no";0;0;0;56,3;10,5
1797;"Kalø";"no";0;0;0;56,3;10,5
1798;"Kalø";"no";0;0;0;56,3;10,5
1799;"Kalø";"no";0;0;0;56,3;10,5
1800;"Kalø";"no";0;0;0;56,3;10,5
1801;"Kalø";"no";0;0;0;56,3;10,5
1802;"Kalø";"no";0;0;0;56,3;10,5
1803;"Kalø";"no";0;0;0;56,3;10,5
1804;"Kalø";"no";0;0;0;56,3;10,5
1805;"Kalø";"no";0;0;0;56,3;10,5
1806;"Kalø";"no";0;0;0;56,3;10,5
1807;"Kalø";"no";0;0;0;56,3;10,5
1808;"Kalø";"no";0;0;0;56,3;10,5
1809;"Kalø";"no";0;0;0;56,3;10,5
1810;"Kalø";"no";0;0;0;56,3;10,5
1811;"Kalø";"no";0;0;0;56,3;10,5
1812;"Kalø";"no";0;0;0;56,3;10,5
1813;"Kalø";"no";0;0;0;56,3;10,5
1814;"Kalø";"no";0;0;0;56,3;10,5
1815;"Kalø";"no";0;0;0;56,3;10,5
1816;"Kalø";"no";0;0;0;56,3;10,5
1817;"Kalø";"no";0;0;0;56,3;10,5
1818;"Kalø";"no";0;0;0;56,3;10,5
1819;"Kalø";"no";0;0;0;56,3;10,5
1820;"Kalø";"no";0;0;0;56,3;10,5
1821;"Kalø";"no";0;0;0;56,3;10,5
1822;"Kalø";"no";0;0;0;56,3;10,5
1823;"Kalø";"no";0;0;0;56,3;10,5
1824;"Kalø";"no";0;0;0;56,3;10,5
1825;"Kalø";"no";0;0;0;56,3;10,5
1826;"Kalø";"no";0;0;0;56,3;10,5
1827;"Kalø";"no";0;0;0;56,3;10,5
1828;"Kalø";"no";0;0;0;56,3;10,5
1829;"Kalø";"no";0;0;0;56,3;10,5
1830;"Kalø";"no";0;0;0;56,3;10,5
1831;"Kalø";"no";0;0;0;56,3;10,5
1832;"Kalø";"no";0;0;0;56,3;10,5
1833;"Kalø";"no";0;0;0;56,3;10,5
1834;"Kalø";"no";0;0;0;56,3;10,5
1835;"Kalø";"no";0;0;0;56,3;10,5
1836;"Kalø";"no";0;0;0;56,3;10,5
1837;"Kalø";"no";0;0;0;56,3;10,5
1838;"Kalø";"no";0;0;0;56,3;10,5
1839;"Kalø";"no";0;0;0;56,3;10,5
1840;"Kalø";"no";0;0;0;56,3;10,5
1841;"Kalø";"no";0;0;0;56,3;10,5
1842;"Kalø";"no";0;0;0;56,3;10,5
1843;"Kalø";"no";0;0;0;56,3;10,5
1844;"Kalø";"no";0;0;0;56,3;10,5
1845;"Kalø";"no";0;0;0;56,3;10,5
1846;"Kalø";"no";0;0;0;56,3;10,5
1847;"Kalø";"no";0;0;0;56,3;10,5
1848;"Kalø";"no";0;0;0;56,3;10,5
1849;"Kalø";"no";0;0;0;56,3;10,5
1850;"Kalø";"no";0;0;0;56,3;10,5
1851;"Kalø";"no";0;0;0;56,3;10,5
1852;"Kalø";"no";0;0;0;56,3;10,5
1853;"Kalø";"no";1;0;1;56,3;10,5
1854;"Kalø";"no";1;0;1;56,3;10,5
1855;"Kalø";"no";2;0;2;56,3;10,5
1856;"Kalø";"no";0;0;0;56,3;10,5
1857;"Kalø";"no";0;0;0;56,3;10,5
1634;"Hundested";"no";0;0;0;55,97;11,847
1635;"Hundested";"no";0;0;0;55,97;11,847
1636;"Hundested";"no";0;0;0;55,97;11,847
1637;"Hundested";"no";0;0;0;55,97;11,847
1638;"Hundested";"no";0;0;0;55,97;11,847
1639;"Hundested";"no";0;0;0;55,97;11,847
1640;"Hundested";"no";0;0;0;55,97;11,847
1641;"Hundested";"no";0;0;0;55,97;11,847
1642;"Hundested";"no";0;0;0;55,97;11,847
1643;"Hundested";"no";0;0;0;55,97;11,847
1644;"Hundested";"no";0;0;0;55,97;11,847
1645;"Hundested";"no";0;0;0;55,97;11,847
1646;"Hundested";"no";0;0;0;55,97;11,847
1647;"Hundested";"no";0;0;0;55,97;11,847
1648;"Hundested";"no";0;0;0;55,97;11,847
1649;"Hundested";"no";0;0;0;55,97;11,847
1650;"Hundested";"no";0;0;0;55,97;11,847
1651;"Hundested";"no";0;0;0;55,97;11,847
1652;"Hundested";"no";0;0;0;55,97;11,847
1653;"Hundested";"no";0;0;0;55,97;11,847
1654;"Hundested";"no";0;0;0;55,97;11,847
1655;"Hundested";"no";0;0;0;55,97;11,847
1656;"Hundested";"no";0;0;0;55,97;11,847
1657;"Hundested";"no";0;0;0;55,97;11,847
1658;"Hundested";"no";0;0;0;55,97;11,847
1659;"Hundested";"no";0;0;0;55,97;11,847
1660;"Hundested";"no";0;0;0;55,97;11,847
1661;"Hundested";"no";0;0;0;55,97;11,847
1662;"Hundested";"no";0;0;0;55,97;11,847
1663;"Hundested";"no";0;0;0;55,97;11,847
1664;"Hundested";"no";0;0;0;55,97;11,847
1665;"Hundested";"no";0;0;0;55,97;11,847
1666;"Hundested";"no";0;0;0;55,97;11,847
1667;"Hundested";"no";0;0;0;55,97;11,847
1668;"Hundested";"no";0;0;0;55,97;11,847
1669;"Hundested";"no";0;0;0;55,97;11,847
1670;"Hundested";"no";0;0;0;55,97;11,847
1671;"Hundested";"no";0;0;0;55,97;11,847
1672;"Hundested";"no";0;0;0;55,97;11,847
1673;"Hundested";"no";0;0;0;55,97;11,847
1674;"Hundested";"no";0;0;0;55,97;11,847
1675;"Hundested";"no";0;0;0;55,97;11,847
1676;"Hundested";"no";0;0;0;55,97;11,847
1677;"Hundested";"no";0;0;0;55,97;11,847
1678;"Hundested";"no";0;0;0;55,97;11,847
1679;"Hundested";"no";0;0;0;55,97;11,847
1680;"Hundested";"no";0;0;0;55,97;11,847
1681;"Hundested";"no";0;0;0;55,97;11,847
1682;"Hundested";"no";0;0;0;55,97;11,847
1683;"Hundested";"no";0;0;0;55,97;11,847
1684;"Hundested";"no";0;0;0;55,97;11,847
1685;"Hundested";"no";0;0;0;55,97;11,847
1686;"Hundested";"no";0;0;0;55,97;11,847
1687;"Hundested";"no";0;0;0;55,97;11,847
1688;"Hundested";"no";0;0;0;55,97;11,847
1689;"Hundested";"no";0;0;0;55,97;11,847
1690;"Hundested";"no";0;0;0;55,97;11,847
1691;"Hundested";"no";0;0;0;55,97;11,847
1692;"Hundested";"no";0;0;0;55,97;11,847
1693;"Hundested";"no";0;0;0;55,97;11,847
1694;"Hundested";"no";0;0;0;55,97;11,847
1695;"Hundested";"no";0;0;0;55,97;11,847
1696;"Hundested";"no";0;0;0;55,97;11,847
1697;"Hundested";"no";0;0;0;55,97;11,847
1698;"Hundested";"no";0;0;0;55,97;11,847
1699;"Hundested";"no";0;0;0;55,97;11,847
1700;"Hundested";"no";0;0;0;55,97;11,847
1701;"Hundested";"no";0;0;0;55,97;11,847
1702;"Hundested";"no";0;0;0;55,97;11,847
1703;"Hundested";"no";0;0;0;55,97;11,847
1704;"Hundested";"no";0;0;0;55,97;11,847
1705;"Hundested";"no";0;0;0;55,97;11,847
1706;"Hundested";"no";0;0;0;55,97;11,847
1707;"Hundested";"no";0;0;0;55,97;11,847
1708;"Hundested";"no";0;0;0;55,97;11,847
1709;"Hundested";"no";0;0;0;55,97;11,847
1710;"Hundested";"no";0;0;0;55,97;11,847
1711;"Hundested";"no";0;0;0;55,97;11,847
1712;"Hundested";"no";0;0;0;55,97;11,847
1713;"Hundested";"no";0;0;0;55,97;11,847
1714;"Hundested";"no";0;0;0;55,97;11,847
1715;"Hundested";"no";0;0;0;55,97;11,847
1716;"Hundested";"no";0;0;0;55,97;11,847
1717;"Hundested";"no";0;0;0;55,97;11,847
1718;"Hundested";"no";0;0;0;55,97;11,847
1719;"Hundested";"no";0;0;0;55,97;11,847
1720;"Hundested";"no";0;0;0;55,97;11,847
1721;"Hundested";"no";0;0;0;55,97;11,847
1722;"Hundested";"no";0;0;0;55,97;11,847
1723;"Hundested";"no";0;0;0;55,97;11,847
1724;"Hundested";"no";0;0;0;55,97;11,847
1725;"Hundested";"no";0;0;0;55,97;11,847
1726;"Hundested";"no";0;0;0;55,97;11,847
1727;"Hundested";"no";0;0;0;55,97;11,847
1728;"Hundested";"no";0;0;0;55,97;11,847
1729;"Hundested";"no";0;0;0;55,97;11,847
1730;"Hundested";"no";0;0;0;55,97;11,847
1731;"Hundested";"no";0;0;0;55,97;11,847
1732;"Hundested";"no";0;0;0;55,97;11,847
1733;"Hundested";"no";0;0;0;55,97;11,847
1734;"Hundested";"no";0;0;0;55,97;11,847
1735;"Hundested";"no";0;0;0;55,97;11,847
1736;"Hundested";"no";0;0;0;55,97;11,847
1737;"Hundested";"no";0;0;0;55,97;11,847
1738;"Hundested";"no";0;0;0;55,97;11,847
1739;"Hundested";"no";0;0;0;55,97;11,847
1740;"Hundested";"no";0;0;0;55,97;11,847
1741;"Hundested";"no";0;0;0;55,97;11,847
1742;"Hundested";"no";0;0;0;55,97;11,847
1743;"Hundested";"no";0;0;0;55,97;11,847
1744;"Hundested";"no";0;0;0;55,97;11,847
1745;"Hundested";"no";0;0;0;55,97;11,847
1746;"Hundested";"no";0;0;0;55,97;11,847
1747;"Hundested";"no";0;0;0;55,97;11,847
1748;"Hundested";"no";0;0;0;55,97;11,847
1749;"Hundested";"no";0;0;0;55,97;11,847
1750;"Hundested";"no";0;0;0;55,97;11,847
1751;"Hundested";"no";0;0;0;55,97;11,847
1752;"Hundested";"no";0;0;0;55,97;11,847
1753;"Hundested";"no";0;0;0;55,97;11,847
1754;"Hundested";"no";0;0;0;55,97;11,847
1755;"Hundested";"no";0;0;0;55,97;11,847
1756;"Hundested";"no";0;0;0;55,97;11,847
1757;"Hundested";"no";0;0;0;55,97;11,847
1758;"Hundested";"no";0;0;0;55,97;11,847
1759;"Hundested";"no";0;0;0;55,97;11,847
1760;"Hundested";"no";0;0;0;55,97;11,847
1761;"Hundested";"no";0;0;0;55,97;11,847
1762;"Hundested";"no";0;0;0;55,97;11,847
1763;"Hundested";"no";0;0;0;55,97;11,847
1764;"Hundested";"no";0;0;0;55,97;11,847
1765;"Hundested";"no";0;0;0;55,97;11,847
1766;"Hundested";"no";0;0;0;55,97;11,847
1767;"Hundested";"no";0;0;0;55,97;11,847
1768;"Hundested";"no";0;0;0;55,97;11,847
1769;"Hundested";"no";0;0;0;55,97;11,847
1770;"Hundested";"no";0;0;0;55,97;11,847
1771;"Hundested";"no";0;0;0;55,97;11,847
1772;"Hundested";"no";0;0;0;55,97;11,847
1773;"Hundested";"no";0;0;0;55,97;11,847
1774;"Hundested";"no";0;0;0;55,97;11,847
1775;"Hundested";"no";0;0;0;55,97;11,847
1776;"Hundested";"no";0;0;0;55,97;11,847
1777;"Hundested";"no";0;0;0;55,97;11,847
1778;"Hundested";"no";0;0;0;55,97;11,847
1779;"Hundested";"no";0;0;0;55,97;11,847
1780;"Hundested";"no";0;0;0;55,97;11,847
1781;"Hundested";"no";0;0;0;55,97;11,847
1782;"Hundested";"no";0;0;0;55,97;11,847
1783;"Hundested";"no";0;0;0;55,97;11,847
1784;"Hundested";"no";0;0;0;55,97;11,847
1785;"Hundested";"no";0;0;0;55,97;11,847
1786;"Hundested";"no";0;0;0;55,97;11,847
1787;"Hundested";"no";0;0;0;55,97;11,847
1788;"Hundested";"no";0;0;0;55,97;11,847
1789;"Hundested";"no";0;0;0;55,97;11,847
1790;"Hundested";"no";0;0;0;55,97;11,847
1791;"Hundested";"no";0;0;0;55,97;11,847
1792;"Hundested";"no";0;0;0;55,97;11,847
1793;"Hundested";"no";0;0;0;55,97;11,847
1794;"Hundested";"no";0;0;0;55,97;11,847
1795;"Hundested";"no";0;0;0;55,97;11,847
1796;"Hundested";"no";0;0;0;55,97;11,847
1797;"Hundested";"no";0;0;0;55,97;11,847
1798;"Hundested";"no";0;0;0;55,97;11,847
1799;"Hundested";"no";0;0;0;55,97;11,847
1800;"Hundested";"no";0;0;0;55,97;11,847
1801;"Hundested";"no";0;0;0;55,97;11,847
1802;"Hundested";"no";0;0;0;55,97;11,847
1803;"Hundested";"no";0;0;0;55,97;11,847
1804;"Hundested";"no";0;0;0;55,97;11,847
1805;"Hundested";"no";0;0;0;55,97;11,847
1806;"Hundested";"no";0;0;0;55,97;11,847
1807;"Hundested";"no";0;0;0;55,97;11,847
1808;"Hundested";"no";0;0;0;55,97;11,847
1809;"Hundested";"no";0;0;0;55,97;11,847
1810;"Hundested";"no";0;0;0;55,97;11,847
1811;"Hundested";"no";0;0;0;55,97;11,847
1812;"Hundested";"no";0;0;0;55,97;11,847
1813;"Hundested";"no";0;0;0;55,97;11,847
1814;"Hundested";"no";0;0;0;55,97;11,847
1815;"Hundested";"no";0;0;0;55,97;11,847
1816;"Hundested";"no";0;0;0;55,97;11,847
1817;"Hundested";"no";0;0;0;55,97;11,847
1818;"Hundested";"no";0;0;0;55,97;11,847
1819;"Hundested";"no";0;0;0;55,97;11,847
1820;"Hundested";"no";0;0;0;55,97;11,847
1821;"Hundested";"no";0;0;0;55,97;11,847
1822;"Hundested";"no";0;0;0;55,97;11,847
1823;"Hundested";"no";0;0;0;55,97;11,847
1824;"Hundested";"no";0;0;0;55,97;11,847
1825;"Hundested";"no";0;0;0;55,97;11,847
1826;"Hundested";"no";0;0;0;55,97;11,847
1827;"Hundested";"no";0;0;0;55,97;11,847
1828;"Hundested";"no";0;0;0;55,97;11,847
1829;"Hundested";"no";0;0;0;55,97;11,847
1830;"Hundested";"no";0;0;0;55,97;11,847
1831;"Hundested";"no";0;0;0;55,97;11,847
1832;"Hundested";"no";0;0;0;55,97;11,847
1833;"Hundested";"no";0;0;0;55,97;11,847
1834;"Hundested";"no";0;0;0;55,97;11,847
1835;"Hundested";"no";0;0;0;55,97;11,847
1836;"Hundested";"no";0;0;0;55,97;11,847
1837;"Hundested";"no";0;0;0;55,97;11,847
1838;"Hundested";"no";0;0;0;55,97;11,847
1839;"Hundested";"no";0;0;0;55,97;11,847
1840;"Hundested";"no";0;0;0;55,97;11,847
1841;"Hundested";"no";0;0;0;55,97;11,847
1842;"Hundested";"no";0;0;0;55,97;11,847
1843;"Hundested";"no";0;0;0;55,97;11,847
1844;"Hundested";"no";0;0;0;55,97;11,847
1845;"Hundested";"no";0;0;0;55,97;11,847
1846;"Hundested";"no";0;0;0;55,97;11,847
1847;"Hundested";"no";0;0;0;55,97;11,847
1848;"Hundested";"no";0;0;0;55,97;11,847
1849;"Hundested";"no";0;0;0;55,97;11,847
1850;"Hundested";"no";0;0;0;55,97;11,847
1851;"Hundested";"no";0;0;0;55,97;11,847
1852;"Hundested";"no";0;0;0;55,97;11,847
1853;"Hundested";"no";0;1;1;55,97;11,847
1854;"Hundested";"no";3;0;3;55,97;11,847
1855;"Hundested";"no";0;0;0;55,97;11,847
1856;"Hundested";"no";0;0;0;55,97;11,847
1857;"Hundested";"no";0;0;0;55,97;11,847
1634;"Allinge";"no";0;0;0;55,25;14,802222
1635;"Allinge";"no";0;0;0;55,25;14,802222
1636;"Allinge";"no";0;0;0;55,25;14,802222
1637;"Allinge";"no";0;0;0;55,25;14,802222
1638;"Allinge";"no";0;0;0;55,25;14,802222
1639;"Allinge";"no";0;0;0;55,25;14,802222
1640;"Allinge";"no";0;0;0;55,25;14,802222
1641;"Allinge";"no";0;0;0;55,25;14,802222
1642;"Allinge";"no";0;0;0;55,25;14,802222
1643;"Allinge";"no";0;0;0;55,25;14,802222
1644;"Allinge";"no";0;0;0;55,25;14,802222
1645;"Allinge";"no";0;0;0;55,25;14,802222
1646;"Allinge";"no";0;0;0;55,25;14,802222
1647;"Allinge";"no";0;0;0;55,25;14,802222
1648;"Allinge";"no";0;0;0;55,25;14,802222
1649;"Allinge";"no";0;0;0;55,25;14,802222
1650;"Allinge";"no";0;0;0;55,25;14,802222
1651;"Allinge";"no";0;0;0;55,25;14,802222
1652;"Allinge";"no";0;0;0;55,25;14,802222
1653;"Allinge";"no";0;0;0;55,25;14,802222
1654;"Allinge";"no";0;0;0;55,25;14,802222
1655;"Allinge";"no";0;0;0;55,25;14,802222
1656;"Allinge";"no";0;0;0;55,25;14,802222
1657;"Allinge";"no";0;0;0;55,25;14,802222
1658;"Allinge";"no";0;0;0;55,25;14,802222
1659;"Allinge";"no";0;0;0;55,25;14,802222
1660;"Allinge";"no";0;0;0;55,25;14,802222
1661;"Allinge";"no";0;0;0;55,25;14,802222
1662;"Allinge";"no";0;0;0;55,25;14,802222
1663;"Allinge";"no";0;0;0;55,25;14,802222
1664;"Allinge";"no";0;0;0;55,25;14,802222
1665;"Allinge";"no";0;0;0;55,25;14,802222
1666;"Allinge";"no";0;0;0;55,25;14,802222
1667;"Allinge";"no";0;0;0;55,25;14,802222
1668;"Allinge";"no";0;0;0;55,25;14,802222
1669;"Allinge";"no";0;0;0;55,25;14,802222
1670;"Allinge";"no";0;0;0;55,25;14,802222
1671;"Allinge";"no";0;0;0;55,25;14,802222
1672;"Allinge";"no";0;0;0;55,25;14,802222
1673;"Allinge";"no";0;0;0;55,25;14,802222
1674;"Allinge";"no";0;0;0;55,25;14,802222
1675;"Allinge";"no";0;0;0;55,25;14,802222
1676;"Allinge";"no";0;0;0;55,25;14,802222
1677;"Allinge";"no";0;0;0;55,25;14,802222
1678;"Allinge";"no";0;0;0;55,25;14,802222
1679;"Allinge";"no";0;0;0;55,25;14,802222
1680;"Allinge";"no";0;0;0;55,25;14,802222
1681;"Allinge";"no";0;0;0;55,25;14,802222
1682;"Allinge";"no";0;0;0;55,25;14,802222
1683;"Allinge";"no";0;0;0;55,25;14,802222
1684;"Allinge";"no";0;0;0;55,25;14,802222
1685;"Allinge";"no";0;0;0;55,25;14,802222
1686;"Allinge";"no";0;0;0;55,25;14,802222
1687;"Allinge";"no";0;0;0;55,25;14,802222
1688;"Allinge";"no";0;0;0;55,25;14,802222
1689;"Allinge";"no";0;0;0;55,25;14,802222
1690;"Allinge";"no";0;0;0;55,25;14,802222
1691;"Allinge";"no";0;0;0;55,25;14,802222
1692;"Allinge";"no";0;0;0;55,25;14,802222
1693;"Allinge";"no";0;0;0;55,25;14,802222
1694;"Allinge";"no";0;0;0;55,25;14,802222
1695;"Allinge";"no";0;0;0;55,25;14,802222
1696;"Allinge";"no";0;0;0;55,25;14,802222
1697;"Allinge";"no";0;0;0;55,25;14,802222
1698;"Allinge";"no";0;0;0;55,25;14,802222
1699;"Allinge";"no";0;0;0;55,25;14,802222
1700;"Allinge";"no";0;0;0;55,25;14,802222
1701;"Allinge";"no";0;0;0;55,25;14,802222
1702;"Allinge";"no";0;0;0;55,25;14,802222
1703;"Allinge";"no";0;0;0;55,25;14,802222
1704;"Allinge";"no";0;0;0;55,25;14,802222
1705;"Allinge";"no";0;0;0;55,25;14,802222
1706;"Allinge";"no";0;0;0;55,25;14,802222
1707;"Allinge";"no";0;0;0;55,25;14,802222
1708;"Allinge";"no";0;0;0;55,25;14,802222
1709;"Allinge";"no";0;0;0;55,25;14,802222
1710;"Allinge";"no";0;0;0;55,25;14,802222
1711;"Allinge";"no";0;0;0;55,25;14,802222
1712;"Allinge";"no";0;0;0;55,25;14,802222
1713;"Allinge";"no";0;0;0;55,25;14,802222
1714;"Allinge";"no";0;0;0;55,25;14,802222
1715;"Allinge";"no";0;0;0;55,25;14,802222
1716;"Allinge";"no";0;0;0;55,25;14,802222
1717;"Allinge";"no";0;0;0;55,25;14,802222
1718;"Allinge";"no";0;0;0;55,25;14,802222
1719;"Allinge";"no";0;0;0;55,25;14,802222
1720;"Allinge";"no";0;0;0;55,25;14,802222
1721;"Allinge";"no";0;0;0;55,25;14,802222
1722;"Allinge";"no";0;0;0;55,25;14,802222
1723;"Allinge";"no";0;0;0;55,25;14,802222
1724;"Allinge";"no";0;0;0;55,25;14,802222
1725;"Allinge";"no";0;0;0;55,25;14,802222
1726;"Allinge";"no";0;0;0;55,25;14,802222
1727;"Allinge";"no";0;0;0;55,25;14,802222
1728;"Allinge";"no";0;0;0;55,25;14,802222
1729;"Allinge";"no";0;0;0;55,25;14,802222
1730;"Allinge";"no";0;0;0;55,25;14,802222
1731;"Allinge";"no";0;0;0;55,25;14,802222
1732;"Allinge";"no";0;0;0;55,25;14,802222
1733;"Allinge";"no";0;0;0;55,25;14,802222
1734;"Allinge";"no";0;0;0;55,25;14,802222
1735;"Allinge";"no";0;0;0;55,25;14,802222
1736;"Allinge";"no";0;0;0;55,25;14,802222
1737;"Allinge";"no";0;0;0;55,25;14,802222
1738;"Allinge";"no";0;0;0;55,25;14,802222
1739;"Allinge";"no";0;0;0;55,25;14,802222
1740;"Allinge";"no";0;0;0;55,25;14,802222
1741;"Allinge";"no";0;0;0;55,25;14,802222
1742;"Allinge";"no";0;0;0;55,25;14,802222
1743;"Allinge";"no";0;0;0;55,25;14,802222
1744;"Allinge";"no";0;0;0;55,25;14,802222
1745;"Allinge";"no";0;0;0;55,25;14,802222
1746;"Allinge";"no";0;0;0;55,25;14,802222
1747;"Allinge";"no";0;0;0;55,25;14,802222
1748;"Allinge";"no";0;0;0;55,25;14,802222
1749;"Allinge";"no";0;0;0;55,25;14,802222
1750;"Allinge";"no";0;0;0;55,25;14,802222
1751;"Allinge";"no";0;0;0;55,25;14,802222
1752;"Allinge";"no";0;0;0;55,25;14,802222
1753;"Allinge";"no";0;0;0;55,25;14,802222
1754;"Allinge";"no";0;0;0;55,25;14,802222
1755;"Allinge";"no";0;0;0;55,25;14,802222
1756;"Allinge";"no";0;0;0;55,25;14,802222
1757;"Allinge";"no";0;0;0;55,25;14,802222
1758;"Allinge";"no";0;0;0;55,25;14,802222
1759;"Allinge";"no";0;0;0;55,25;14,802222
1760;"Allinge";"no";0;0;0;55,25;14,802222
1761;"Allinge";"no";0;0;0;55,25;14,802222
1762;"Allinge";"no";0;0;0;55,25;14,802222
1763;"Allinge";"no";0;0;0;55,25;14,802222
1764;"Allinge";"no";0;0;0;55,25;14,802222
1765;"Allinge";"no";0;0;0;55,25;14,802222
1766;"Allinge";"no";0;0;0;55,25;14,802222
1767;"Allinge";"no";0;0;0;55,25;14,802222
1768;"Allinge";"no";0;0;0;55,25;14,802222
1769;"Allinge";"no";0;0;0;55,25;14,802222
1770;"Allinge";"no";0;0;0;55,25;14,802222
1771;"Allinge";"no";0;0;0;55,25;14,802222
1772;"Allinge";"no";0;0;0;55,25;14,802222
1773;"Allinge";"no";0;0;0;55,25;14,802222
1774;"Allinge";"no";0;0;0;55,25;14,802222
1775;"Allinge";"no";0;0;0;55,25;14,802222
1776;"Allinge";"no";0;0;0;55,25;14,802222
1777;"Allinge";"no";0;0;0;55,25;14,802222
1778;"Allinge";"no";0;0;0;55,25;14,802222
1779;"Allinge";"no";0;0;0;55,25;14,802222
1780;"Allinge";"no";0;0;0;55,25;14,802222
1781;"Allinge";"no";0;0;0;55,25;14,802222
1782;"Allinge";"no";0;0;0;55,25;14,802222
1783;"Allinge";"no";0;0;0;55,25;14,802222
1784;"Allinge";"no";0;0;0;55,25;14,802222
1785;"Allinge";"no";0;0;0;55,25;14,802222
1786;"Allinge";"no";0;0;0;55,25;14,802222
1787;"Allinge";"no";0;0;0;55,25;14,802222
1788;"Allinge";"no";0;0;0;55,25;14,802222
1789;"Allinge";"no";0;0;0;55,25;14,802222
1790;"Allinge";"no";0;0;0;55,25;14,802222
1791;"Allinge";"no";0;0;0;55,25;14,802222
1792;"Allinge";"no";0;0;0;55,25;14,802222
1793;"Allinge";"no";0;0;0;55,25;14,802222
1794;"Allinge";"no";0;0;0;55,25;14,802222
1795;"Allinge";"no";0;0;0;55,25;14,802222
1796;"Allinge";"no";0;0;0;55,25;14,802222
1797;"Allinge";"no";0;0;0;55,25;14,802222
1798;"Allinge";"no";0;0;0;55,25;14,802222
1799;"Allinge";"no";0;0;0;55,25;14,802222
1800;"Allinge";"no";0;0;0;55,25;14,802222
1801;"Allinge";"no";0;0;0;55,25;14,802222
1802;"Allinge";"no";0;0;0;55,25;14,802222
1803;"Allinge";"no";0;0;0;55,25;14,802222
1804;"Allinge";"no";0;0;0;55,25;14,802222
1805;"Allinge";"no";0;0;0;55,25;14,802222
1806;"Allinge";"no";0;0;0;55,25;14,802222
1807;"Allinge";"no";0;0;0;55,25;14,802222
1808;"Allinge";"no";0;0;0;55,25;14,802222
1809;"Allinge";"no";0;0;0;55,25;14,802222
1810;"Allinge";"no";0;0;0;55,25;14,802222
1811;"Allinge";"no";0;0;0;55,25;14,802222
1812;"Allinge";"no";0;0;0;55,25;14,802222
1813;"Allinge";"no";0;0;0;55,25;14,802222
1814;"Allinge";"no";0;0;0;55,25;14,802222
1815;"Allinge";"no";0;0;0;55,25;14,802222
1816;"Allinge";"no";0;0;0;55,25;14,802222
1817;"Allinge";"no";0;0;0;55,25;14,802222
1818;"Allinge";"no";0;0;0;55,25;14,802222
1819;"Allinge";"no";0;0;0;55,25;14,802222
1820;"Allinge";"no";0;0;0;55,25;14,802222
1821;"Allinge";"no";0;0;0;55,25;14,802222
1822;"Allinge";"no";0;0;0;55,25;14,802222
1823;"Allinge";"no";0;0;0;55,25;14,802222
1824;"Allinge";"no";0;0;0;55,25;14,802222
1825;"Allinge";"no";0;0;0;55,25;14,802222
1826;"Allinge";"no";0;0;0;55,25;14,802222
1827;"Allinge";"no";0;0;0;55,25;14,802222
1828;"Allinge";"no";0;0;0;55,25;14,802222
1829;"Allinge";"no";0;0;0;55,25;14,802222
1830;"Allinge";"no";0;0;0;55,25;14,802222
1831;"Allinge";"no";0;0;0;55,25;14,802222
1832;"Allinge";"no";0;0;0;55,25;14,802222
1833;"Allinge";"no";0;0;0;55,25;14,802222
1834;"Allinge";"no";0;0;0;55,25;14,802222
1835;"Allinge";"no";0;0;0;55,25;14,802222
1836;"Allinge";"no";0;0;0;55,25;14,802222
1837;"Allinge";"no";0;0;0;55,25;14,802222
1838;"Allinge";"no";0;0;0;55,25;14,802222
1839;"Allinge";"no";0;0;0;55,25;14,802222
1840;"Allinge";"no";0;0;0;55,25;14,802222
1841;"Allinge";"no";0;0;0;55,25;14,802222
1842;"Allinge";"no";0;0;0;55,25;14,802222
1843;"Allinge";"no";0;0;0;55,25;14,802222
1844;"Allinge";"no";0;0;0;55,25;14,802222
1845;"Allinge";"no";0;0;0;55,25;14,802222
1846;"Allinge";"no";0;0;0;55,25;14,802222
1847;"Allinge";"no";0;0;0;55,25;14,802222
1848;"Allinge";"no";0;0;0;55,25;14,802222
1849;"Allinge";"no";0;0;0;55,25;14,802222
1850;"Allinge";"no";0;0;0;55,25;14,802222
1851;"Allinge";"no";0;0;0;55,25;14,802222
1852;"Allinge";"no";0;0;0;55,25;14,802222
1853;"Allinge";"no";0;0;0;55,25;14,802222
1854;"Allinge";"no";0;0;0;55,25;14,802222
1855;"Allinge";"no";1;0;1;55,25;14,802222
1856;"Allinge";"no";0;0;0;55,25;14,802222
1857;"Allinge";"no";0;0;0;55,25;14,802222
1634;"Bognæs";"no";0;0;0;55,842222;11,624722
1635;"Bognæs";"no";0;0;0;55,842222;11,624722
1636;"Bognæs";"no";0;0;0;55,842222;11,624722
1637;"Bognæs";"no";0;0;0;55,842222;11,624722
1638;"Bognæs";"no";0;0;0;55,842222;11,624722
1639;"Bognæs";"no";0;0;0;55,842222;11,624722
1640;"Bognæs";"no";0;0;0;55,842222;11,624722
1641;"Bognæs";"no";0;0;0;55,842222;11,624722
1642;"Bognæs";"no";0;0;0;55,842222;11,624722
1643;"Bognæs";"no";0;0;0;55,842222;11,624722
1644;"Bognæs";"no";0;0;0;55,842222;11,624722
1645;"Bognæs";"no";0;0;0;55,842222;11,624722
1646;"Bognæs";"no";0;1;1;55,842222;11,624722
1647;"Bognæs";"no";0;0;0;55,842222;11,624722
1648;"Bognæs";"no";0;0;0;55,842222;11,624722
1649;"Bognæs";"no";0;0;0;55,842222;11,624722
1650;"Bognæs";"no";0;0;0;55,842222;11,624722
1651;"Bognæs";"no";0;0;0;55,842222;11,624722
1652;"Bognæs";"no";0;0;0;55,842222;11,624722
1653;"Bognæs";"no";0;0;0;55,842222;11,624722
1654;"Bognæs";"no";0;0;0;55,842222;11,624722
1655;"Bognæs";"no";0;0;0;55,842222;11,624722
1656;"Bognæs";"no";0;0;0;55,842222;11,624722
1657;"Bognæs";"no";0;0;0;55,842222;11,624722
1658;"Bognæs";"no";0;0;0;55,842222;11,624722
1659;"Bognæs";"no";0;0;0;55,842222;11,624722
1660;"Bognæs";"no";0;0;0;55,842222;11,624722
1661;"Bognæs";"no";0;0;0;55,842222;11,624722
1662;"Bognæs";"no";0;0;0;55,842222;11,624722
1663;"Bognæs";"no";0;0;0;55,842222;11,624722
1664;"Bognæs";"no";0;0;0;55,842222;11,624722
1665;"Bognæs";"no";0;0;0;55,842222;11,624722
1666;"Bognæs";"no";0;0;0;55,842222;11,624722
1667;"Bognæs";"no";0;0;0;55,842222;11,624722
1668;"Bognæs";"no";0;0;0;55,842222;11,624722
1669;"Bognæs";"no";0;0;0;55,842222;11,624722
1670;"Bognæs";"no";0;0;0;55,842222;11,624722
1671;"Bognæs";"no";0;0;0;55,842222;11,624722
1672;"Bognæs";"no";0;0;0;55,842222;11,624722
1673;"Bognæs";"no";0;0;0;55,842222;11,624722
1674;"Bognæs";"no";0;0;0;55,842222;11,624722
1675;"Bognæs";"no";0;0;0;55,842222;11,624722
1676;"Bognæs";"no";0;0;0;55,842222;11,624722
1677;"Bognæs";"no";0;0;0;55,842222;11,624722
1678;"Bognæs";"no";0;0;0;55,842222;11,624722
1679;"Bognæs";"no";0;0;0;55,842222;11,624722
1680;"Bognæs";"no";0;0;0;55,842222;11,624722
1681;"Bognæs";"no";0;0;0;55,842222;11,624722
1682;"Bognæs";"no";0;0;0;55,842222;11,624722
1683;"Bognæs";"no";0;0;0;55,842222;11,624722
1684;"Bognæs";"no";0;0;0;55,842222;11,624722
1685;"Bognæs";"no";0;0;0;55,842222;11,624722
1686;"Bognæs";"no";0;0;0;55,842222;11,624722
1687;"Bognæs";"no";0;0;0;55,842222;11,624722
1688;"Bognæs";"no";0;0;0;55,842222;11,624722
1689;"Bognæs";"no";0;0;0;55,842222;11,624722
1690;"Bognæs";"no";0;0;0;55,842222;11,624722
1691;"Bognæs";"no";0;0;0;55,842222;11,624722
1692;"Bognæs";"no";0;0;0;55,842222;11,624722
1693;"Bognæs";"no";0;0;0;55,842222;11,624722
1694;"Bognæs";"no";0;0;0;55,842222;11,624722
1695;"Bognæs";"no";0;0;0;55,842222;11,624722
1696;"Bognæs";"no";0;0;0;55,842222;11,624722
1697;"Bognæs";"no";0;0;0;55,842222;11,624722
1698;"Bognæs";"no";0;0;0;55,842222;11,624722
1699;"Bognæs";"no";0;0;0;55,842222;11,624722
1700;"Bognæs";"no";0;0;0;55,842222;11,624722
1701;"Bognæs";"no";0;0;0;55,842222;11,624722
1702;"Bognæs";"no";0;0;0;55,842222;11,624722
1703;"Bognæs";"no";0;0;0;55,842222;11,624722
1704;"Bognæs";"no";0;0;0;55,842222;11,624722
1705;"Bognæs";"no";0;0;0;55,842222;11,624722
1706;"Bognæs";"no";0;0;0;55,842222;11,624722
1707;"Bognæs";"no";0;0;0;55,842222;11,624722
1708;"Bognæs";"no";0;0;0;55,842222;11,624722
1709;"Bognæs";"no";0;0;0;55,842222;11,624722
1710;"Bognæs";"no";0;0;0;55,842222;11,624722
1711;"Bognæs";"no";0;0;0;55,842222;11,624722
1712;"Bognæs";"no";0;0;0;55,842222;11,624722
1713;"Bognæs";"no";0;0;0;55,842222;11,624722
1714;"Bognæs";"no";0;0;0;55,842222;11,624722
1715;"Bognæs";"no";0;0;0;55,842222;11,624722
1716;"Bognæs";"no";0;0;0;55,842222;11,624722
1717;"Bognæs";"no";0;0;0;55,842222;11,624722
1718;"Bognæs";"no";0;0;0;55,842222;11,624722
1719;"Bognæs";"no";0;0;0;55,842222;11,624722
1720;"Bognæs";"no";0;0;0;55,842222;11,624722
1721;"Bognæs";"no";0;0;0;55,842222;11,624722
1722;"Bognæs";"no";0;0;0;55,842222;11,624722
1723;"Bognæs";"no";0;0;0;55,842222;11,624722
1724;"Bognæs";"no";0;0;0;55,842222;11,624722
1725;"Bognæs";"no";0;0;0;55,842222;11,624722
1726;"Bognæs";"no";0;0;0;55,842222;11,624722
1727;"Bognæs";"no";0;0;0;55,842222;11,624722
1728;"Bognæs";"no";0;0;0;55,842222;11,624722
1729;"Bognæs";"no";0;0;0;55,842222;11,624722
1730;"Bognæs";"no";0;0;0;55,842222;11,624722
1731;"Bognæs";"no";0;0;0;55,842222;11,624722
1732;"Bognæs";"no";0;0;0;55,842222;11,624722
1733;"Bognæs";"no";0;0;0;55,842222;11,624722
1734;"Bognæs";"no";0;0;0;55,842222;11,624722
1735;"Bognæs";"no";0;0;0;55,842222;11,624722
1736;"Bognæs";"no";0;0;0;55,842222;11,624722
1737;"Bognæs";"no";0;0;0;55,842222;11,624722
1738;"Bognæs";"no";0;0;0;55,842222;11,624722
1739;"Bognæs";"no";0;0;0;55,842222;11,624722
1740;"Bognæs";"no";0;0;0;55,842222;11,624722
1741;"Bognæs";"no";0;0;0;55,842222;11,624722
1742;"Bognæs";"no";0;0;0;55,842222;11,624722
1743;"Bognæs";"no";0;0;0;55,842222;11,624722
1744;"Bognæs";"no";0;0;0;55,842222;11,624722
1745;"Bognæs";"no";0;0;0;55,842222;11,624722
1746;"Bognæs";"no";0;0;0;55,842222;11,624722
1747;"Bognæs";"no";0;0;0;55,842222;11,624722
1748;"Bognæs";"no";0;0;0;55,842222;11,624722
1749;"Bognæs";"no";0;0;0;55,842222;11,624722
1750;"Bognæs";"no";0;0;0;55,842222;11,624722
1751;"Bognæs";"no";0;0;0;55,842222;11,624722
1752;"Bognæs";"no";0;0;0;55,842222;11,624722
1753;"Bognæs";"no";0;0;0;55,842222;11,624722
1754;"Bognæs";"no";0;0;0;55,842222;11,624722
1755;"Bognæs";"no";0;0;0;55,842222;11,624722
1756;"Bognæs";"no";0;0;0;55,842222;11,624722
1757;"Bognæs";"no";0;0;0;55,842222;11,624722
1758;"Bognæs";"no";0;0;0;55,842222;11,624722
1759;"Bognæs";"no";0;0;0;55,842222;11,624722
1760;"Bognæs";"no";0;0;0;55,842222;11,624722
1761;"Bognæs";"no";0;0;0;55,842222;11,624722
1762;"Bognæs";"no";0;0;0;55,842222;11,624722
1763;"Bognæs";"no";0;0;0;55,842222;11,624722
1764;"Bognæs";"no";0;0;0;55,842222;11,624722
1765;"Bognæs";"no";0;0;0;55,842222;11,624722
1766;"Bognæs";"no";0;0;0;55,842222;11,624722
1767;"Bognæs";"no";0;0;0;55,842222;11,624722
1768;"Bognæs";"no";0;0;0;55,842222;11,624722
1769;"Bognæs";"no";0;0;0;55,842222;11,624722
1770;"Bognæs";"no";0;0;0;55,842222;11,624722
1771;"Bognæs";"no";0;0;0;55,842222;11,624722
1772;"Bognæs";"no";0;0;0;55,842222;11,624722
1773;"Bognæs";"no";0;0;0;55,842222;11,624722
1774;"Bognæs";"no";0;0;0;55,842222;11,624722
1775;"Bognæs";"no";0;0;0;55,842222;11,624722
1776;"Bognæs";"no";0;0;0;55,842222;11,624722
1777;"Bognæs";"no";0;0;0;55,842222;11,624722
1778;"Bognæs";"no";0;0;0;55,842222;11,624722
1779;"Bognæs";"no";0;0;0;55,842222;11,624722
1780;"Bognæs";"no";0;0;0;55,842222;11,624722
1781;"Bognæs";"no";0;0;0;55,842222;11,624722
1782;"Bognæs";"no";0;0;0;55,842222;11,624722
1783;"Bognæs";"no";0;0;0;55,842222;11,624722
1784;"Bognæs";"no";0;0;0;55,842222;11,624722
1785;"Bognæs";"no";0;0;0;55,842222;11,624722
1786;"Bognæs";"no";0;0;0;55,842222;11,624722
1787;"Bognæs";"no";0;0;0;55,842222;11,624722
1788;"Bognæs";"no";0;0;0;55,842222;11,624722
1789;"Bognæs";"no";0;0;0;55,842222;11,624722
1790;"Bognæs";"no";0;0;0;55,842222;11,624722
1791;"Bognæs";"no";0;0;0;55,842222;11,624722
1792;"Bognæs";"no";0;0;0;55,842222;11,624722
1793;"Bognæs";"no";0;0;0;55,842222;11,624722
1794;"Bognæs";"no";0;0;0;55,842222;11,624722
1795;"Bognæs";"no";0;0;0;55,842222;11,624722
1796;"Bognæs";"no";0;0;0;55,842222;11,624722
1797;"Bognæs";"no";0;0;0;55,842222;11,624722
1798;"Bognæs";"no";0;0;0;55,842222;11,624722
1799;"Bognæs";"no";0;0;0;55,842222;11,624722
1800;"Bognæs";"no";0;0;0;55,842222;11,624722
1801;"Bognæs";"no";0;0;0;55,842222;11,624722
1802;"Bognæs";"no";0;0;0;55,842222;11,624722
1803;"Bognæs";"no";0;0;0;55,842222;11,624722
1804;"Bognæs";"no";0;0;0;55,842222;11,624722
1805;"Bognæs";"no";0;0;0;55,842222;11,624722
1806;"Bognæs";"no";0;0;0;55,842222;11,624722
1807;"Bognæs";"no";0;0;0;55,842222;11,624722
1808;"Bognæs";"no";0;0;0;55,842222;11,624722
1809;"Bognæs";"no";0;0;0;55,842222;11,624722
1810;"Bognæs";"no";0;0;0;55,842222;11,624722
1811;"Bognæs";"no";0;0;0;55,842222;11,624722
1812;"Bognæs";"no";0;0;0;55,842222;11,624722
1813;"Bognæs";"no";0;0;0;55,842222;11,624722
1814;"Bognæs";"no";0;0;0;55,842222;11,624722
1815;"Bognæs";"no";0;0;0;55,842222;11,624722
1816;"Bognæs";"no";0;0;0;55,842222;11,624722
1817;"Bognæs";"no";0;0;0;55,842222;11,624722
1818;"Bognæs";"no";0;0;0;55,842222;11,624722
1819;"Bognæs";"no";0;0;0;55,842222;11,624722
1820;"Bognæs";"no";0;0;0;55,842222;11,624722
1821;"Bognæs";"no";0;0;0;55,842222;11,624722
1822;"Bognæs";"no";0;0;0;55,842222;11,624722
1823;"Bognæs";"no";0;0;0;55,842222;11,624722
1824;"Bognæs";"no";0;0;0;55,842222;11,624722
1825;"Bognæs";"no";0;0;0;55,842222;11,624722
1826;"Bognæs";"no";0;0;0;55,842222;11,624722
1827;"Bognæs";"no";0;0;0;55,842222;11,624722
1828;"Bognæs";"no";0;0;0;55,842222;11,624722
1829;"Bognæs";"no";0;0;0;55,842222;11,624722
1830;"Bognæs";"no";0;0;0;55,842222;11,624722
1831;"Bognæs";"no";0;0;0;55,842222;11,624722
1832;"Bognæs";"no";0;0;0;55,842222;11,624722
1833;"Bognæs";"no";0;0;0;55,842222;11,624722
1834;"Bognæs";"no";0;0;0;55,842222;11,624722
1835;"Bognæs";"no";0;0;0;55,842222;11,624722
1836;"Bognæs";"no";0;0;0;55,842222;11,624722
1837;"Bognæs";"no";0;0;0;55,842222;11,624722
1838;"Bognæs";"no";0;0;0;55,842222;11,624722
1839;"Bognæs";"no";0;0;0;55,842222;11,624722
1840;"Bognæs";"no";0;0;0;55,842222;11,624722
1841;"Bognæs";"no";0;0;0;55,842222;11,624722
1842;"Bognæs";"no";0;0;0;55,842222;11,624722
1843;"Bognæs";"no";0;0;0;55,842222;11,624722
1844;"Bognæs";"no";0;0;0;55,842222;11,624722
1845;"Bognæs";"no";0;0;0;55,842222;11,624722
1846;"Bognæs";"no";0;0;0;55,842222;11,624722
1847;"Bognæs";"no";0;0;0;55,842222;11,624722
1848;"Bognæs";"no";0;0;0;55,842222;11,624722
1849;"Bognæs";"no";0;0;0;55,842222;11,624722
1850;"Bognæs";"no";0;0;0;55,842222;11,624722
1851;"Bognæs";"no";0;0;0;55,842222;11,624722
1852;"Bognæs";"no";0;0;0;55,842222;11,624722
1853;"Bognæs";"no";0;0;0;55,842222;11,624722
1854;"Bognæs";"no";0;0;0;55,842222;11,624722
1855;"Bognæs";"no";0;0;0;55,842222;11,624722
1856;"Bognæs";"no";0;0;0;55,842222;11,624722
1857;"Bognæs";"no";0;0;0;55,842222;11,624722
1634;"Dragsholm";"no";0;0;0;55,771035;11,3887423
1635;"Dragsholm";"no";0;0;0;55,771035;11,3887423
1636;"Dragsholm";"no";0;0;0;55,771035;11,3887423
1637;"Dragsholm";"no";0;0;0;55,771035;11,3887423
1638;"Dragsholm";"no";0;0;0;55,771035;11,3887423
1639;"Dragsholm";"no";0;0;0;55,771035;11,3887423
1640;"Dragsholm";"no";0;0;0;55,771035;11,3887423
1641;"Dragsholm";"no";0;0;0;55,771035;11,3887423
1642;"Dragsholm";"no";0;0;0;55,771035;11,3887423
1643;"Dragsholm";"no";0;0;0;55,771035;11,3887423
1644;"Dragsholm";"no";0;0;0;55,771035;11,3887423
1645;"Dragsholm";"no";0;0;0;55,771035;11,3887423
1646;"Dragsholm";"no";0;0;0;55,771035;11,3887423
1647;"Dragsholm";"no";0;0;0;55,771035;11,3887423
1648;"Dragsholm";"no";0;0;0;55,771035;11,3887423
1649;"Dragsholm";"no";0;1;1;55,771035;11,3887423
1650;"Dragsholm";"no";0;0;0;55,771035;11,3887423
1651;"Dragsholm";"no";0;0;0;55,771035;11,3887423
1652;"Dragsholm";"no";0;0;0;55,771035;11,3887423
1653;"Dragsholm";"no";0;0;0;55,771035;11,3887423
1654;"Dragsholm";"no";0;0;0;55,771035;11,3887423
1655;"Dragsholm";"no";0;0;0;55,771035;11,3887423
1656;"Dragsholm";"no";0;0;0;55,771035;11,3887423
1657;"Dragsholm";"no";0;0;0;55,771035;11,3887423
1658;"Dragsholm";"no";0;0;0;55,771035;11,3887423
1659;"Dragsholm";"no";0;0;0;55,771035;11,3887423
1660;"Dragsholm";"no";0;0;0;55,771035;11,3887423
1661;"Dragsholm";"no";0;0;0;55,771035;11,3887423
1662;"Dragsholm";"no";0;0;0;55,771035;11,3887423
1663;"Dragsholm";"no";0;0;0;55,771035;11,3887423
1664;"Dragsholm";"no";0;0;0;55,771035;11,3887423
1665;"Dragsholm";"no";0;0;0;55,771035;11,3887423
1666;"Dragsholm";"no";0;0;0;55,771035;11,3887423
1667;"Dragsholm";"no";0;0;0;55,771035;11,3887423
1668;"Dragsholm";"no";0;0;0;55,771035;11,3887423
1669;"Dragsholm";"no";0;0;0;55,771035;11,3887423
1670;"Dragsholm";"no";0;0;0;55,771035;11,3887423
1671;"Dragsholm";"no";0;0;0;55,771035;11,3887423
1672;"Dragsholm";"no";0;0;0;55,771035;11,3887423
1673;"Dragsholm";"no";0;0;0;55,771035;11,3887423
1674;"Dragsholm";"no";0;0;0;55,771035;11,3887423
1675;"Dragsholm";"no";0;0;0;55,771035;11,3887423
1676;"Dragsholm";"no";0;0;0;55,771035;11,3887423
1677;"Dragsholm";"no";0;0;0;55,771035;11,3887423
1678;"Dragsholm";"no";0;0;0;55,771035;11,3887423
1679;"Dragsholm";"no";0;0;0;55,771035;11,3887423
1680;"Dragsholm";"no";0;0;0;55,771035;11,3887423
1681;"Dragsholm";"no";0;0;0;55,771035;11,3887423
1682;"Dragsholm";"no";0;0;0;55,771035;11,3887423
1683;"Dragsholm";"no";0;0;0;55,771035;11,3887423
1684;"Dragsholm";"no";0;0;0;55,771035;11,3887423
1685;"Dragsholm";"no";0;0;0;55,771035;11,3887423
1686;"Dragsholm";"no";0;0;0;55,771035;11,3887423
1687;"Dragsholm";"no";0;0;0;55,771035;11,3887423
1688;"Dragsholm";"no";0;0;0;55,771035;11,3887423
1689;"Dragsholm";"no";0;0;0;55,771035;11,3887423
1690;"Dragsholm";"no";0;0;0;55,771035;11,3887423
1691;"Dragsholm";"no";0;0;0;55,771035;11,3887423
1692;"Dragsholm";"no";0;0;0;55,771035;11,3887423
1693;"Dragsholm";"no";0;0;0;55,771035;11,3887423
1694;"Dragsholm";"no";0;0;0;55,771035;11,3887423
1695;"Dragsholm";"no";0;0;0;55,771035;11,3887423
1696;"Dragsholm";"no";0;0;0;55,771035;11,3887423
1697;"Dragsholm";"no";0;0;0;55,771035;11,3887423
1698;"Dragsholm";"no";0;0;0;55,771035;11,3887423
1699;"Dragsholm";"no";0;0;0;55,771035;11,3887423
1700;"Dragsholm";"no";0;0;0;55,771035;11,3887423
1701;"Dragsholm";"no";0;0;0;55,771035;11,3887423
1702;"Dragsholm";"no";0;0;0;55,771035;11,3887423
1703;"Dragsholm";"no";0;0;0;55,771035;11,3887423
1704;"Dragsholm";"no";0;0;0;55,771035;11,3887423
1705;"Dragsholm";"no";0;0;0;55,771035;11,3887423
1706;"Dragsholm";"no";0;0;0;55,771035;11,3887423
1707;"Dragsholm";"no";0;0;0;55,771035;11,3887423
1708;"Dragsholm";"no";0;0;0;55,771035;11,3887423
1709;"Dragsholm";"no";0;0;0;55,771035;11,3887423
1710;"Dragsholm";"no";0;0;0;55,771035;11,3887423
1711;"Dragsholm";"no";0;0;0;55,771035;11,3887423
1712;"Dragsholm";"no";0;0;0;55,771035;11,3887423
1713;"Dragsholm";"no";0;0;0;55,771035;11,3887423
1714;"Dragsholm";"no";0;0;0;55,771035;11,3887423
1715;"Dragsholm";"no";0;0;0;55,771035;11,3887423
1716;"Dragsholm";"no";0;0;0;55,771035;11,3887423
1717;"Dragsholm";"no";0;0;0;55,771035;11,3887423
1718;"Dragsholm";"no";0;0;0;55,771035;11,3887423
1719;"Dragsholm";"no";0;0;0;55,771035;11,3887423
1720;"Dragsholm";"no";0;0;0;55,771035;11,3887423
1721;"Dragsholm";"no";0;0;0;55,771035;11,3887423
1722;"Dragsholm";"no";0;0;0;55,771035;11,3887423
1723;"Dragsholm";"no";0;0;0;55,771035;11,3887423
1724;"Dragsholm";"no";0;0;0;55,771035;11,3887423
1725;"Dragsholm";"no";0;0;0;55,771035;11,3887423
1726;"Dragsholm";"no";0;0;0;55,771035;11,3887423
1727;"Dragsholm";"no";0;0;0;55,771035;11,3887423
1728;"Dragsholm";"no";0;0;0;55,771035;11,3887423
1729;"Dragsholm";"no";0;0;0;55,771035;11,3887423
1730;"Dragsholm";"no";0;0;0;55,771035;11,3887423
1731;"Dragsholm";"no";0;0;0;55,771035;11,3887423
1732;"Dragsholm";"no";0;0;0;55,771035;11,3887423
1733;"Dragsholm";"no";0;0;0;55,771035;11,3887423
1734;"Dragsholm";"no";0;0;0;55,771035;11,3887423
1735;"Dragsholm";"no";0;0;0;55,771035;11,3887423
1736;"Dragsholm";"no";0;0;0;55,771035;11,3887423
1737;"Dragsholm";"no";0;0;0;55,771035;11,3887423
1738;"Dragsholm";"no";0;0;0;55,771035;11,3887423
1739;"Dragsholm";"no";0;0;0;55,771035;11,3887423
1740;"Dragsholm";"no";0;0;0;55,771035;11,3887423
1741;"Dragsholm";"no";0;0;0;55,771035;11,3887423
1742;"Dragsholm";"no";0;0;0;55,771035;11,3887423
1743;"Dragsholm";"no";0;0;0;55,771035;11,3887423
1744;"Dragsholm";"no";0;0;0;55,771035;11,3887423
1745;"Dragsholm";"no";0;0;0;55,771035;11,3887423
1746;"Dragsholm";"no";0;0;0;55,771035;11,3887423
1747;"Dragsholm";"no";0;0;0;55,771035;11,3887423
1748;"Dragsholm";"no";0;0;0;55,771035;11,3887423
1749;"Dragsholm";"no";0;0;0;55,771035;11,3887423
1750;"Dragsholm";"no";0;0;0;55,771035;11,3887423
1751;"Dragsholm";"no";0;0;0;55,771035;11,3887423
1752;"Dragsholm";"no";0;0;0;55,771035;11,3887423
1753;"Dragsholm";"no";0;0;0;55,771035;11,3887423
1754;"Dragsholm";"no";0;0;0;55,771035;11,3887423
1755;"Dragsholm";"no";0;0;0;55,771035;11,3887423
1756;"Dragsholm";"no";0;0;0;55,771035;11,3887423
1757;"Dragsholm";"no";0;0;0;55,771035;11,3887423
1758;"Dragsholm";"no";0;0;0;55,771035;11,3887423
1759;"Dragsholm";"no";0;0;0;55,771035;11,3887423
1760;"Dragsholm";"no";0;0;0;55,771035;11,3887423
1761;"Dragsholm";"no";0;0;0;55,771035;11,3887423
1762;"Dragsholm";"no";0;0;0;55,771035;11,3887423
1763;"Dragsholm";"no";0;0;0;55,771035;11,3887423
1764;"Dragsholm";"no";0;0;0;55,771035;11,3887423
1765;"Dragsholm";"no";0;0;0;55,771035;11,3887423
1766;"Dragsholm";"no";0;0;0;55,771035;11,3887423
1767;"Dragsholm";"no";0;0;0;55,771035;11,3887423
1768;"Dragsholm";"no";0;0;0;55,771035;11,3887423
1769;"Dragsholm";"no";0;0;0;55,771035;11,3887423
1770;"Dragsholm";"no";0;0;0;55,771035;11,3887423
1771;"Dragsholm";"no";0;0;0;55,771035;11,3887423
1772;"Dragsholm";"no";0;0;0;55,771035;11,3887423
1773;"Dragsholm";"no";0;0;0;55,771035;11,3887423
1774;"Dragsholm";"no";0;0;0;55,771035;11,3887423
1775;"Dragsholm";"no";0;0;0;55,771035;11,3887423
1776;"Dragsholm";"no";0;0;0;55,771035;11,3887423
1777;"Dragsholm";"no";0;0;0;55,771035;11,3887423
1778;"Dragsholm";"no";0;0;0;55,771035;11,3887423
1779;"Dragsholm";"no";0;0;0;55,771035;11,3887423
1780;"Dragsholm";"no";0;0;0;55,771035;11,3887423
1781;"Dragsholm";"no";0;0;0;55,771035;11,3887423
1782;"Dragsholm";"no";0;0;0;55,771035;11,3887423
1783;"Dragsholm";"no";0;0;0;55,771035;11,3887423
1784;"Dragsholm";"no";0;0;0;55,771035;11,3887423
1785;"Dragsholm";"no";0;0;0;55,771035;11,3887423
1786;"Dragsholm";"no";0;0;0;55,771035;11,3887423
1787;"Dragsholm";"no";0;0;0;55,771035;11,3887423
1788;"Dragsholm";"no";0;0;0;55,771035;11,3887423
1789;"Dragsholm";"no";0;0;0;55,771035;11,3887423
1790;"Dragsholm";"no";0;0;0;55,771035;11,3887423
1791;"Dragsholm";"no";0;0;0;55,771035;11,3887423
1792;"Dragsholm";"no";0;0;0;55,771035;11,3887423
1793;"Dragsholm";"no";0;0;0;55,771035;11,3887423
1794;"Dragsholm";"no";0;0;0;55,771035;11,3887423
1795;"Dragsholm";"no";0;0;0;55,771035;11,3887423
1796;"Dragsholm";"no";0;0;0;55,771035;11,3887423
1797;"Dragsholm";"no";0;0;0;55,771035;11,3887423
1798;"Dragsholm";"no";0;0;0;55,771035;11,3887423
1799;"Dragsholm";"no";0;0;0;55,771035;11,3887423
1800;"Dragsholm";"no";0;0;0;55,771035;11,3887423
1801;"Dragsholm";"no";0;0;0;55,771035;11,3887423
1802;"Dragsholm";"no";0;0;0;55,771035;11,3887423
1803;"Dragsholm";"no";0;0;0;55,771035;11,3887423
1804;"Dragsholm";"no";0;0;0;55,771035;11,3887423
1805;"Dragsholm";"no";0;0;0;55,771035;11,3887423
1806;"Dragsholm";"no";0;0;0;55,771035;11,3887423
1807;"Dragsholm";"no";0;0;0;55,771035;11,3887423
1808;"Dragsholm";"no";0;0;0;55,771035;11,3887423
1809;"Dragsholm";"no";0;0;0;55,771035;11,3887423
1810;"Dragsholm";"no";0;0;0;55,771035;11,3887423
1811;"Dragsholm";"no";0;0;0;55,771035;11,3887423
1812;"Dragsholm";"no";0;0;0;55,771035;11,3887423
1813;"Dragsholm";"no";0;0;0;55,771035;11,3887423
1814;"Dragsholm";"no";0;0;0;55,771035;11,3887423
1815;"Dragsholm";"no";0;0;0;55,771035;11,3887423
1816;"Dragsholm";"no";0;0;0;55,771035;11,3887423
1817;"Dragsholm";"no";0;0;0;55,771035;11,3887423
1818;"Dragsholm";"no";0;0;0;55,771035;11,3887423
1819;"Dragsholm";"no";0;0;0;55,771035;11,3887423
1820;"Dragsholm";"no";0;0;0;55,771035;11,3887423
1821;"Dragsholm";"no";0;0;0;55,771035;11,3887423
1822;"Dragsholm";"no";0;0;0;55,771035;11,3887423
1823;"Dragsholm";"no";0;0;0;55,771035;11,3887423
1824;"Dragsholm";"no";0;0;0;55,771035;11,3887423
1825;"Dragsholm";"no";0;0;0;55,771035;11,3887423
1826;"Dragsholm";"no";0;0;0;55,771035;11,3887423
1827;"Dragsholm";"no";0;0;0;55,771035;11,3887423
1828;"Dragsholm";"no";0;0;0;55,771035;11,3887423
1829;"Dragsholm";"no";0;0;0;55,771035;11,3887423
1830;"Dragsholm";"no";0;0;0;55,771035;11,3887423
1831;"Dragsholm";"no";0;0;0;55,771035;11,3887423
1832;"Dragsholm";"no";0;0;0;55,771035;11,3887423
1833;"Dragsholm";"no";0;0;0;55,771035;11,3887423
1834;"Dragsholm";"no";0;0;0;55,771035;11,3887423
1835;"Dragsholm";"no";0;0;0;55,771035;11,3887423
1836;"Dragsholm";"no";0;0;0;55,771035;11,3887423
1837;"Dragsholm";"no";0;0;0;55,771035;11,3887423
1838;"Dragsholm";"no";0;0;0;55,771035;11,3887423
1839;"Dragsholm";"no";0;0;0;55,771035;11,3887423
1840;"Dragsholm";"no";0;0;0;55,771035;11,3887423
1841;"Dragsholm";"no";0;0;0;55,771035;11,3887423
1842;"Dragsholm";"no";0;0;0;55,771035;11,3887423
1843;"Dragsholm";"no";0;0;0;55,771035;11,3887423
1844;"Dragsholm";"no";0;0;0;55,771035;11,3887423
1845;"Dragsholm";"no";0;0;0;55,771035;11,3887423
1846;"Dragsholm";"no";0;0;0;55,771035;11,3887423
1847;"Dragsholm";"no";0;0;0;55,771035;11,3887423
1848;"Dragsholm";"no";0;0;0;55,771035;11,3887423
1849;"Dragsholm";"no";0;0;0;55,771035;11,3887423
1850;"Dragsholm";"no";0;0;0;55,771035;11,3887423
1851;"Dragsholm";"no";0;0;0;55,771035;11,3887423
1852;"Dragsholm";"no";0;0;0;55,771035;11,3887423
1853;"Dragsholm";"no";0;0;0;55,771035;11,3887423
1854;"Dragsholm";"no";0;0;0;55,771035;11,3887423
1855;"Dragsholm";"no";0;0;0;55,771035;11,3887423
1856;"Dragsholm";"no";0;0;0;55,771035;11,3887423
1857;"Dragsholm";"no";0;0;0;55,771035;11,3887423
1634;"Baagø";"no";0;0;0;55,3;9,816666
1635;"Baagø";"no";0;0;0;55,3;9,816666
1636;"Baagø";"no";0;0;0;55,3;9,816666
1637;"Baagø";"no";0;0;0;55,3;9,816666
1638;"Baagø";"no";0;0;0;55,3;9,816666
1639;"Baagø";"no";0;0;0;55,3;9,816666
1640;"Baagø";"no";0;0;0;55,3;9,816666
1641;"Baagø";"no";0;0;0;55,3;9,816666
1642;"Baagø";"no";0;0;0;55,3;9,816666
1643;"Baagø";"no";0;0;0;55,3;9,816666
1644;"Baagø";"no";0;0;0;55,3;9,816666
1645;"Baagø";"no";0;0;0;55,3;9,816666
1646;"Baagø";"no";0;0;0;55,3;9,816666
1647;"Baagø";"no";0;0;0;55,3;9,816666
1648;"Baagø";"no";0;0;0;55,3;9,816666
1649;"Baagø";"no";0;0;0;55,3;9,816666
1650;"Baagø";"no";0;0;0;55,3;9,816666
1651;"Baagø";"no";0;0;0;55,3;9,816666
1652;"Baagø";"no";0;0;0;55,3;9,816666
1653;"Baagø";"no";0;0;0;55,3;9,816666
1654;"Baagø";"no";0;0;0;55,3;9,816666
1655;"Baagø";"no";0;0;0;55,3;9,816666
1656;"Baagø";"no";0;0;0;55,3;9,816666
1657;"Baagø";"no";0;0;0;55,3;9,816666
1658;"Baagø";"no";0;0;0;55,3;9,816666
1659;"Baagø";"no";0;0;0;55,3;9,816666
1660;"Baagø";"no";0;0;0;55,3;9,816666
1661;"Baagø";"no";0;0;0;55,3;9,816666
1662;"Baagø";"no";0;0;0;55,3;9,816666
1663;"Baagø";"no";0;0;0;55,3;9,816666
1664;"Baagø";"no";0;0;0;55,3;9,816666
1665;"Baagø";"no";0;0;0;55,3;9,816666
1666;"Baagø";"no";0;1;1;55,3;9,816666
1667;"Baagø";"no";0;0;0;55,3;9,816666
1668;"Baagø";"no";0;0;0;55,3;9,816666
1669;"Baagø";"no";0;0;0;55,3;9,816666
1670;"Baagø";"no";0;0;0;55,3;9,816666
1671;"Baagø";"no";0;0;0;55,3;9,816666
1672;"Baagø";"no";0;0;0;55,3;9,816666
1673;"Baagø";"no";0;0;0;55,3;9,816666
1674;"Baagø";"no";0;0;0;55,3;9,816666
1675;"Baagø";"no";0;0;0;55,3;9,816666
1676;"Baagø";"no";0;0;0;55,3;9,816666
1677;"Baagø";"no";0;0;0;55,3;9,816666
1678;"Baagø";"no";0;0;0;55,3;9,816666
1679;"Baagø";"no";0;0;0;55,3;9,816666
1680;"Baagø";"no";0;0;0;55,3;9,816666
1681;"Baagø";"no";0;0;0;55,3;9,816666
1682;"Baagø";"no";0;0;0;55,3;9,816666
1683;"Baagø";"no";0;0;0;55,3;9,816666
1684;"Baagø";"no";0;0;0;55,3;9,816666
1685;"Baagø";"no";0;0;0;55,3;9,816666
1686;"Baagø";"no";0;0;0;55,3;9,816666
1687;"Baagø";"no";0;0;0;55,3;9,816666
1688;"Baagø";"no";0;0;0;55,3;9,816666
1689;"Baagø";"no";0;0;0;55,3;9,816666
1690;"Baagø";"no";0;0;0;55,3;9,816666
1691;"Baagø";"no";0;0;0;55,3;9,816666
1692;"Baagø";"no";0;0;0;55,3;9,816666
1693;"Baagø";"no";0;0;0;55,3;9,816666
1694;"Baagø";"no";0;0;0;55,3;9,816666
1695;"Baagø";"no";0;0;0;55,3;9,816666
1696;"Baagø";"no";0;0;0;55,3;9,816666
1697;"Baagø";"no";0;0;0;55,3;9,816666
1698;"Baagø";"no";0;0;0;55,3;9,816666
1699;"Baagø";"no";0;0;0;55,3;9,816666
1700;"Baagø";"no";0;0;0;55,3;9,816666
1701;"Baagø";"no";0;0;0;55,3;9,816666
1702;"Baagø";"no";0;0;0;55,3;9,816666
1703;"Baagø";"no";0;0;0;55,3;9,816666
1704;"Baagø";"no";0;0;0;55,3;9,816666
1705;"Baagø";"no";0;0;0;55,3;9,816666
1706;"Baagø";"no";0;0;0;55,3;9,816666
1707;"Baagø";"no";0;0;0;55,3;9,816666
1708;"Baagø";"no";0;0;0;55,3;9,816666
1709;"Baagø";"no";0;0;0;55,3;9,816666
1710;"Baagø";"no";0;0;0;55,3;9,816666
1711;"Baagø";"no";0;0;0;55,3;9,816666
1712;"Baagø";"no";0;0;0;55,3;9,816666
1713;"Baagø";"no";0;0;0;55,3;9,816666
1714;"Baagø";"no";0;0;0;55,3;9,816666
1715;"Baagø";"no";0;0;0;55,3;9,816666
1716;"Baagø";"no";0;0;0;55,3;9,816666
1717;"Baagø";"no";0;0;0;55,3;9,816666
1718;"Baagø";"no";0;0;0;55,3;9,816666
1719;"Baagø";"no";0;0;0;55,3;9,816666
1720;"Baagø";"no";0;0;0;55,3;9,816666
1721;"Baagø";"no";0;0;0;55,3;9,816666
1722;"Baagø";"no";0;0;0;55,3;9,816666
1723;"Baagø";"no";0;0;0;55,3;9,816666
1724;"Baagø";"no";0;0;0;55,3;9,816666
1725;"Baagø";"no";0;0;0;55,3;9,816666
1726;"Baagø";"no";0;0;0;55,3;9,816666
1727;"Baagø";"no";0;0;0;55,3;9,816666
1728;"Baagø";"no";0;0;0;55,3;9,816666
1729;"Baagø";"no";0;0;0;55,3;9,816666
1730;"Baagø";"no";0;0;0;55,3;9,816666
1731;"Baagø";"no";0;0;0;55,3;9,816666
1732;"Baagø";"no";0;0;0;55,3;9,816666
1733;"Baagø";"no";0;0;0;55,3;9,816666
1734;"Baagø";"no";0;0;0;55,3;9,816666
1735;"Baagø";"no";0;0;0;55,3;9,816666
1736;"Baagø";"no";0;0;0;55,3;9,816666
1737;"Baagø";"no";0;0;0;55,3;9,816666
1738;"Baagø";"no";0;0;0;55,3;9,816666
1739;"Baagø";"no";0;0;0;55,3;9,816666
1740;"Baagø";"no";0;0;0;55,3;9,816666
1741;"Baagø";"no";0;0;0;55,3;9,816666
1742;"Baagø";"no";0;0;0;55,3;9,816666
1743;"Baagø";"no";0;0;0;55,3;9,816666
1744;"Baagø";"no";0;0;0;55,3;9,816666
1745;"Baagø";"no";0;0;0;55,3;9,816666
1746;"Baagø";"no";0;0;0;55,3;9,816666
1747;"Baagø";"no";0;0;0;55,3;9,816666
1748;"Baagø";"no";0;0;0;55,3;9,816666
1749;"Baagø";"no";0;0;0;55,3;9,816666
1750;"Baagø";"no";0;0;0;55,3;9,816666
1751;"Baagø";"no";0;0;0;55,3;9,816666
1752;"Baagø";"no";0;0;0;55,3;9,816666
1753;"Baagø";"no";0;0;0;55,3;9,816666
1754;"Baagø";"no";0;0;0;55,3;9,816666
1755;"Baagø";"no";0;0;0;55,3;9,816666
1756;"Baagø";"no";0;0;0;55,3;9,816666
1757;"Baagø";"no";0;0;0;55,3;9,816666
1758;"Baagø";"no";0;0;0;55,3;9,816666
1759;"Baagø";"no";0;0;0;55,3;9,816666
1760;"Baagø";"no";0;0;0;55,3;9,816666
1761;"Baagø";"no";0;0;0;55,3;9,816666
1762;"Baagø";"no";0;0;0;55,3;9,816666
1763;"Baagø";"no";0;0;0;55,3;9,816666
1764;"Baagø";"no";0;0;0;55,3;9,816666
1765;"Baagø";"no";0;0;0;55,3;9,816666
1766;"Baagø";"no";0;0;0;55,3;9,816666
1767;"Baagø";"no";0;0;0;55,3;9,816666
1768;"Baagø";"no";0;0;0;55,3;9,816666
1769;"Baagø";"no";0;0;0;55,3;9,816666
1770;"Baagø";"no";0;0;0;55,3;9,816666
1771;"Baagø";"no";0;0;0;55,3;9,816666
1772;"Baagø";"no";0;0;0;55,3;9,816666
1773;"Baagø";"no";0;0;0;55,3;9,816666
1774;"Baagø";"no";0;0;0;55,3;9,816666
1775;"Baagø";"no";0;0;0;55,3;9,816666
1776;"Baagø";"no";0;0;0;55,3;9,816666
1777;"Baagø";"no";0;0;0;55,3;9,816666
1778;"Baagø";"no";0;0;0;55,3;9,816666
1779;"Baagø";"no";0;0;0;55,3;9,816666
1780;"Baagø";"no";0;0;0;55,3;9,816666
1781;"Baagø";"no";0;0;0;55,3;9,816666
1782;"Baagø";"no";0;0;0;55,3;9,816666
1783;"Baagø";"no";0;0;0;55,3;9,816666
1784;"Baagø";"no";0;0;0;55,3;9,816666
1785;"Baagø";"no";0;0;0;55,3;9,816666
1786;"Baagø";"no";0;0;0;55,3;9,816666
1787;"Baagø";"no";0;0;0;55,3;9,816666
1788;"Baagø";"no";0;0;0;55,3;9,816666
1789;"Baagø";"no";0;0;0;55,3;9,816666
1790;"Baagø";"no";0;0;0;55,3;9,816666
1791;"Baagø";"no";0;0;0;55,3;9,816666
1792;"Baagø";"no";0;0;0;55,3;9,816666
1793;"Baagø";"no";0;0;0;55,3;9,816666
1794;"Baagø";"no";0;0;0;55,3;9,816666
1795;"Baagø";"no";0;0;0;55,3;9,816666
1796;"Baagø";"no";0;0;0;55,3;9,816666
1797;"Baagø";"no";0;0;0;55,3;9,816666
1798;"Baagø";"no";0;0;0;55,3;9,816666
1799;"Baagø";"no";0;0;0;55,3;9,816666
1800;"Baagø";"no";0;0;0;55,3;9,816666
1801;"Baagø";"no";0;0;0;55,3;9,816666
1802;"Baagø";"no";0;0;0;55,3;9,816666
1803;"Baagø";"no";0;0;0;55,3;9,816666
1804;"Baagø";"no";0;0;0;55,3;9,816666
1805;"Baagø";"no";0;0;0;55,3;9,816666
1806;"Baagø";"no";0;0;0;55,3;9,816666
1807;"Baagø";"no";0;0;0;55,3;9,816666
1808;"Baagø";"no";0;0;0;55,3;9,816666
1809;"Baagø";"no";0;0;0;55,3;9,816666
1810;"Baagø";"no";0;0;0;55,3;9,816666
1811;"Baagø";"no";0;0;0;55,3;9,816666
1812;"Baagø";"no";0;0;0;55,3;9,816666
1813;"Baagø";"no";0;0;0;55,3;9,816666
1814;"Baagø";"no";0;0;0;55,3;9,816666
1815;"Baagø";"no";0;0;0;55,3;9,816666
1816;"Baagø";"no";0;0;0;55,3;9,816666
1817;"Baagø";"no";0;0;0;55,3;9,816666
1818;"Baagø";"no";0;0;0;55,3;9,816666
1819;"Baagø";"no";0;0;0;55,3;9,816666
1820;"Baagø";"no";0;0;0;55,3;9,816666
1821;"Baagø";"no";0;0;0;55,3;9,816666
1822;"Baagø";"no";0;0;0;55,3;9,816666
1823;"Baagø";"no";0;0;0;55,3;9,816666
1824;"Baagø";"no";0;0;0;55,3;9,816666
1825;"Baagø";"no";0;0;0;55,3;9,816666
1826;"Baagø";"no";0;0;0;55,3;9,816666
1827;"Baagø";"no";0;0;0;55,3;9,816666
1828;"Baagø";"no";0;0;0;55,3;9,816666
1829;"Baagø";"no";0;0;0;55,3;9,816666
1830;"Baagø";"no";0;0;0;55,3;9,816666
1831;"Baagø";"no";0;0;0;55,3;9,816666
1832;"Baagø";"no";0;0;0;55,3;9,816666
1833;"Baagø";"no";0;0;0;55,3;9,816666
1834;"Baagø";"no";0;0;0;55,3;9,816666
1835;"Baagø";"no";0;0;0;55,3;9,816666
1836;"Baagø";"no";0;0;0;55,3;9,816666
1837;"Baagø";"no";0;0;0;55,3;9,816666
1838;"Baagø";"no";0;0;0;55,3;9,816666
1839;"Baagø";"no";0;0;0;55,3;9,816666
1840;"Baagø";"no";0;0;0;55,3;9,816666
1841;"Baagø";"no";0;0;0;55,3;9,816666
1842;"Baagø";"no";0;0;0;55,3;9,816666
1843;"Baagø";"no";0;0;0;55,3;9,816666
1844;"Baagø";"no";0;0;0;55,3;9,816666
1845;"Baagø";"no";0;0;0;55,3;9,816666
1846;"Baagø";"no";0;0;0;55,3;9,816666
1847;"Baagø";"no";0;0;0;55,3;9,816666
1848;"Baagø";"no";0;0;0;55,3;9,816666
1849;"Baagø";"no";0;0;0;55,3;9,816666
1850;"Baagø";"no";0;0;0;55,3;9,816666
1851;"Baagø";"no";0;0;0;55,3;9,816666
1852;"Baagø";"no";0;0;0;55,3;9,816666
1853;"Baagø";"no";0;0;0;55,3;9,816666
1854;"Baagø";"no";0;0;0;55,3;9,816666
1855;"Baagø";"no";0;0;0;55,3;9,816666
1856;"Baagø";"no";0;0;0;55,3;9,816666
1857;"Baagø";"no";0;0;0;55,3;9,816666
1634;"Aalholm";"no";0;0;0;54,665348;11,723093
1635;"Aalholm";"no";0;0;0;54,665348;11,723093
1636;"Aalholm";"no";0;0;0;54,665348;11,723093
1637;"Aalholm";"no";0;0;0;54,665348;11,723093
1638;"Aalholm";"no";0;0;0;54,665348;11,723093
1639;"Aalholm";"no";0;0;0;54,665348;11,723093
1640;"Aalholm";"no";0;0;0;54,665348;11,723093
1641;"Aalholm";"no";0;0;0;54,665348;11,723093
1642;"Aalholm";"no";0;0;0;54,665348;11,723093
1643;"Aalholm";"no";0;0;0;54,665348;11,723093
1644;"Aalholm";"no";0;0;0;54,665348;11,723093
1645;"Aalholm";"no";0;0;0;54,665348;11,723093
1646;"Aalholm";"no";0;0;0;54,665348;11,723093
1647;"Aalholm";"no";0;0;0;54,665348;11,723093
1648;"Aalholm";"no";0;0;0;54,665348;11,723093
1649;"Aalholm";"no";0;0;0;54,665348;11,723093
1650;"Aalholm";"no";0;0;0;54,665348;11,723093
1651;"Aalholm";"no";0;0;0;54,665348;11,723093
1652;"Aalholm";"no";0;0;0;54,665348;11,723093
1653;"Aalholm";"no";0;0;0;54,665348;11,723093
1654;"Aalholm";"no";0;0;0;54,665348;11,723093
1655;"Aalholm";"no";0;0;0;54,665348;11,723093
1656;"Aalholm";"no";0;0;0;54,665348;11,723093
1657;"Aalholm";"no";0;0;0;54,665348;11,723093
1658;"Aalholm";"no";0;0;0;54,665348;11,723093
1659;"Aalholm";"no";0;0;0;54,665348;11,723093
1660;"Aalholm";"no";0;0;0;54,665348;11,723093
1661;"Aalholm";"no";0;0;0;54,665348;11,723093
1662;"Aalholm";"no";0;0;0;54,665348;11,723093
1663;"Aalholm";"no";0;0;0;54,665348;11,723093
1664;"Aalholm";"no";0;0;0;54,665348;11,723093
1665;"Aalholm";"no";0;0;0;54,665348;11,723093
1666;"Aalholm";"no";0;0;0;54,665348;11,723093
1667;"Aalholm";"no";0;0;0;54,665348;11,723093
1668;"Aalholm";"no";0;0;0;54,665348;11,723093
1669;"Aalholm";"no";0;0;0;54,665348;11,723093
1670;"Aalholm";"no";0;0;0;54,665348;11,723093
1671;"Aalholm";"no";0;1;1;54,665348;11,723093
1672;"Aalholm";"no";0;0;0;54,665348;11,723093
1673;"Aalholm";"no";0;0;0;54,665348;11,723093
1674;"Aalholm";"no";0;0;0;54,665348;11,723093
1675;"Aalholm";"no";0;0;0;54,665348;11,723093
1676;"Aalholm";"no";0;0;0;54,665348;11,723093
1677;"Aalholm";"no";0;0;0;54,665348;11,723093
1678;"Aalholm";"no";0;0;0;54,665348;11,723093
1679;"Aalholm";"no";0;0;0;54,665348;11,723093
1680;"Aalholm";"no";0;1;1;54,665348;11,723093
1681;"Aalholm";"no";0;0;0;54,665348;11,723093
1682;"Aalholm";"no";0;0;0;54,665348;11,723093
1683;"Aalholm";"no";0;0;0;54,665348;11,723093
1684;"Aalholm";"no";0;0;0;54,665348;11,723093
1685;"Aalholm";"no";0;0;0;54,665348;11,723093
1686;"Aalholm";"no";0;0;0;54,665348;11,723093
1687;"Aalholm";"no";0;0;0;54,665348;11,723093
1688;"Aalholm";"no";0;0;0;54,665348;11,723093
1689;"Aalholm";"no";0;0;0;54,665348;11,723093
1690;"Aalholm";"no";0;0;0;54,665348;11,723093
1691;"Aalholm";"no";0;0;0;54,665348;11,723093
1692;"Aalholm";"no";0;0;0;54,665348;11,723093
1693;"Aalholm";"no";0;0;0;54,665348;11,723093
1694;"Aalholm";"no";0;0;0;54,665348;11,723093
1695;"Aalholm";"no";0;0;0;54,665348;11,723093
1696;"Aalholm";"no";0;0;0;54,665348;11,723093
1697;"Aalholm";"no";0;0;0;54,665348;11,723093
1698;"Aalholm";"no";0;0;0;54,665348;11,723093
1699;"Aalholm";"no";0;0;0;54,665348;11,723093
1700;"Aalholm";"no";0;0;0;54,665348;11,723093
1701;"Aalholm";"no";0;0;0;54,665348;11,723093
1702;"Aalholm";"no";0;0;0;54,665348;11,723093
1703;"Aalholm";"no";0;0;0;54,665348;11,723093
1704;"Aalholm";"no";0;0;0;54,665348;11,723093
1705;"Aalholm";"no";0;0;0;54,665348;11,723093
1706;"Aalholm";"no";0;0;0;54,665348;11,723093
1707;"Aalholm";"no";0;0;0;54,665348;11,723093
1708;"Aalholm";"no";0;0;0;54,665348;11,723093
1709;"Aalholm";"no";0;0;0;54,665348;11,723093
1710;"Aalholm";"no";0;0;0;54,665348;11,723093
1711;"Aalholm";"no";0;0;0;54,665348;11,723093
1712;"Aalholm";"no";0;0;0;54,665348;11,723093
1713;"Aalholm";"no";0;0;0;54,665348;11,723093
1714;"Aalholm";"no";0;0;0;54,665348;11,723093
1715;"Aalholm";"no";0;0;0;54,665348;11,723093
1716;"Aalholm";"no";0;0;0;54,665348;11,723093
1717;"Aalholm";"no";0;0;0;54,665348;11,723093
1718;"Aalholm";"no";0;0;0;54,665348;11,723093
1719;"Aalholm";"no";0;0;0;54,665348;11,723093
1720;"Aalholm";"no";0;0;0;54,665348;11,723093
1721;"Aalholm";"no";0;0;0;54,665348;11,723093
1722;"Aalholm";"no";0;0;0;54,665348;11,723093
1723;"Aalholm";"no";0;0;0;54,665348;11,723093
1724;"Aalholm";"no";0;0;0;54,665348;11,723093
1725;"Aalholm";"no";0;0;0;54,665348;11,723093
1726;"Aalholm";"no";0;0;0;54,665348;11,723093
1727;"Aalholm";"no";0;0;0;54,665348;11,723093
1728;"Aalholm";"no";0;0;0;54,665348;11,723093
1729;"Aalholm";"no";0;0;0;54,665348;11,723093
1730;"Aalholm";"no";0;0;0;54,665348;11,723093
1731;"Aalholm";"no";0;0;0;54,665348;11,723093
1732;"Aalholm";"no";0;0;0;54,665348;11,723093
1733;"Aalholm";"no";0;0;0;54,665348;11,723093
1734;"Aalholm";"no";0;0;0;54,665348;11,723093
1735;"Aalholm";"no";0;0;0;54,665348;11,723093
1736;"Aalholm";"no";0;0;0;54,665348;11,723093
1737;"Aalholm";"no";0;0;0;54,665348;11,723093
1738;"Aalholm";"no";0;0;0;54,665348;11,723093
1739;"Aalholm";"no";0;0;0;54,665348;11,723093
1740;"Aalholm";"no";0;0;0;54,665348;11,723093
1741;"Aalholm";"no";0;0;0;54,665348;11,723093
1742;"Aalholm";"no";0;0;0;54,665348;11,723093
1743;"Aalholm";"no";0;0;0;54,665348;11,723093
1744;"Aalholm";"no";0;0;0;54,665348;11,723093
1745;"Aalholm";"no";0;0;0;54,665348;11,723093
1746;"Aalholm";"no";0;0;0;54,665348;11,723093
1747;"Aalholm";"no";0;0;0;54,665348;11,723093
1748;"Aalholm";"no";0;0;0;54,665348;11,723093
1749;"Aalholm";"no";0;0;0;54,665348;11,723093
1750;"Aalholm";"no";0;0;0;54,665348;11,723093
1751;"Aalholm";"no";0;0;0;54,665348;11,723093
1752;"Aalholm";"no";0;0;0;54,665348;11,723093
1753;"Aalholm";"no";0;0;0;54,665348;11,723093
1754;"Aalholm";"no";0;0;0;54,665348;11,723093
1755;"Aalholm";"no";0;0;0;54,665348;11,723093
1756;"Aalholm";"no";0;0;0;54,665348;11,723093
1757;"Aalholm";"no";0;0;0;54,665348;11,723093
1758;"Aalholm";"no";0;0;0;54,665348;11,723093
1759;"Aalholm";"no";0;0;0;54,665348;11,723093
1760;"Aalholm";"no";0;0;0;54,665348;11,723093
1761;"Aalholm";"no";0;0;0;54,665348;11,723093
1762;"Aalholm";"no";0;0;0;54,665348;11,723093
1763;"Aalholm";"no";0;0;0;54,665348;11,723093
1764;"Aalholm";"no";0;0;0;54,665348;11,723093
1765;"Aalholm";"no";0;0;0;54,665348;11,723093
1766;"Aalholm";"no";0;0;0;54,665348;11,723093
1767;"Aalholm";"no";0;0;0;54,665348;11,723093
1768;"Aalholm";"no";0;0;0;54,665348;11,723093
1769;"Aalholm";"no";0;0;0;54,665348;11,723093
1770;"Aalholm";"no";0;0;0;54,665348;11,723093
1771;"Aalholm";"no";0;0;0;54,665348;11,723093
1772;"Aalholm";"no";0;0;0;54,665348;11,723093
1773;"Aalholm";"no";0;0;0;54,665348;11,723093
1774;"Aalholm";"no";0;0;0;54,665348;11,723093
1775;"Aalholm";"no";0;0;0;54,665348;11,723093
1776;"Aalholm";"no";0;0;0;54,665348;11,723093
1777;"Aalholm";"no";0;0;0;54,665348;11,723093
1778;"Aalholm";"no";0;0;0;54,665348;11,723093
1779;"Aalholm";"no";0;0;0;54,665348;11,723093
1780;"Aalholm";"no";0;0;0;54,665348;11,723093
1781;"Aalholm";"no";0;0;0;54,665348;11,723093
1782;"Aalholm";"no";0;0;0;54,665348;11,723093
1783;"Aalholm";"no";0;0;0;54,665348;11,723093
1784;"Aalholm";"no";0;0;0;54,665348;11,723093
1785;"Aalholm";"no";0;0;0;54,665348;11,723093
1786;"Aalholm";"no";0;0;0;54,665348;11,723093
1787;"Aalholm";"no";0;0;0;54,665348;11,723093
1788;"Aalholm";"no";0;0;0;54,665348;11,723093
1789;"Aalholm";"no";0;0;0;54,665348;11,723093
1790;"Aalholm";"no";0;0;0;54,665348;11,723093
1791;"Aalholm";"no";0;0;0;54,665348;11,723093
1792;"Aalholm";"no";0;0;0;54,665348;11,723093
1793;"Aalholm";"no";0;0;0;54,665348;11,723093
1794;"Aalholm";"no";0;0;0;54,665348;11,723093
1795;"Aalholm";"no";0;0;0;54,665348;11,723093
1796;"Aalholm";"no";0;0;0;54,665348;11,723093
1797;"Aalholm";"no";0;0;0;54,665348;11,723093
1798;"Aalholm";"no";0;0;0;54,665348;11,723093
1799;"Aalholm";"no";0;0;0;54,665348;11,723093
1800;"Aalholm";"no";0;0;0;54,665348;11,723093
1801;"Aalholm";"no";0;0;0;54,665348;11,723093
1802;"Aalholm";"no";0;0;0;54,665348;11,723093
1803;"Aalholm";"no";0;0;0;54,665348;11,723093
1804;"Aalholm";"no";0;0;0;54,665348;11,723093
1805;"Aalholm";"no";0;0;0;54,665348;11,723093
1806;"Aalholm";"no";0;0;0;54,665348;11,723093
1807;"Aalholm";"no";0;0;0;54,665348;11,723093
1808;"Aalholm";"no";0;0;0;54,665348;11,723093
1809;"Aalholm";"no";0;0;0;54,665348;11,723093
1810;"Aalholm";"no";0;0;0;54,665348;11,723093
1811;"Aalholm";"no";0;0;0;54,665348;11,723093
1812;"Aalholm";"no";0;0;0;54,665348;11,723093
1813;"Aalholm";"no";0;0;0;54,665348;11,723093
1814;"Aalholm";"no";0;0;0;54,665348;11,723093
1815;"Aalholm";"no";0;0;0;54,665348;11,723093
1816;"Aalholm";"no";0;0;0;54,665348;11,723093
1817;"Aalholm";"no";0;0;0;54,665348;11,723093
1818;"Aalholm";"no";0;0;0;54,665348;11,723093
1819;"Aalholm";"no";0;0;0;54,665348;11,723093
1820;"Aalholm";"no";0;0;0;54,665348;11,723093
1821;"Aalholm";"no";0;0;0;54,665348;11,723093
1822;"Aalholm";"no";0;0;0;54,665348;11,723093
1823;"Aalholm";"no";0;0;0;54,665348;11,723093
1824;"Aalholm";"no";0;0;0;54,665348;11,723093
1825;"Aalholm";"no";0;0;0;54,665348;11,723093
1826;"Aalholm";"no";0;0;0;54,665348;11,723093
1827;"Aalholm";"no";0;0;0;54,665348;11,723093
1828;"Aalholm";"no";0;0;0;54,665348;11,723093
1829;"Aalholm";"no";0;0;0;54,665348;11,723093
1830;"Aalholm";"no";0;0;0;54,665348;11,723093
1831;"Aalholm";"no";0;0;0;54,665348;11,723093
1832;"Aalholm";"no";0;0;0;54,665348;11,723093
1833;"Aalholm";"no";0;0;0;54,665348;11,723093
1834;"Aalholm";"no";0;0;0;54,665348;11,723093
1835;"Aalholm";"no";0;0;0;54,665348;11,723093
1836;"Aalholm";"no";0;0;0;54,665348;11,723093
1837;"Aalholm";"no";0;0;0;54,665348;11,723093
1838;"Aalholm";"no";0;0;0;54,665348;11,723093
1839;"Aalholm";"no";0;0;0;54,665348;11,723093
1840;"Aalholm";"no";0;0;0;54,665348;11,723093
1841;"Aalholm";"no";0;0;0;54,665348;11,723093
1842;"Aalholm";"no";0;0;0;54,665348;11,723093
1843;"Aalholm";"no";0;0;0;54,665348;11,723093
1844;"Aalholm";"no";0;0;0;54,665348;11,723093
1845;"Aalholm";"no";0;0;0;54,665348;11,723093
1846;"Aalholm";"no";0;0;0;54,665348;11,723093
1847;"Aalholm";"no";0;0;0;54,665348;11,723093
1848;"Aalholm";"no";0;0;0;54,665348;11,723093
1849;"Aalholm";"no";0;0;0;54,665348;11,723093
1850;"Aalholm";"no";0;0;0;54,665348;11,723093
1851;"Aalholm";"no";0;0;0;54,665348;11,723093
1852;"Aalholm";"no";0;0;0;54,665348;11,723093
1853;"Aalholm";"no";0;0;0;54,665348;11,723093
1854;"Aalholm";"no";0;0;0;54,665348;11,723093
1855;"Aalholm";"no";0;0;0;54,665348;11,723093
1856;"Aalholm";"no";0;0;0;54,665348;11,723093
1857;"Aalholm";"no";0;0;0;54,665348;11,723093
1634;"Grevenstein";"no";0;0;0;54,9162;9,5844
1635;"Grevenstein";"no";0;0;0;54,9162;9,5844
1636;"Grevenstein";"no";0;0;0;54,9162;9,5844
1637;"Grevenstein";"no";0;0;0;54,9162;9,5844
1638;"Grevenstein";"no";0;0;0;54,9162;9,5844
1639;"Grevenstein";"no";0;0;0;54,9162;9,5844
1640;"Grevenstein";"no";0;0;0;54,9162;9,5844
1641;"Grevenstein";"no";0;0;0;54,9162;9,5844
1642;"Grevenstein";"no";0;0;0;54,9162;9,5844
1643;"Grevenstein";"no";0;0;0;54,9162;9,5844
1644;"Grevenstein";"no";0;0;0;54,9162;9,5844
1645;"Grevenstein";"no";0;0;0;54,9162;9,5844
1646;"Grevenstein";"no";0;0;0;54,9162;9,5844
1647;"Grevenstein";"no";0;0;0;54,9162;9,5844
1648;"Grevenstein";"no";0;0;0;54,9162;9,5844
1649;"Grevenstein";"no";0;0;0;54,9162;9,5844
1650;"Grevenstein";"no";0;0;0;54,9162;9,5844
1651;"Grevenstein";"no";0;0;0;54,9162;9,5844
1652;"Grevenstein";"no";0;0;0;54,9162;9,5844
1653;"Grevenstein";"no";0;0;0;54,9162;9,5844
1654;"Grevenstein";"no";0;0;0;54,9162;9,5844
1655;"Grevenstein";"no";0;0;0;54,9162;9,5844
1656;"Grevenstein";"no";0;0;0;54,9162;9,5844
1657;"Grevenstein";"no";0;0;0;54,9162;9,5844
1658;"Grevenstein";"no";0;0;0;54,9162;9,5844
1659;"Grevenstein";"no";0;0;0;54,9162;9,5844
1660;"Grevenstein";"no";0;0;0;54,9162;9,5844
1661;"Grevenstein";"no";0;0;0;54,9162;9,5844
1662;"Grevenstein";"no";0;0;0;54,9162;9,5844
1663;"Grevenstein";"no";0;0;0;54,9162;9,5844
1664;"Grevenstein";"no";0;0;0;54,9162;9,5844
1665;"Grevenstein";"no";0;0;0;54,9162;9,5844
1666;"Grevenstein";"no";0;0;0;54,9162;9,5844
1667;"Grevenstein";"no";0;0;0;54,9162;9,5844
1668;"Grevenstein";"no";0;0;0;54,9162;9,5844
1669;"Grevenstein";"no";0;0;0;54,9162;9,5844
1670;"Grevenstein";"no";0;0;0;54,9162;9,5844
1671;"Grevenstein";"no";0;0;0;54,9162;9,5844
1672;"Grevenstein";"no";0;0;0;54,9162;9,5844
1673;"Grevenstein";"no";0;0;0;54,9162;9,5844
1674;"Grevenstein";"no";0;0;0;54,9162;9,5844
1675;"Grevenstein";"no";0;0;0;54,9162;9,5844
1676;"Grevenstein";"no";0;0;0;54,9162;9,5844
1677;"Grevenstein";"no";0;0;0;54,9162;9,5844
1678;"Grevenstein";"no";0;0;0;54,9162;9,5844
1679;"Grevenstein";"no";0;0;0;54,9162;9,5844
1680;"Grevenstein";"no";0;0;0;54,9162;9,5844
1681;"Grevenstein";"no";0;1;1;54,9162;9,5844
1682;"Grevenstein";"no";0;0;0;54,9162;9,5844
1683;"Grevenstein";"no";0;0;0;54,9162;9,5844
1684;"Grevenstein";"no";0;0;0;54,9162;9,5844
1685;"Grevenstein";"no";0;0;0;54,9162;9,5844
1686;"Grevenstein";"no";0;0;0;54,9162;9,5844
1687;"Grevenstein";"no";0;0;0;54,9162;9,5844
1688;"Grevenstein";"no";0;0;0;54,9162;9,5844
1689;"Grevenstein";"no";0;0;0;54,9162;9,5844
1690;"Grevenstein";"no";0;0;0;54,9162;9,5844
1691;"Grevenstein";"no";0;0;0;54,9162;9,5844
1692;"Grevenstein";"no";0;0;0;54,9162;9,5844
1693;"Grevenstein";"no";0;0;0;54,9162;9,5844
1694;"Grevenstein";"no";0;0;0;54,9162;9,5844
1695;"Grevenstein";"no";0;0;0;54,9162;9,5844
1696;"Grevenstein";"no";0;0;0;54,9162;9,5844
1697;"Grevenstein";"no";0;0;0;54,9162;9,5844
1698;"Grevenstein";"no";0;0;0;54,9162;9,5844
1699;"Grevenstein";"no";0;0;0;54,9162;9,5844
1700;"Grevenstein";"no";0;0;0;54,9162;9,5844
1701;"Grevenstein";"no";0;0;0;54,9162;9,5844
1702;"Grevenstein";"no";0;0;0;54,9162;9,5844
1703;"Grevenstein";"no";0;0;0;54,9162;9,5844
1704;"Grevenstein";"no";0;0;0;54,9162;9,5844
1705;"Grevenstein";"no";0;0;0;54,9162;9,5844
1706;"Grevenstein";"no";0;0;0;54,9162;9,5844
1707;"Grevenstein";"no";0;0;0;54,9162;9,5844
1708;"Grevenstein";"no";0;0;0;54,9162;9,5844
1709;"Grevenstein";"no";0;0;0;54,9162;9,5844
1710;"Grevenstein";"no";0;0;0;54,9162;9,5844
1711;"Grevenstein";"no";0;0;0;54,9162;9,5844
1712;"Grevenstein";"no";0;0;0;54,9162;9,5844
1713;"Grevenstein";"no";0;0;0;54,9162;9,5844
1714;"Grevenstein";"no";0;0;0;54,9162;9,5844
1715;"Grevenstein";"no";0;0;0;54,9162;9,5844
1716;"Grevenstein";"no";0;0;0;54,9162;9,5844
1717;"Grevenstein";"no";0;0;0;54,9162;9,5844
1718;"Grevenstein";"no";0;0;0;54,9162;9,5844
1719;"Grevenstein";"no";0;0;0;54,9162;9,5844
1720;"Grevenstein";"no";0;0;0;54,9162;9,5844
1721;"Grevenstein";"no";0;0;0;54,9162;9,5844
1722;"Grevenstein";"no";0;0;0;54,9162;9,5844
1723;"Grevenstein";"no";0;0;0;54,9162;9,5844
1724;"Grevenstein";"no";0;0;0;54,9162;9,5844
1725;"Grevenstein";"no";0;0;0;54,9162;9,5844
1726;"Grevenstein";"no";0;0;0;54,9162;9,5844
1727;"Grevenstein";"no";0;0;0;54,9162;9,5844
1728;"Grevenstein";"no";0;0;0;54,9162;9,5844
1729;"Grevenstein";"no";0;0;0;54,9162;9,5844
1730;"Grevenstein";"no";0;0;0;54,9162;9,5844
1731;"Grevenstein";"no";0;0;0;54,9162;9,5844
1732;"Grevenstein";"no";0;0;0;54,9162;9,5844
1733;"Grevenstein";"no";0;0;0;54,9162;9,5844
1734;"Grevenstein";"no";0;0;0;54,9162;9,5844
1735;"Grevenstein";"no";0;0;0;54,9162;9,5844
1736;"Grevenstein";"no";0;0;0;54,9162;9,5844
1737;"Grevenstein";"no";0;0;0;54,9162;9,5844
1738;"Grevenstein";"no";0;0;0;54,9162;9,5844
1739;"Grevenstein";"no";0;0;0;54,9162;9,5844
1740;"Grevenstein";"no";0;0;0;54,9162;9,5844
1741;"Grevenstein";"no";0;0;0;54,9162;9,5844
1742;"Grevenstein";"no";0;0;0;54,9162;9,5844
1743;"Grevenstein";"no";0;0;0;54,9162;9,5844
1744;"Grevenstein";"no";0;0;0;54,9162;9,5844
1745;"Grevenstein";"no";0;0;0;54,9162;9,5844
1746;"Grevenstein";"no";0;0;0;54,9162;9,5844
1747;"Grevenstein";"no";0;0;0;54,9162;9,5844
1748;"Grevenstein";"no";0;0;0;54,9162;9,5844
1749;"Grevenstein";"no";0;0;0;54,9162;9,5844
1750;"Grevenstein";"no";0;0;0;54,9162;9,5844
1751;"Grevenstein";"no";0;0;0;54,9162;9,5844
1752;"Grevenstein";"no";0;0;0;54,9162;9,5844
1753;"Grevenstein";"no";0;0;0;54,9162;9,5844
1754;"Grevenstein";"no";0;0;0;54,9162;9,5844
1755;"Grevenstein";"no";0;0;0;54,9162;9,5844
1756;"Grevenstein";"no";0;0;0;54,9162;9,5844
1757;"Grevenstein";"no";0;0;0;54,9162;9,5844
1758;"Grevenstein";"no";0;0;0;54,9162;9,5844
1759;"Grevenstein";"no";0;0;0;54,9162;9,5844
1760;"Grevenstein";"no";0;0;0;54,9162;9,5844
1761;"Grevenstein";"no";0;0;0;54,9162;9,5844
1762;"Grevenstein";"no";0;0;0;54,9162;9,5844
1763;"Grevenstein";"no";0;0;0;54,9162;9,5844
1764;"Grevenstein";"no";0;0;0;54,9162;9,5844
1765;"Grevenstein";"no";0;0;0;54,9162;9,5844
1766;"Grevenstein";"no";0;0;0;54,9162;9,5844
1767;"Grevenstein";"no";0;0;0;54,9162;9,5844
1768;"Grevenstein";"no";0;0;0;54,9162;9,5844
1769;"Grevenstein";"no";0;0;0;54,9162;9,5844
1770;"Grevenstein";"no";0;0;0;54,9162;9,5844
1771;"Grevenstein";"no";0;0;0;54,9162;9,5844
1772;"Grevenstein";"no";0;0;0;54,9162;9,5844
1773;"Grevenstein";"no";0;0;0;54,9162;9,5844
1774;"Grevenstein";"no";0;0;0;54,9162;9,5844
1775;"Grevenstein";"no";0;0;0;54,9162;9,5844
1776;"Grevenstein";"no";0;0;0;54,9162;9,5844
1777;"Grevenstein";"no";0;0;0;54,9162;9,5844
1778;"Grevenstein";"no";0;0;0;54,9162;9,5844
1779;"Grevenstein";"no";0;0;0;54,9162;9,5844
1780;"Grevenstein";"no";0;0;0;54,9162;9,5844
1781;"Grevenstein";"no";0;0;0;54,9162;9,5844
1782;"Grevenstein";"no";0;0;0;54,9162;9,5844
1783;"Grevenstein";"no";0;0;0;54,9162;9,5844
1784;"Grevenstein";"no";0;0;0;54,9162;9,5844
1785;"Grevenstein";"no";0;0;0;54,9162;9,5844
1786;"Grevenstein";"no";0;0;0;54,9162;9,5844
1787;"Grevenstein";"no";0;0;0;54,9162;9,5844
1788;"Grevenstein";"no";0;0;0;54,9162;9,5844
1789;"Grevenstein";"no";0;0;0;54,9162;9,5844
1790;"Grevenstein";"no";0;0;0;54,9162;9,5844
1791;"Grevenstein";"no";0;0;0;54,9162;9,5844
1792;"Grevenstein";"no";0;0;0;54,9162;9,5844
1793;"Grevenstein";"no";0;0;0;54,9162;9,5844
1794;"Grevenstein";"no";0;0;0;54,9162;9,5844
1795;"Grevenstein";"no";0;0;0;54,9162;9,5844
1796;"Grevenstein";"no";0;0;0;54,9162;9,5844
1797;"Grevenstein";"no";0;0;0;54,9162;9,5844
1798;"Grevenstein";"no";0;0;0;54,9162;9,5844
1799;"Grevenstein";"no";0;0;0;54,9162;9,5844
1800;"Grevenstein";"no";0;0;0;54,9162;9,5844
1801;"Grevenstein";"no";0;0;0;54,9162;9,5844
1802;"Grevenstein";"no";0;0;0;54,9162;9,5844
1803;"Grevenstein";"no";0;0;0;54,9162;9,5844
1804;"Grevenstein";"no";0;0;0;54,9162;9,5844
1805;"Grevenstein";"no";0;0;0;54,9162;9,5844
1806;"Grevenstein";"no";0;0;0;54,9162;9,5844
1807;"Grevenstein";"no";0;0;0;54,9162;9,5844
1808;"Grevenstein";"no";0;0;0;54,9162;9,5844
1809;"Grevenstein";"no";0;0;0;54,9162;9,5844
1810;"Grevenstein";"no";0;0;0;54,9162;9,5844
1811;"Grevenstein";"no";0;0;0;54,9162;9,5844
1812;"Grevenstein";"no";0;0;0;54,9162;9,5844
1813;"Grevenstein";"no";0;0;0;54,9162;9,5844
1814;"Grevenstein";"no";0;0;0;54,9162;9,5844
1815;"Grevenstein";"no";0;0;0;54,9162;9,5844
1816;"Grevenstein";"no";0;0;0;54,9162;9,5844
1817;"Grevenstein";"no";0;0;0;54,9162;9,5844
1818;"Grevenstein";"no";0;0;0;54,9162;9,5844
1819;"Grevenstein";"no";0;0;0;54,9162;9,5844
1820;"Grevenstein";"no";0;0;0;54,9162;9,5844
1821;"Grevenstein";"no";0;0;0;54,9162;9,5844
1822;"Grevenstein";"no";0;0;0;54,9162;9,5844
1823;"Grevenstein";"no";0;0;0;54,9162;9,5844
1824;"Grevenstein";"no";0;0;0;54,9162;9,5844
1825;"Grevenstein";"no";0;0;0;54,9162;9,5844
1826;"Grevenstein";"no";0;0;0;54,9162;9,5844
1827;"Grevenstein";"no";0;0;0;54,9162;9,5844
1828;"Grevenstein";"no";0;0;0;54,9162;9,5844
1829;"Grevenstein";"no";0;0;0;54,9162;9,5844
1830;"Grevenstein";"no";0;0;0;54,9162;9,5844
1831;"Grevenstein";"no";0;0;0;54,9162;9,5844
1832;"Grevenstein";"no";0;0;0;54,9162;9,5844
1833;"Grevenstein";"no";0;0;0;54,9162;9,5844
1834;"Grevenstein";"no";0;0;0;54,9162;9,5844
1835;"Grevenstein";"no";0;0;0;54,9162;9,5844
1836;"Grevenstein";"no";0;0;0;54,9162;9,5844
1837;"Grevenstein";"no";0;0;0;54,9162;9,5844
1838;"Grevenstein";"no";0;0;0;54,9162;9,5844
1839;"Grevenstein";"no";0;0;0;54,9162;9,5844
1840;"Grevenstein";"no";0;0;0;54,9162;9,5844
1841;"Grevenstein";"no";0;0;0;54,9162;9,5844
1842;"Grevenstein";"no";0;0;0;54,9162;9,5844
1843;"Grevenstein";"no";0;0;0;54,9162;9,5844
1844;"Grevenstein";"no";0;0;0;54,9162;9,5844
1845;"Grevenstein";"no";0;0;0;54,9162;9,5844
1846;"Grevenstein";"no";0;0;0;54,9162;9,5844
1847;"Grevenstein";"no";0;0;0;54,9162;9,5844
1848;"Grevenstein";"no";0;0;0;54,9162;9,5844
1849;"Grevenstein";"no";0;0;0;54,9162;9,5844
1850;"Grevenstein";"no";0;0;0;54,9162;9,5844
1851;"Grevenstein";"no";0;0;0;54,9162;9,5844
1852;"Grevenstein";"no";0;0;0;54,9162;9,5844
1853;"Grevenstein";"no";0;0;0;54,9162;9,5844
1854;"Grevenstein";"no";0;0;0;54,9162;9,5844
1855;"Grevenstein";"no";0;0;0;54,9162;9,5844
1856;"Grevenstein";"no";0;0;0;54,9162;9,5844
1857;"Grevenstein";"no";0;0;0;54,9162;9,5844
1634;"Halsted";"no";0;0;0;54,85;11,233333
1635;"Halsted";"no";0;0;0;54,85;11,233333
1636;"Halsted";"no";0;0;0;54,85;11,233333
1637;"Halsted";"no";0;0;0;54,85;11,233333
1638;"Halsted";"no";0;0;0;54,85;11,233333
1639;"Halsted";"no";0;0;0;54,85;11,233333
1640;"Halsted";"no";0;0;0;54,85;11,233333
1641;"Halsted";"no";0;0;0;54,85;11,233333
1642;"Halsted";"no";0;0;0;54,85;11,233333
1643;"Halsted";"no";0;0;0;54,85;11,233333
1644;"Halsted";"no";0;0;0;54,85;11,233333
1645;"Halsted";"no";0;0;0;54,85;11,233333
1646;"Halsted";"no";0;0;0;54,85;11,233333
1647;"Halsted";"no";0;0;0;54,85;11,233333
1648;"Halsted";"no";0;0;0;54,85;11,233333
1649;"Halsted";"no";0;0;0;54,85;11,233333
1650;"Halsted";"no";0;0;0;54,85;11,233333
1651;"Halsted";"no";0;0;0;54,85;11,233333
1652;"Halsted";"no";0;0;0;54,85;11,233333
1653;"Halsted";"no";0;0;0;54,85;11,233333
1654;"Halsted";"no";0;0;0;54,85;11,233333
1655;"Halsted";"no";0;0;0;54,85;11,233333
1656;"Halsted";"no";0;0;0;54,85;11,233333
1657;"Halsted";"no";0;0;0;54,85;11,233333
1658;"Halsted";"no";0;0;0;54,85;11,233333
1659;"Halsted";"no";0;0;0;54,85;11,233333
1660;"Halsted";"no";0;0;0;54,85;11,233333
1661;"Halsted";"no";0;0;0;54,85;11,233333
1662;"Halsted";"no";0;0;0;54,85;11,233333
1663;"Halsted";"no";0;0;0;54,85;11,233333
1664;"Halsted";"no";0;0;0;54,85;11,233333
1665;"Halsted";"no";0;0;0;54,85;11,233333
1666;"Halsted";"no";0;0;0;54,85;11,233333
1667;"Halsted";"no";0;0;0;54,85;11,233333
1668;"Halsted";"no";0;0;0;54,85;11,233333
1669;"Halsted";"no";0;0;0;54,85;11,233333
1670;"Halsted";"no";0;0;0;54,85;11,233333
1671;"Halsted";"no";0;0;0;54,85;11,233333
1672;"Halsted";"no";0;0;0;54,85;11,233333
1673;"Halsted";"no";0;0;0;54,85;11,233333
1674;"Halsted";"no";0;0;0;54,85;11,233333
1675;"Halsted";"no";0;0;0;54,85;11,233333
1676;"Halsted";"no";0;0;0;54,85;11,233333
1677;"Halsted";"no";0;0;0;54,85;11,233333
1678;"Halsted";"no";0;0;0;54,85;11,233333
1679;"Halsted";"no";0;0;0;54,85;11,233333
1680;"Halsted";"no";0;0;0;54,85;11,233333
1681;"Halsted";"no";0;0;0;54,85;11,233333
1682;"Halsted";"no";0;0;0;54,85;11,233333
1683;"Halsted";"no";0;0;0;54,85;11,233333
1684;"Halsted";"no";0;0;0;54,85;11,233333
1685;"Halsted";"no";0;0;0;54,85;11,233333
1686;"Halsted";"no";0;0;0;54,85;11,233333
1687;"Halsted";"no";0;0;0;54,85;11,233333
1688;"Halsted";"no";0;0;0;54,85;11,233333
1689;"Halsted";"no";0;0;0;54,85;11,233333
1690;"Halsted";"no";0;0;0;54,85;11,233333
1691;"Halsted";"no";0;0;0;54,85;11,233333
1692;"Halsted";"no";0;0;0;54,85;11,233333
1693;"Halsted";"no";0;0;0;54,85;11,233333
1694;"Halsted";"no";0;0;0;54,85;11,233333
1695;"Halsted";"no";0;1;1;54,85;11,233333
1696;"Halsted";"no";0;0;0;54,85;11,233333
1697;"Halsted";"no";0;0;0;54,85;11,233333
1698;"Halsted";"no";0;0;0;54,85;11,233333
1699;"Halsted";"no";0;0;0;54,85;11,233333
1700;"Halsted";"no";0;0;0;54,85;11,233333
1701;"Halsted";"no";0;0;0;54,85;11,233333
1702;"Halsted";"no";0;0;0;54,85;11,233333
1703;"Halsted";"no";0;0;0;54,85;11,233333
1704;"Halsted";"no";0;0;0;54,85;11,233333
1705;"Halsted";"no";0;0;0;54,85;11,233333
1706;"Halsted";"no";0;0;0;54,85;11,233333
1707;"Halsted";"no";0;0;0;54,85;11,233333
1708;"Halsted";"no";0;0;0;54,85;11,233333
1709;"Halsted";"no";0;0;0;54,85;11,233333
1710;"Halsted";"no";0;0;0;54,85;11,233333
1711;"Halsted";"no";0;0;0;54,85;11,233333
1712;"Halsted";"no";0;0;0;54,85;11,233333
1713;"Halsted";"no";0;0;0;54,85;11,233333
1714;"Halsted";"no";0;0;0;54,85;11,233333
1715;"Halsted";"no";0;0;0;54,85;11,233333
1716;"Halsted";"no";0;0;0;54,85;11,233333
1717;"Halsted";"no";0;0;0;54,85;11,233333
1718;"Halsted";"no";0;0;0;54,85;11,233333
1719;"Halsted";"no";0;0;0;54,85;11,233333
1720;"Halsted";"no";0;0;0;54,85;11,233333
1721;"Halsted";"no";0;0;0;54,85;11,233333
1722;"Halsted";"no";0;0;0;54,85;11,233333
1723;"Halsted";"no";0;0;0;54,85;11,233333
1724;"Halsted";"no";0;0;0;54,85;11,233333
1725;"Halsted";"no";0;0;0;54,85;11,233333
1726;"Halsted";"no";0;0;0;54,85;11,233333
1727;"Halsted";"no";0;0;0;54,85;11,233333
1728;"Halsted";"no";0;0;0;54,85;11,233333
1729;"Halsted";"no";0;0;0;54,85;11,233333
1730;"Halsted";"no";0;0;0;54,85;11,233333
1731;"Halsted";"no";0;0;0;54,85;11,233333
1732;"Halsted";"no";0;0;0;54,85;11,233333
1733;"Halsted";"no";0;0;0;54,85;11,233333
1734;"Halsted";"no";0;0;0;54,85;11,233333
1735;"Halsted";"no";0;0;0;54,85;11,233333
1736;"Halsted";"no";0;0;0;54,85;11,233333
1737;"Halsted";"no";0;0;0;54,85;11,233333
1738;"Halsted";"no";0;0;0;54,85;11,233333
1739;"Halsted";"no";0;0;0;54,85;11,233333
1740;"Halsted";"no";0;0;0;54,85;11,233333
1741;"Halsted";"no";0;0;0;54,85;11,233333
1742;"Halsted";"no";0;0;0;54,85;11,233333
1743;"Halsted";"no";0;0;0;54,85;11,233333
1744;"Halsted";"no";0;0;0;54,85;11,233333
1745;"Halsted";"no";0;0;0;54,85;11,233333
1746;"Halsted";"no";0;0;0;54,85;11,233333
1747;"Halsted";"no";0;0;0;54,85;11,233333
1748;"Halsted";"no";0;0;0;54,85;11,233333
1749;"Halsted";"no";0;0;0;54,85;11,233333
1750;"Halsted";"no";0;0;0;54,85;11,233333
1751;"Halsted";"no";0;0;0;54,85;11,233333
1752;"Halsted";"no";0;0;0;54,85;11,233333
1753;"Halsted";"no";0;0;0;54,85;11,233333
1754;"Halsted";"no";0;0;0;54,85;11,233333
1755;"Halsted";"no";0;0;0;54,85;11,233333
1756;"Halsted";"no";0;0;0;54,85;11,233333
1757;"Halsted";"no";0;0;0;54,85;11,233333
1758;"Halsted";"no";0;0;0;54,85;11,233333
1759;"Halsted";"no";0;0;0;54,85;11,233333
1760;"Halsted";"no";0;0;0;54,85;11,233333
1761;"Halsted";"no";0;0;0;54,85;11,233333
1762;"Halsted";"no";0;0;0;54,85;11,233333
1763;"Halsted";"no";0;0;0;54,85;11,233333
1764;"Halsted";"no";0;0;0;54,85;11,233333
1765;"Halsted";"no";0;0;0;54,85;11,233333
1766;"Halsted";"no";0;0;0;54,85;11,233333
1767;"Halsted";"no";0;0;0;54,85;11,233333
1768;"Halsted";"no";0;0;0;54,85;11,233333
1769;"Halsted";"no";0;0;0;54,85;11,233333
1770;"Halsted";"no";0;0;0;54,85;11,233333
1771;"Halsted";"no";0;0;0;54,85;11,233333
1772;"Halsted";"no";0;0;0;54,85;11,233333
1773;"Halsted";"no";0;0;0;54,85;11,233333
1774;"Halsted";"no";0;0;0;54,85;11,233333
1775;"Halsted";"no";0;0;0;54,85;11,233333
1776;"Halsted";"no";0;0;0;54,85;11,233333
1777;"Halsted";"no";0;0;0;54,85;11,233333
1778;"Halsted";"no";0;0;0;54,85;11,233333
1779;"Halsted";"no";0;0;0;54,85;11,233333
1780;"Halsted";"no";0;0;0;54,85;11,233333
1781;"Halsted";"no";0;0;0;54,85;11,233333
1782;"Halsted";"no";0;0;0;54,85;11,233333
1783;"Halsted";"no";0;0;0;54,85;11,233333
1784;"Halsted";"no";0;0;0;54,85;11,233333
1785;"Halsted";"no";0;0;0;54,85;11,233333
1786;"Halsted";"no";0;0;0;54,85;11,233333
1787;"Halsted";"no";0;0;0;54,85;11,233333
1788;"Halsted";"no";0;0;0;54,85;11,233333
1789;"Halsted";"no";0;0;0;54,85;11,233333
1790;"Halsted";"no";0;0;0;54,85;11,233333
1791;"Halsted";"no";0;0;0;54,85;11,233333
1792;"Halsted";"no";0;0;0;54,85;11,233333
1793;"Halsted";"no";0;0;0;54,85;11,233333
1794;"Halsted";"no";0;0;0;54,85;11,233333
1795;"Halsted";"no";0;0;0;54,85;11,233333
1796;"Halsted";"no";0;0;0;54,85;11,233333
1797;"Halsted";"no";0;0;0;54,85;11,233333
1798;"Halsted";"no";0;0;0;54,85;11,233333
1799;"Halsted";"no";0;0;0;54,85;11,233333
1800;"Halsted";"no";0;0;0;54,85;11,233333
1801;"Halsted";"no";0;0;0;54,85;11,233333
1802;"Halsted";"no";0;0;0;54,85;11,233333
1803;"Halsted";"no";0;0;0;54,85;11,233333
1804;"Halsted";"no";0;0;0;54,85;11,233333
1805;"Halsted";"no";0;0;0;54,85;11,233333
1806;"Halsted";"no";0;0;0;54,85;11,233333
1807;"Halsted";"no";0;0;0;54,85;11,233333
1808;"Halsted";"no";0;0;0;54,85;11,233333
1809;"Halsted";"no";0;0;0;54,85;11,233333
1810;"Halsted";"no";0;0;0;54,85;11,233333
1811;"Halsted";"no";0;0;0;54,85;11,233333
1812;"Halsted";"no";0;0;0;54,85;11,233333
1813;"Halsted";"no";0;0;0;54,85;11,233333
1814;"Halsted";"no";0;0;0;54,85;11,233333
1815;"Halsted";"no";0;0;0;54,85;11,233333
1816;"Halsted";"no";0;0;0;54,85;11,233333
1817;"Halsted";"no";0;0;0;54,85;11,233333
1818;"Halsted";"no";0;0;0;54,85;11,233333
1819;"Halsted";"no";0;0;0;54,85;11,233333
1820;"Halsted";"no";0;0;0;54,85;11,233333
1821;"Halsted";"no";0;0;0;54,85;11,233333
1822;"Halsted";"no";0;0;0;54,85;11,233333
1823;"Halsted";"no";0;0;0;54,85;11,233333
1824;"Halsted";"no";0;0;0;54,85;11,233333
1825;"Halsted";"no";0;0;0;54,85;11,233333
1826;"Halsted";"no";0;0;0;54,85;11,233333
1827;"Halsted";"no";0;0;0;54,85;11,233333
1828;"Halsted";"no";0;0;0;54,85;11,233333
1829;"Halsted";"no";0;0;0;54,85;11,233333
1830;"Halsted";"no";0;0;0;54,85;11,233333
1831;"Halsted";"no";0;0;0;54,85;11,233333
1832;"Halsted";"no";0;0;0;54,85;11,233333
1833;"Halsted";"no";0;0;0;54,85;11,233333
1834;"Halsted";"no";0;0;0;54,85;11,233333
1835;"Halsted";"no";0;0;0;54,85;11,233333
1836;"Halsted";"no";0;0;0;54,85;11,233333
1837;"Halsted";"no";0;0;0;54,85;11,233333
1838;"Halsted";"no";0;0;0;54,85;11,233333
1839;"Halsted";"no";0;0;0;54,85;11,233333
1840;"Halsted";"no";0;0;0;54,85;11,233333
1841;"Halsted";"no";0;0;0;54,85;11,233333
1842;"Halsted";"no";0;0;0;54,85;11,233333
1843;"Halsted";"no";0;0;0;54,85;11,233333
1844;"Halsted";"no";0;0;0;54,85;11,233333
1845;"Halsted";"no";0;0;0;54,85;11,233333
1846;"Halsted";"no";0;0;0;54,85;11,233333
1847;"Halsted";"no";0;0;0;54,85;11,233333
1848;"Halsted";"no";0;0;0;54,85;11,233333
1849;"Halsted";"no";0;0;0;54,85;11,233333
1850;"Halsted";"no";0;0;0;54,85;11,233333
1851;"Halsted";"no";0;0;0;54,85;11,233333
1852;"Halsted";"no";0;0;0;54,85;11,233333
1853;"Halsted";"no";0;0;0;54,85;11,233333
1854;"Halsted";"no";0;0;0;54,85;11,233333
1855;"Halsted";"no";0;0;0;54,85;11,233333
1856;"Halsted";"no";0;0;0;54,85;11,233333
1857;"Halsted";"no";0;0;0;54,85;11,233333
1634;"Kattegat";"no";0;0;0;57;11
1635;"Kattegat";"no";0;0;0;57;11
1636;"Kattegat";"no";0;0;0;57;11
1637;"Kattegat";"no";0;0;0;57;11
1638;"Kattegat";"no";0;0;0;57;11
1639;"Kattegat";"no";0;0;0;57;11
1640;"Kattegat";"no";0;0;0;57;11
1641;"Kattegat";"no";0;0;0;57;11
1642;"Kattegat";"no";0;0;0;57;11
1643;"Kattegat";"no";0;0;0;57;11
1644;"Kattegat";"no";0;0;0;57;11
1645;"Kattegat";"no";0;0;0;57;11
1646;"Kattegat";"no";0;0;0;57;11
1647;"Kattegat";"no";0;0;0;57;11
1648;"Kattegat";"no";0;0;0;57;11
1649;"Kattegat";"no";0;0;0;57;11
1650;"Kattegat";"no";0;0;0;57;11
1651;"Kattegat";"no";0;0;0;57;11
1652;"Kattegat";"no";0;0;0;57;11
1653;"Kattegat";"no";0;0;0;57;11
1654;"Kattegat";"no";0;0;0;57;11
1655;"Kattegat";"no";0;0;0;57;11
1656;"Kattegat";"no";0;0;0;57;11
1657;"Kattegat";"no";0;0;0;57;11
1658;"Kattegat";"no";0;0;0;57;11
1659;"Kattegat";"no";0;0;0;57;11
1660;"Kattegat";"no";0;0;0;57;11
1661;"Kattegat";"no";0;0;0;57;11
1662;"Kattegat";"no";0;0;0;57;11
1663;"Kattegat";"no";0;0;0;57;11
1664;"Kattegat";"no";0;0;0;57;11
1665;"Kattegat";"no";0;0;0;57;11
1666;"Kattegat";"no";0;0;0;57;11
1667;"Kattegat";"no";0;0;0;57;11
1668;"Kattegat";"no";0;0;0;57;11
1669;"Kattegat";"no";0;0;0;57;11
1670;"Kattegat";"no";0;0;0;57;11
1671;"Kattegat";"no";0;0;0;57;11
1672;"Kattegat";"no";0;0;0;57;11
1673;"Kattegat";"no";0;0;0;57;11
1674;"Kattegat";"no";0;0;0;57;11
1675;"Kattegat";"no";0;0;0;57;11
1676;"Kattegat";"no";0;0;0;57;11
1677;"Kattegat";"no";0;0;0;57;11
1678;"Kattegat";"no";0;0;0;57;11
1679;"Kattegat";"no";0;0;0;57;11
1680;"Kattegat";"no";0;0;0;57;11
1681;"Kattegat";"no";0;0;0;57;11
1682;"Kattegat";"no";0;0;0;57;11
1683;"Kattegat";"no";0;0;0;57;11
1684;"Kattegat";"no";0;0;0;57;11
1685;"Kattegat";"no";0;0;0;57;11
1686;"Kattegat";"no";0;0;0;57;11
1687;"Kattegat";"no";0;0;0;57;11
1688;"Kattegat";"no";0;0;0;57;11
1689;"Kattegat";"no";0;0;0;57;11
1690;"Kattegat";"no";0;0;0;57;11
1691;"Kattegat";"no";0;0;0;57;11
1692;"Kattegat";"no";0;0;0;57;11
1693;"Kattegat";"no";0;0;0;57;11
1694;"Kattegat";"no";0;0;0;57;11
1695;"Kattegat";"no";0;0;0;57;11
1696;"Kattegat";"no";0;0;0;57;11
1697;"Kattegat";"no";0;4;4;57;11
1698;"Kattegat";"no";0;0;0;57;11
1699;"Kattegat";"no";0;0;0;57;11
1700;"Kattegat";"no";0;0;0;57;11
1701;"Kattegat";"no";0;0;0;57;11
1702;"Kattegat";"no";0;0;0;57;11
1703;"Kattegat";"no";0;0;0;57;11
1704;"Kattegat";"no";0;0;0;57;11
1705;"Kattegat";"no";0;0;0;57;11
1706;"Kattegat";"no";0;0;0;57;11
1707;"Kattegat";"no";0;0;0;57;11
1708;"Kattegat";"no";0;0;0;57;11
1709;"Kattegat";"no";0;0;0;57;11
1710;"Kattegat";"no";0;0;0;57;11
1711;"Kattegat";"no";0;0;0;57;11
1712;"Kattegat";"no";0;0;0;57;11
1713;"Kattegat";"no";0;0;0;57;11
1714;"Kattegat";"no";0;0;0;57;11
1715;"Kattegat";"no";0;0;0;57;11
1716;"Kattegat";"no";0;0;0;57;11
1717;"Kattegat";"no";0;0;0;57;11
1718;"Kattegat";"no";0;0;0;57;11
1719;"Kattegat";"no";0;0;0;57;11
1720;"Kattegat";"no";0;0;0;57;11
1721;"Kattegat";"no";0;0;0;57;11
1722;"Kattegat";"no";0;0;0;57;11
1723;"Kattegat";"no";0;0;0;57;11
1724;"Kattegat";"no";0;0;0;57;11
1725;"Kattegat";"no";0;0;0;57;11
1726;"Kattegat";"no";0;0;0;57;11
1727;"Kattegat";"no";0;0;0;57;11
1728;"Kattegat";"no";0;0;0;57;11
1729;"Kattegat";"no";0;0;0;57;11
1730;"Kattegat";"no";0;0;0;57;11
1731;"Kattegat";"no";0;0;0;57;11
1732;"Kattegat";"no";0;0;0;57;11
1733;"Kattegat";"no";0;0;0;57;11
1734;"Kattegat";"no";0;0;0;57;11
1735;"Kattegat";"no";0;0;0;57;11
1736;"Kattegat";"no";0;0;0;57;11
1737;"Kattegat";"no";0;0;0;57;11
1738;"Kattegat";"no";0;0;0;57;11
1739;"Kattegat";"no";0;0;0;57;11
1740;"Kattegat";"no";0;0;0;57;11
1741;"Kattegat";"no";0;0;0;57;11
1742;"Kattegat";"no";0;0;0;57;11
1743;"Kattegat";"no";0;0;0;57;11
1744;"Kattegat";"no";0;0;0;57;11
1745;"Kattegat";"no";0;0;0;57;11
1746;"Kattegat";"no";0;0;0;57;11
1747;"Kattegat";"no";0;0;0;57;11
1748;"Kattegat";"no";0;0;0;57;11
1749;"Kattegat";"no";0;0;0;57;11
1750;"Kattegat";"no";0;0;0;57;11
1751;"Kattegat";"no";0;0;0;57;11
1752;"Kattegat";"no";0;0;0;57;11
1753;"Kattegat";"no";0;0;0;57;11
1754;"Kattegat";"no";0;0;0;57;11
1755;"Kattegat";"no";0;0;0;57;11
1756;"Kattegat";"no";0;0;0;57;11
1757;"Kattegat";"no";0;0;0;57;11
1758;"Kattegat";"no";0;0;0;57;11
1759;"Kattegat";"no";0;0;0;57;11
1760;"Kattegat";"no";0;0;0;57;11
1761;"Kattegat";"no";0;0;0;57;11
1762;"Kattegat";"no";0;0;0;57;11
1763;"Kattegat";"no";0;0;0;57;11
1764;"Kattegat";"no";0;0;0;57;11
1765;"Kattegat";"no";0;0;0;57;11
1766;"Kattegat";"no";0;0;0;57;11
1767;"Kattegat";"no";0;0;0;57;11
1768;"Kattegat";"no";0;0;0;57;11
1769;"Kattegat";"no";0;0;0;57;11
1770;"Kattegat";"no";0;0;0;57;11
1771;"Kattegat";"no";0;0;0;57;11
1772;"Kattegat";"no";0;0;0;57;11
1773;"Kattegat";"no";0;0;0;57;11
1774;"Kattegat";"no";0;0;0;57;11
1775;"Kattegat";"no";0;0;0;57;11
1776;"Kattegat";"no";0;0;0;57;11
1777;"Kattegat";"no";0;0;0;57;11
1778;"Kattegat";"no";0;0;0;57;11
1779;"Kattegat";"no";0;0;0;57;11
1780;"Kattegat";"no";0;0;0;57;11
1781;"Kattegat";"no";0;0;0;57;11
1782;"Kattegat";"no";0;0;0;57;11
1783;"Kattegat";"no";0;0;0;57;11
1784;"Kattegat";"no";0;0;0;57;11
1785;"Kattegat";"no";0;0;0;57;11
1786;"Kattegat";"no";0;0;0;57;11
1787;"Kattegat";"no";0;0;0;57;11
1788;"Kattegat";"no";0;0;0;57;11
1789;"Kattegat";"no";0;0;0;57;11
1790;"Kattegat";"no";0;0;0;57;11
1791;"Kattegat";"no";0;0;0;57;11
1792;"Kattegat";"no";0;0;0;57;11
1793;"Kattegat";"no";0;0;0;57;11
1794;"Kattegat";"no";0;0;0;57;11
1795;"Kattegat";"no";0;0;0;57;11
1796;"Kattegat";"no";0;0;0;57;11
1797;"Kattegat";"no";0;0;0;57;11
1798;"Kattegat";"no";0;0;0;57;11
1799;"Kattegat";"no";0;0;0;57;11
1800;"Kattegat";"no";0;0;0;57;11
1801;"Kattegat";"no";0;0;0;57;11
1802;"Kattegat";"no";0;0;0;57;11
1803;"Kattegat";"no";0;0;0;57;11
1804;"Kattegat";"no";0;0;0;57;11
1805;"Kattegat";"no";0;0;0;57;11
1806;"Kattegat";"no";0;0;0;57;11
1807;"Kattegat";"no";0;0;0;57;11
1808;"Kattegat";"no";0;0;0;57;11
1809;"Kattegat";"no";0;0;0;57;11
1810;"Kattegat";"no";0;0;0;57;11
1811;"Kattegat";"no";0;0;0;57;11
1812;"Kattegat";"no";0;0;0;57;11
1813;"Kattegat";"no";0;0;0;57;11
1814;"Kattegat";"no";0;0;0;57;11
1815;"Kattegat";"no";0;0;0;57;11
1816;"Kattegat";"no";0;0;0;57;11
1817;"Kattegat";"no";0;0;0;57;11
1818;"Kattegat";"no";0;0;0;57;11
1819;"Kattegat";"no";0;0;0;57;11
1820;"Kattegat";"no";0;0;0;57;11
1821;"Kattegat";"no";0;0;0;57;11
1822;"Kattegat";"no";0;0;0;57;11
1823;"Kattegat";"no";0;0;0;57;11
1824;"Kattegat";"no";0;0;0;57;11
1825;"Kattegat";"no";0;0;0;57;11
1826;"Kattegat";"no";0;0;0;57;11
1827;"Kattegat";"no";0;0;0;57;11
1828;"Kattegat";"no";0;0;0;57;11
1829;"Kattegat";"no";0;0;0;57;11
1830;"Kattegat";"no";0;0;0;57;11
1831;"Kattegat";"no";0;0;0;57;11
1832;"Kattegat";"no";0;0;0;57;11
1833;"Kattegat";"no";0;0;0;57;11
1834;"Kattegat";"no";0;0;0;57;11
1835;"Kattegat";"no";0;0;0;57;11
1836;"Kattegat";"no";0;0;0;57;11
1837;"Kattegat";"no";0;0;0;57;11
1838;"Kattegat";"no";0;0;0;57;11
1839;"Kattegat";"no";0;0;0;57;11
1840;"Kattegat";"no";0;0;0;57;11
1841;"Kattegat";"no";0;0;0;57;11
1842;"Kattegat";"no";0;0;0;57;11
1843;"Kattegat";"no";0;0;0;57;11
1844;"Kattegat";"no";0;0;0;57;11
1845;"Kattegat";"no";0;0;0;57;11
1846;"Kattegat";"no";0;0;0;57;11
1847;"Kattegat";"no";0;0;0;57;11
1848;"Kattegat";"no";0;0;0;57;11
1849;"Kattegat";"no";0;0;0;57;11
1850;"Kattegat";"no";0;0;0;57;11
1851;"Kattegat";"no";0;0;0;57;11
1852;"Kattegat";"no";0;0;0;57;11
1853;"Kattegat";"no";0;0;0;57;11
1854;"Kattegat";"no";0;0;0;57;11
1855;"Kattegat";"no";0;0;0;57;11
1856;"Kattegat";"no";0;0;0;57;11
1857;"Kattegat";"no";0;0;0;57;11
1634;"Hals";"east";0;0;0;57;10,316666
1635;"Hals";"east";0;0;0;57;10,316666
1636;"Hals";"east";0;0;0;57;10,316666
1637;"Hals";"east";0;0;0;57;10,316666
1638;"Hals";"east";0;0;0;57;10,316666
1639;"Hals";"east";0;0;0;57;10,316666
1640;"Hals";"east";0;0;0;57;10,316666
1641;"Hals";"east";0;0;0;57;10,316666
1642;"Hals";"east";0;0;0;57;10,316666
1643;"Hals";"east";0;0;0;57;10,316666
1644;"Hals";"east";0;0;0;57;10,316666
1645;"Hals";"east";0;0;0;57;10,316666
1646;"Hals";"east";0;0;0;57;10,316666
1647;"Hals";"east";0;0;0;57;10,316666
1648;"Hals";"east";0;0;0;57;10,316666
1649;"Hals";"east";0;0;0;57;10,316666
1650;"Hals";"east";0;0;0;57;10,316666
1651;"Hals";"east";0;0;0;57;10,316666
1652;"Hals";"east";0;0;0;57;10,316666
1653;"Hals";"east";0;0;0;57;10,316666
1654;"Hals";"east";0;0;0;57;10,316666
1655;"Hals";"east";0;0;0;57;10,316666
1656;"Hals";"east";0;0;0;57;10,316666
1657;"Hals";"east";0;0;0;57;10,316666
1658;"Hals";"east";0;0;0;57;10,316666
1659;"Hals";"east";0;0;0;57;10,316666
1660;"Hals";"east";0;0;0;57;10,316666
1661;"Hals";"east";0;0;0;57;10,316666
1662;"Hals";"east";0;0;0;57;10,316666
1663;"Hals";"east";0;0;0;57;10,316666
1664;"Hals";"east";0;0;0;57;10,316666
1665;"Hals";"east";0;0;0;57;10,316666
1666;"Hals";"east";0;0;0;57;10,316666
1667;"Hals";"east";0;0;0;57;10,316666
1668;"Hals";"east";0;0;0;57;10,316666
1669;"Hals";"east";0;0;0;57;10,316666
1670;"Hals";"east";0;0;0;57;10,316666
1671;"Hals";"east";0;0;0;57;10,316666
1672;"Hals";"east";0;0;0;57;10,316666
1673;"Hals";"east";0;0;0;57;10,316666
1674;"Hals";"east";0;0;0;57;10,316666
1675;"Hals";"east";0;0;0;57;10,316666
1676;"Hals";"east";0;0;0;57;10,316666
1677;"Hals";"east";0;0;0;57;10,316666
1678;"Hals";"east";0;0;0;57;10,316666
1679;"Hals";"east";0;0;0;57;10,316666
1680;"Hals";"east";0;0;0;57;10,316666
1681;"Hals";"east";0;0;0;57;10,316666
1682;"Hals";"east";0;0;0;57;10,316666
1683;"Hals";"east";0;0;0;57;10,316666
1684;"Hals";"east";0;0;0;57;10,316666
1685;"Hals";"east";0;0;0;57;10,316666
1686;"Hals";"east";0;0;0;57;10,316666
1687;"Hals";"east";0;0;0;57;10,316666
1688;"Hals";"east";0;0;0;57;10,316666
1689;"Hals";"east";0;0;0;57;10,316666
1690;"Hals";"east";0;0;0;57;10,316666
1691;"Hals";"east";0;0;0;57;10,316666
1692;"Hals";"east";0;0;0;57;10,316666
1693;"Hals";"east";0;0;0;57;10,316666
1694;"Hals";"east";0;0;0;57;10,316666
1695;"Hals";"east";0;0;0;57;10,316666
1696;"Hals";"east";0;0;0;57;10,316666
1697;"Hals";"east";0;0;0;57;10,316666
1698;"Hals";"east";0;0;0;57;10,316666
1699;"Hals";"east";0;0;0;57;10,316666
1700;"Hals";"east";0;0;0;57;10,316666
1701;"Hals";"east";0;0;0;57;10,316666
1702;"Hals";"east";0;0;0;57;10,316666
1703;"Hals";"east";0;0;0;57;10,316666
1704;"Hals";"east";0;0;0;57;10,316666
1705;"Hals";"east";0;0;0;57;10,316666
1706;"Hals";"east";0;0;0;57;10,316666
1707;"Hals";"east";0;0;0;57;10,316666
1708;"Hals";"east";0;0;0;57;10,316666
1709;"Hals";"east";0;0;0;57;10,316666
1710;"Hals";"east";0;0;0;57;10,316666
1711;"Hals";"east";0;0;0;57;10,316666
1712;"Hals";"east";0;0;0;57;10,316666
1713;"Hals";"east";0;0;0;57;10,316666
1714;"Hals";"east";0;0;0;57;10,316666
1715;"Hals";"east";0;0;0;57;10,316666
1716;"Hals";"east";0;0;0;57;10,316666
1717;"Hals";"east";0;0;0;57;10,316666
1718;"Hals";"east";0;0;0;57;10,316666
1719;"Hals";"east";0;0;0;57;10,316666
1720;"Hals";"east";0;0;0;57;10,316666
1721;"Hals";"east";0;0;0;57;10,316666
1722;"Hals";"east";0;0;0;57;10,316666
1723;"Hals";"east";0;0;0;57;10,316666
1724;"Hals";"east";0;0;0;57;10,316666
1725;"Hals";"east";0;1;1;57;10,316666
1726;"Hals";"east";0;0;0;57;10,316666
1727;"Hals";"east";0;0;0;57;10,316666
1728;"Hals";"east";0;0;0;57;10,316666
1729;"Hals";"east";0;0;0;57;10,316666
1730;"Hals";"east";0;0;0;57;10,316666
1731;"Hals";"east";0;0;0;57;10,316666
1732;"Hals";"east";0;0;0;57;10,316666
1733;"Hals";"east";0;0;0;57;10,316666
1734;"Hals";"east";0;0;0;57;10,316666
1735;"Hals";"east";0;0;0;57;10,316666
1736;"Hals";"east";0;0;0;57;10,316666
1737;"Hals";"east";0;0;0;57;10,316666
1738;"Hals";"east";0;0;0;57;10,316666
1739;"Hals";"east";0;0;0;57;10,316666
1740;"Hals";"east";0;0;0;57;10,316666
1741;"Hals";"east";0;0;0;57;10,316666
1742;"Hals";"east";0;0;0;57;10,316666
1743;"Hals";"east";0;0;0;57;10,316666
1744;"Hals";"east";0;0;0;57;10,316666
1745;"Hals";"east";0;0;0;57;10,316666
1746;"Hals";"east";0;0;0;57;10,316666
1747;"Hals";"east";0;0;0;57;10,316666
1748;"Hals";"east";0;0;0;57;10,316666
1749;"Hals";"east";0;0;0;57;10,316666
1750;"Hals";"east";0;0;0;57;10,316666
1751;"Hals";"east";0;0;0;57;10,316666
1752;"Hals";"east";0;0;0;57;10,316666
1753;"Hals";"east";0;0;0;57;10,316666
1754;"Hals";"east";0;0;0;57;10,316666
1755;"Hals";"east";0;0;0;57;10,316666
1756;"Hals";"east";0;0;0;57;10,316666
1757;"Hals";"east";0;0;0;57;10,316666
1758;"Hals";"east";0;0;0;57;10,316666
1759;"Hals";"east";0;0;0;57;10,316666
1760;"Hals";"east";0;0;0;57;10,316666
1761;"Hals";"east";0;0;0;57;10,316666
1762;"Hals";"east";0;0;0;57;10,316666
1763;"Hals";"east";0;0;0;57;10,316666
1764;"Hals";"east";0;0;0;57;10,316666
1765;"Hals";"east";0;0;0;57;10,316666
1766;"Hals";"east";0;0;0;57;10,316666
1767;"Hals";"east";0;0;0;57;10,316666
1768;"Hals";"east";0;0;0;57;10,316666
1769;"Hals";"east";0;0;0;57;10,316666
1770;"Hals";"east";0;0;0;57;10,316666
1771;"Hals";"east";0;0;0;57;10,316666
1772;"Hals";"east";0;0;0;57;10,316666
1773;"Hals";"east";0;0;0;57;10,316666
1774;"Hals";"east";0;0;0;57;10,316666
1775;"Hals";"east";0;0;0;57;10,316666
1776;"Hals";"east";0;0;0;57;10,316666
1777;"Hals";"east";0;0;0;57;10,316666
1778;"Hals";"east";0;0;0;57;10,316666
1779;"Hals";"east";0;0;0;57;10,316666
1780;"Hals";"east";0;0;0;57;10,316666
1781;"Hals";"east";0;0;0;57;10,316666
1782;"Hals";"east";0;0;0;57;10,316666
1783;"Hals";"east";0;0;0;57;10,316666
1784;"Hals";"east";0;0;0;57;10,316666
1785;"Hals";"east";0;0;0;57;10,316666
1786;"Hals";"east";0;0;0;57;10,316666
1787;"Hals";"east";0;0;0;57;10,316666
1788;"Hals";"east";0;0;0;57;10,316666
1789;"Hals";"east";0;0;0;57;10,316666
1790;"Hals";"east";0;0;0;57;10,316666
1791;"Hals";"east";0;0;0;57;10,316666
1792;"Hals";"east";0;0;0;57;10,316666
1793;"Hals";"east";0;0;0;57;10,316666
1794;"Hals";"east";0;0;0;57;10,316666
1795;"Hals";"east";0;0;0;57;10,316666
1796;"Hals";"east";0;0;0;57;10,316666
1797;"Hals";"east";0;0;0;57;10,316666
1798;"Hals";"east";0;0;0;57;10,316666
1799;"Hals";"east";0;0;0;57;10,316666
1800;"Hals";"east";0;0;0;57;10,316666
1801;"Hals";"east";0;0;0;57;10,316666
1802;"Hals";"east";0;0;0;57;10,316666
1803;"Hals";"east";0;0;0;57;10,316666
1804;"Hals";"east";0;0;0;57;10,316666
1805;"Hals";"east";0;0;0;57;10,316666
1806;"Hals";"east";0;0;0;57;10,316666
1807;"Hals";"east";0;0;0;57;10,316666
1808;"Hals";"east";0;0;0;57;10,316666
1809;"Hals";"east";0;0;0;57;10,316666
1810;"Hals";"east";0;0;0;57;10,316666
1811;"Hals";"east";0;0;0;57;10,316666
1812;"Hals";"east";0;0;0;57;10,316666
1813;"Hals";"east";0;0;0;57;10,316666
1814;"Hals";"east";0;0;0;57;10,316666
1815;"Hals";"east";0;0;0;57;10,316666
1816;"Hals";"east";0;0;0;57;10,316666
1817;"Hals";"east";0;0;0;57;10,316666
1818;"Hals";"east";0;0;0;57;10,316666
1819;"Hals";"east";0;0;0;57;10,316666
1820;"Hals";"east";0;0;0;57;10,316666
1821;"Hals";"east";0;0;0;57;10,316666
1822;"Hals";"east";0;0;0;57;10,316666
1823;"Hals";"east";0;0;0;57;10,316666
1824;"Hals";"east";0;0;0;57;10,316666
1825;"Hals";"east";0;0;0;57;10,316666
1826;"Hals";"east";0;0;0;57;10,316666
1827;"Hals";"east";0;0;0;57;10,316666
1828;"Hals";"east";0;0;0;57;10,316666
1829;"Hals";"east";0;0;0;57;10,316666
1830;"Hals";"east";0;0;0;57;10,316666
1831;"Hals";"east";0;0;0;57;10,316666
1832;"Hals";"east";0;0;0;57;10,316666
1833;"Hals";"east";0;0;0;57;10,316666
1834;"Hals";"east";0;0;0;57;10,316666
1835;"Hals";"east";0;0;0;57;10,316666
1836;"Hals";"east";0;0;0;57;10,316666
1837;"Hals";"east";0;0;0;57;10,316666
1838;"Hals";"east";0;0;0;57;10,316666
1839;"Hals";"east";0;0;0;57;10,316666
1840;"Hals";"east";0;0;0;57;10,316666
1841;"Hals";"east";0;0;0;57;10,316666
1842;"Hals";"east";0;0;0;57;10,316666
1843;"Hals";"east";0;0;0;57;10,316666
1844;"Hals";"east";0;0;0;57;10,316666
1845;"Hals";"east";0;0;0;57;10,316666
1846;"Hals";"east";0;0;0;57;10,316666
1847;"Hals";"east";0;0;0;57;10,316666
1848;"Hals";"east";0;0;0;57;10,316666
1849;"Hals";"east";0;0;0;57;10,316666
1850;"Hals";"east";0;0;0;57;10,316666
1851;"Hals";"east";0;0;0;57;10,316666
1852;"Hals";"east";0;0;0;57;10,316666
1853;"Hals";"east";0;0;0;57;10,316666
1854;"Hals";"east";0;0;0;57;10,316666
1855;"Hals";"east";0;0;0;57;10,316666
1856;"Hals";"east";0;0;0;57;10,316666
1857;"Hals";"east";0;0;0;57;10,316666
1634;"Fredensborg";"no";0;0;0;55,965474;12,384523
1635;"Fredensborg";"no";0;0;0;55,965474;12,384523
1636;"Fredensborg";"no";0;0;0;55,965474;12,384523
1637;"Fredensborg";"no";0;0;0;55,965474;12,384523
1638;"Fredensborg";"no";0;0;0;55,965474;12,384523
1639;"Fredensborg";"no";0;0;0;55,965474;12,384523
1640;"Fredensborg";"no";0;0;0;55,965474;12,384523
1641;"Fredensborg";"no";0;0;0;55,965474;12,384523
1642;"Fredensborg";"no";0;0;0;55,965474;12,384523
1643;"Fredensborg";"no";0;0;0;55,965474;12,384523
1644;"Fredensborg";"no";0;0;0;55,965474;12,384523
1645;"Fredensborg";"no";0;0;0;55,965474;12,384523
1646;"Fredensborg";"no";0;0;0;55,965474;12,384523
1647;"Fredensborg";"no";0;0;0;55,965474;12,384523
1648;"Fredensborg";"no";0;0;0;55,965474;12,384523
1649;"Fredensborg";"no";0;0;0;55,965474;12,384523
1650;"Fredensborg";"no";0;0;0;55,965474;12,384523
1651;"Fredensborg";"no";0;0;0;55,965474;12,384523
1652;"Fredensborg";"no";0;0;0;55,965474;12,384523
1653;"Fredensborg";"no";0;0;0;55,965474;12,384523
1654;"Fredensborg";"no";0;0;0;55,965474;12,384523
1655;"Fredensborg";"no";0;0;0;55,965474;12,384523
1656;"Fredensborg";"no";0;0;0;55,965474;12,384523
1657;"Fredensborg";"no";0;0;0;55,965474;12,384523
1658;"Fredensborg";"no";0;0;0;55,965474;12,384523
1659;"Fredensborg";"no";0;0;0;55,965474;12,384523
1660;"Fredensborg";"no";0;0;0;55,965474;12,384523
1661;"Fredensborg";"no";0;0;0;55,965474;12,384523
1662;"Fredensborg";"no";0;0;0;55,965474;12,384523
1663;"Fredensborg";"no";0;0;0;55,965474;12,384523
1664;"Fredensborg";"no";0;0;0;55,965474;12,384523
1665;"Fredensborg";"no";0;0;0;55,965474;12,384523
1666;"Fredensborg";"no";0;0;0;55,965474;12,384523
1667;"Fredensborg";"no";0;0;0;55,965474;12,384523
1668;"Fredensborg";"no";0;0;0;55,965474;12,384523
1669;"Fredensborg";"no";0;0;0;55,965474;12,384523
1670;"Fredensborg";"no";0;0;0;55,965474;12,384523
1671;"Fredensborg";"no";0;0;0;55,965474;12,384523
1672;"Fredensborg";"no";0;0;0;55,965474;12,384523
1673;"Fredensborg";"no";0;0;0;55,965474;12,384523
1674;"Fredensborg";"no";0;0;0;55,965474;12,384523
1675;"Fredensborg";"no";0;0;0;55,965474;12,384523
1676;"Fredensborg";"no";0;0;0;55,965474;12,384523
1677;"Fredensborg";"no";0;0;0;55,965474;12,384523
1678;"Fredensborg";"no";0;0;0;55,965474;12,384523
1679;"Fredensborg";"no";0;0;0;55,965474;12,384523
1680;"Fredensborg";"no";0;0;0;55,965474;12,384523
1681;"Fredensborg";"no";0;0;0;55,965474;12,384523
1682;"Fredensborg";"no";0;0;0;55,965474;12,384523
1683;"Fredensborg";"no";0;0;0;55,965474;12,384523
1684;"Fredensborg";"no";0;0;0;55,965474;12,384523
1685;"Fredensborg";"no";0;0;0;55,965474;12,384523
1686;"Fredensborg";"no";0;0;0;55,965474;12,384523
1687;"Fredensborg";"no";0;0;0;55,965474;12,384523
1688;"Fredensborg";"no";0;0;0;55,965474;12,384523
1689;"Fredensborg";"no";0;0;0;55,965474;12,384523
1690;"Fredensborg";"no";0;0;0;55,965474;12,384523
1691;"Fredensborg";"no";0;0;0;55,965474;12,384523
1692;"Fredensborg";"no";0;0;0;55,965474;12,384523
1693;"Fredensborg";"no";0;0;0;55,965474;12,384523
1694;"Fredensborg";"no";0;0;0;55,965474;12,384523
1695;"Fredensborg";"no";0;0;0;55,965474;12,384523
1696;"Fredensborg";"no";0;0;0;55,965474;12,384523
1697;"Fredensborg";"no";0;0;0;55,965474;12,384523
1698;"Fredensborg";"no";0;0;0;55,965474;12,384523
1699;"Fredensborg";"no";0;0;0;55,965474;12,384523
1700;"Fredensborg";"no";0;0;0;55,965474;12,384523
1701;"Fredensborg";"no";0;0;0;55,965474;12,384523
1702;"Fredensborg";"no";0;0;0;55,965474;12,384523
1703;"Fredensborg";"no";0;0;0;55,965474;12,384523
1704;"Fredensborg";"no";0;0;0;55,965474;12,384523
1705;"Fredensborg";"no";0;0;0;55,965474;12,384523
1706;"Fredensborg";"no";0;0;0;55,965474;12,384523
1707;"Fredensborg";"no";0;0;0;55,965474;12,384523
1708;"Fredensborg";"no";0;0;0;55,965474;12,384523
1709;"Fredensborg";"no";0;0;0;55,965474;12,384523
1710;"Fredensborg";"no";0;0;0;55,965474;12,384523
1711;"Fredensborg";"no";0;0;0;55,965474;12,384523
1712;"Fredensborg";"no";0;0;0;55,965474;12,384523
1713;"Fredensborg";"no";0;0;0;55,965474;12,384523
1714;"Fredensborg";"no";0;0;0;55,965474;12,384523
1715;"Fredensborg";"no";0;0;0;55,965474;12,384523
1716;"Fredensborg";"no";0;0;0;55,965474;12,384523
1717;"Fredensborg";"no";0;0;0;55,965474;12,384523
1718;"Fredensborg";"no";0;0;0;55,965474;12,384523
1719;"Fredensborg";"no";0;0;0;55,965474;12,384523
1720;"Fredensborg";"no";0;0;0;55,965474;12,384523
1721;"Fredensborg";"no";0;0;0;55,965474;12,384523
1722;"Fredensborg";"no";0;0;0;55,965474;12,384523
1723;"Fredensborg";"no";0;0;0;55,965474;12,384523
1724;"Fredensborg";"no";0;0;0;55,965474;12,384523
1725;"Fredensborg";"no";0;0;0;55,965474;12,384523
1726;"Fredensborg";"no";0;0;0;55,965474;12,384523
1727;"Fredensborg";"no";0;0;0;55,965474;12,384523
1728;"Fredensborg";"no";0;0;0;55,965474;12,384523
1729;"Fredensborg";"no";0;0;0;55,965474;12,384523
1730;"Fredensborg";"no";0;0;0;55,965474;12,384523
1731;"Fredensborg";"no";0;0;0;55,965474;12,384523
1732;"Fredensborg";"no";0;0;0;55,965474;12,384523
1733;"Fredensborg";"no";0;0;0;55,965474;12,384523
1734;"Fredensborg";"no";0;0;0;55,965474;12,384523
1735;"Fredensborg";"no";0;0;0;55,965474;12,384523
1736;"Fredensborg";"no";0;0;0;55,965474;12,384523
1737;"Fredensborg";"no";0;0;0;55,965474;12,384523
1738;"Fredensborg";"no";0;0;0;55,965474;12,384523
1739;"Fredensborg";"no";0;0;0;55,965474;12,384523
1740;"Fredensborg";"no";0;0;0;55,965474;12,384523
1741;"Fredensborg";"no";0;0;0;55,965474;12,384523
1742;"Fredensborg";"no";0;0;0;55,965474;12,384523
1743;"Fredensborg";"no";0;0;0;55,965474;12,384523
1744;"Fredensborg";"no";0;1;1;55,965474;12,384523
1745;"Fredensborg";"no";0;0;0;55,965474;12,384523
1746;"Fredensborg";"no";0;0;0;55,965474;12,384523
1747;"Fredensborg";"no";0;0;0;55,965474;12,384523
1748;"Fredensborg";"no";0;0;0;55,965474;12,384523
1749;"Fredensborg";"no";0;0;0;55,965474;12,384523
1750;"Fredensborg";"no";0;0;0;55,965474;12,384523
1751;"Fredensborg";"no";0;0;0;55,965474;12,384523
1752;"Fredensborg";"no";0;0;0;55,965474;12,384523
1753;"Fredensborg";"no";0;0;0;55,965474;12,384523
1754;"Fredensborg";"no";0;0;0;55,965474;12,384523
1755;"Fredensborg";"no";0;0;0;55,965474;12,384523
1756;"Fredensborg";"no";0;0;0;55,965474;12,384523
1757;"Fredensborg";"no";0;0;0;55,965474;12,384523
1758;"Fredensborg";"no";0;0;0;55,965474;12,384523
1759;"Fredensborg";"no";0;0;0;55,965474;12,384523
1760;"Fredensborg";"no";0;0;0;55,965474;12,384523
1761;"Fredensborg";"no";0;0;0;55,965474;12,384523
1762;"Fredensborg";"no";0;0;0;55,965474;12,384523
1763;"Fredensborg";"no";0;0;0;55,965474;12,384523
1764;"Fredensborg";"no";0;0;0;55,965474;12,384523
1765;"Fredensborg";"no";0;0;0;55,965474;12,384523
1766;"Fredensborg";"no";0;0;0;55,965474;12,384523
1767;"Fredensborg";"no";0;0;0;55,965474;12,384523
1768;"Fredensborg";"no";0;0;0;55,965474;12,384523
1769;"Fredensborg";"no";0;0;0;55,965474;12,384523
1770;"Fredensborg";"no";0;0;0;55,965474;12,384523
1771;"Fredensborg";"no";0;0;0;55,965474;12,384523
1772;"Fredensborg";"no";0;0;0;55,965474;12,384523
1773;"Fredensborg";"no";0;0;0;55,965474;12,384523
1774;"Fredensborg";"no";0;0;0;55,965474;12,384523
1775;"Fredensborg";"no";0;0;0;55,965474;12,384523
1776;"Fredensborg";"no";0;0;0;55,965474;12,384523
1777;"Fredensborg";"no";0;0;0;55,965474;12,384523
1778;"Fredensborg";"no";0;0;0;55,965474;12,384523
1779;"Fredensborg";"no";0;0;0;55,965474;12,384523
1780;"Fredensborg";"no";0;0;0;55,965474;12,384523
1781;"Fredensborg";"no";0;0;0;55,965474;12,384523
1782;"Fredensborg";"no";0;0;0;55,965474;12,384523
1783;"Fredensborg";"no";0;0;0;55,965474;12,384523
1784;"Fredensborg";"no";0;0;0;55,965474;12,384523
1785;"Fredensborg";"no";0;0;0;55,965474;12,384523
1786;"Fredensborg";"no";0;0;0;55,965474;12,384523
1787;"Fredensborg";"no";0;0;0;55,965474;12,384523
1788;"Fredensborg";"no";0;0;0;55,965474;12,384523
1789;"Fredensborg";"no";0;0;0;55,965474;12,384523
1790;"Fredensborg";"no";0;0;0;55,965474;12,384523
1791;"Fredensborg";"no";0;0;0;55,965474;12,384523
1792;"Fredensborg";"no";0;0;0;55,965474;12,384523
1793;"Fredensborg";"no";0;0;0;55,965474;12,384523
1794;"Fredensborg";"no";0;0;0;55,965474;12,384523
1795;"Fredensborg";"no";0;0;0;55,965474;12,384523
1796;"Fredensborg";"no";0;0;0;55,965474;12,384523
1797;"Fredensborg";"no";0;0;0;55,965474;12,384523
1798;"Fredensborg";"no";0;0;0;55,965474;12,384523
1799;"Fredensborg";"no";0;0;0;55,965474;12,384523
1800;"Fredensborg";"no";0;0;0;55,965474;12,384523
1801;"Fredensborg";"no";0;0;0;55,965474;12,384523
1802;"Fredensborg";"no";0;0;0;55,965474;12,384523
1803;"Fredensborg";"no";0;0;0;55,965474;12,384523
1804;"Fredensborg";"no";0;0;0;55,965474;12,384523
1805;"Fredensborg";"no";0;0;0;55,965474;12,384523
1806;"Fredensborg";"no";0;0;0;55,965474;12,384523
1807;"Fredensborg";"no";0;0;0;55,965474;12,384523
1808;"Fredensborg";"no";0;0;0;55,965474;12,384523
1809;"Fredensborg";"no";0;0;0;55,965474;12,384523
1810;"Fredensborg";"no";0;0;0;55,965474;12,384523
1811;"Fredensborg";"no";0;0;0;55,965474;12,384523
1812;"Fredensborg";"no";0;0;0;55,965474;12,384523
1813;"Fredensborg";"no";0;0;0;55,965474;12,384523
1814;"Fredensborg";"no";0;0;0;55,965474;12,384523
1815;"Fredensborg";"no";0;0;0;55,965474;12,384523
1816;"Fredensborg";"no";0;0;0;55,965474;12,384523
1817;"Fredensborg";"no";0;0;0;55,965474;12,384523
1818;"Fredensborg";"no";0;0;0;55,965474;12,384523
1819;"Fredensborg";"no";0;0;0;55,965474;12,384523
1820;"Fredensborg";"no";0;0;0;55,965474;12,384523
1821;"Fredensborg";"no";0;0;0;55,965474;12,384523
1822;"Fredensborg";"no";0;0;0;55,965474;12,384523
1823;"Fredensborg";"no";0;0;0;55,965474;12,384523
1824;"Fredensborg";"no";0;0;0;55,965474;12,384523
1825;"Fredensborg";"no";0;0;0;55,965474;12,384523
1826;"Fredensborg";"no";0;0;0;55,965474;12,384523
1827;"Fredensborg";"no";0;0;0;55,965474;12,384523
1828;"Fredensborg";"no";0;0;0;55,965474;12,384523
1829;"Fredensborg";"no";0;0;0;55,965474;12,384523
1830;"Fredensborg";"no";0;0;0;55,965474;12,384523
1831;"Fredensborg";"no";0;0;0;55,965474;12,384523
1832;"Fredensborg";"no";0;0;0;55,965474;12,384523
1833;"Fredensborg";"no";0;0;0;55,965474;12,384523
1834;"Fredensborg";"no";0;0;0;55,965474;12,384523
1835;"Fredensborg";"no";0;0;0;55,965474;12,384523
1836;"Fredensborg";"no";0;0;0;55,965474;12,384523
1837;"Fredensborg";"no";0;0;0;55,965474;12,384523
1838;"Fredensborg";"no";0;0;0;55,965474;12,384523
1839;"Fredensborg";"no";0;0;0;55,965474;12,384523
1840;"Fredensborg";"no";0;0;0;55,965474;12,384523
1841;"Fredensborg";"no";0;0;0;55,965474;12,384523
1842;"Fredensborg";"no";0;0;0;55,965474;12,384523
1843;"Fredensborg";"no";0;0;0;55,965474;12,384523
1844;"Fredensborg";"no";0;0;0;55,965474;12,384523
1845;"Fredensborg";"no";0;0;0;55,965474;12,384523
1846;"Fredensborg";"no";0;0;0;55,965474;12,384523
1847;"Fredensborg";"no";0;0;0;55,965474;12,384523
1848;"Fredensborg";"no";0;0;0;55,965474;12,384523
1849;"Fredensborg";"no";0;0;0;55,965474;12,384523
1850;"Fredensborg";"no";0;0;0;55,965474;12,384523
1851;"Fredensborg";"no";0;0;0;55,965474;12,384523
1852;"Fredensborg";"no";0;0;0;55,965474;12,384523
1853;"Fredensborg";"no";0;0;0;55,965474;12,384523
1854;"Fredensborg";"no";0;0;0;55,965474;12,384523
1855;"Fredensborg";"no";0;0;0;55,965474;12,384523
1856;"Fredensborg";"no";0;0;0;55,965474;12,384523
1857;"Fredensborg";"no";0;0;0;55,965474;12,384523
1634;"Okholm";"no";0;0;0;57,066666;9,583333
1635;"Okholm";"no";0;0;0;57,066666;9,583333
1636;"Okholm";"no";0;0;0;57,066666;9,583333
1637;"Okholm";"no";0;0;0;57,066666;9,583333
1638;"Okholm";"no";0;0;0;57,066666;9,583333
1639;"Okholm";"no";0;0;0;57,066666;9,583333
1640;"Okholm";"no";0;0;0;57,066666;9,583333
1641;"Okholm";"no";0;0;0;57,066666;9,583333
1642;"Okholm";"no";0;0;0;57,066666;9,583333
1643;"Okholm";"no";0;0;0;57,066666;9,583333
1644;"Okholm";"no";0;0;0;57,066666;9,583333
1645;"Okholm";"no";0;0;0;57,066666;9,583333
1646;"Okholm";"no";0;0;0;57,066666;9,583333
1647;"Okholm";"no";0;0;0;57,066666;9,583333
1648;"Okholm";"no";0;0;0;57,066666;9,583333
1649;"Okholm";"no";0;0;0;57,066666;9,583333
1650;"Okholm";"no";0;0;0;57,066666;9,583333
1651;"Okholm";"no";0;0;0;57,066666;9,583333
1652;"Okholm";"no";0;0;0;57,066666;9,583333
1653;"Okholm";"no";0;0;0;57,066666;9,583333
1654;"Okholm";"no";0;0;0;57,066666;9,583333
1655;"Okholm";"no";0;0;0;57,066666;9,583333
1656;"Okholm";"no";0;0;0;57,066666;9,583333
1657;"Okholm";"no";0;0;0;57,066666;9,583333
1658;"Okholm";"no";0;0;0;57,066666;9,583333
1659;"Okholm";"no";0;0;0;57,066666;9,583333
1660;"Okholm";"no";0;0;0;57,066666;9,583333
1661;"Okholm";"no";0;0;0;57,066666;9,583333
1662;"Okholm";"no";0;0;0;57,066666;9,583333
1663;"Okholm";"no";0;0;0;57,066666;9,583333
1664;"Okholm";"no";0;0;0;57,066666;9,583333
1665;"Okholm";"no";0;0;0;57,066666;9,583333
1666;"Okholm";"no";0;0;0;57,066666;9,583333
1667;"Okholm";"no";0;0;0;57,066666;9,583333
1668;"Okholm";"no";0;0;0;57,066666;9,583333
1669;"Okholm";"no";0;0;0;57,066666;9,583333
1670;"Okholm";"no";0;0;0;57,066666;9,583333
1671;"Okholm";"no";0;0;0;57,066666;9,583333
1672;"Okholm";"no";0;0;0;57,066666;9,583333
1673;"Okholm";"no";0;0;0;57,066666;9,583333
1674;"Okholm";"no";0;0;0;57,066666;9,583333
1675;"Okholm";"no";0;0;0;57,066666;9,583333
1676;"Okholm";"no";0;0;0;57,066666;9,583333
1677;"Okholm";"no";0;0;0;57,066666;9,583333
1678;"Okholm";"no";0;0;0;57,066666;9,583333
1679;"Okholm";"no";0;0;0;57,066666;9,583333
1680;"Okholm";"no";0;0;0;57,066666;9,583333
1681;"Okholm";"no";0;0;0;57,066666;9,583333
1682;"Okholm";"no";0;0;0;57,066666;9,583333
1683;"Okholm";"no";0;0;0;57,066666;9,583333
1684;"Okholm";"no";0;0;0;57,066666;9,583333
1685;"Okholm";"no";0;0;0;57,066666;9,583333
1686;"Okholm";"no";0;0;0;57,066666;9,583333
1687;"Okholm";"no";0;0;0;57,066666;9,583333
1688;"Okholm";"no";0;0;0;57,066666;9,583333
1689;"Okholm";"no";0;0;0;57,066666;9,583333
1690;"Okholm";"no";0;0;0;57,066666;9,583333
1691;"Okholm";"no";0;0;0;57,066666;9,583333
1692;"Okholm";"no";0;0;0;57,066666;9,583333
1693;"Okholm";"no";0;0;0;57,066666;9,583333
1694;"Okholm";"no";0;0;0;57,066666;9,583333
1695;"Okholm";"no";0;0;0;57,066666;9,583333
1696;"Okholm";"no";0;0;0;57,066666;9,583333
1697;"Okholm";"no";0;0;0;57,066666;9,583333
1698;"Okholm";"no";0;0;0;57,066666;9,583333
1699;"Okholm";"no";0;0;0;57,066666;9,583333
1700;"Okholm";"no";0;0;0;57,066666;9,583333
1701;"Okholm";"no";0;0;0;57,066666;9,583333
1702;"Okholm";"no";0;0;0;57,066666;9,583333
1703;"Okholm";"no";0;0;0;57,066666;9,583333
1704;"Okholm";"no";0;0;0;57,066666;9,583333
1705;"Okholm";"no";0;0;0;57,066666;9,583333
1706;"Okholm";"no";0;0;0;57,066666;9,583333
1707;"Okholm";"no";0;0;0;57,066666;9,583333
1708;"Okholm";"no";0;0;0;57,066666;9,583333
1709;"Okholm";"no";0;0;0;57,066666;9,583333
1710;"Okholm";"no";0;0;0;57,066666;9,583333
1711;"Okholm";"no";0;0;0;57,066666;9,583333
1712;"Okholm";"no";0;0;0;57,066666;9,583333
1713;"Okholm";"no";0;0;0;57,066666;9,583333
1714;"Okholm";"no";0;0;0;57,066666;9,583333
1715;"Okholm";"no";0;0;0;57,066666;9,583333
1716;"Okholm";"no";0;0;0;57,066666;9,583333
1717;"Okholm";"no";0;0;0;57,066666;9,583333
1718;"Okholm";"no";0;0;0;57,066666;9,583333
1719;"Okholm";"no";0;0;0;57,066666;9,583333
1720;"Okholm";"no";0;0;0;57,066666;9,583333
1721;"Okholm";"no";0;0;0;57,066666;9,583333
1722;"Okholm";"no";0;0;0;57,066666;9,583333
1723;"Okholm";"no";0;0;0;57,066666;9,583333
1724;"Okholm";"no";0;0;0;57,066666;9,583333
1725;"Okholm";"no";0;0;0;57,066666;9,583333
1726;"Okholm";"no";0;0;0;57,066666;9,583333
1727;"Okholm";"no";0;0;0;57,066666;9,583333
1728;"Okholm";"no";0;0;0;57,066666;9,583333
1729;"Okholm";"no";0;0;0;57,066666;9,583333
1730;"Okholm";"no";0;0;0;57,066666;9,583333
1731;"Okholm";"no";0;0;0;57,066666;9,583333
1732;"Okholm";"no";0;0;0;57,066666;9,583333
1733;"Okholm";"no";0;0;0;57,066666;9,583333
1734;"Okholm";"no";0;0;0;57,066666;9,583333
1735;"Okholm";"no";0;0;0;57,066666;9,583333
1736;"Okholm";"no";0;0;0;57,066666;9,583333
1737;"Okholm";"no";0;0;0;57,066666;9,583333
1738;"Okholm";"no";0;0;0;57,066666;9,583333
1739;"Okholm";"no";0;0;0;57,066666;9,583333
1740;"Okholm";"no";0;0;0;57,066666;9,583333
1741;"Okholm";"no";0;0;0;57,066666;9,583333
1742;"Okholm";"no";0;0;0;57,066666;9,583333
1743;"Okholm";"no";0;0;0;57,066666;9,583333
1744;"Okholm";"no";0;0;0;57,066666;9,583333
1745;"Okholm";"no";0;0;0;57,066666;9,583333
1746;"Okholm";"no";0;0;0;57,066666;9,583333
1747;"Okholm";"no";0;0;0;57,066666;9,583333
1748;"Okholm";"no";0;0;0;57,066666;9,583333
1749;"Okholm";"no";0;0;0;57,066666;9,583333
1750;"Okholm";"no";0;0;0;57,066666;9,583333
1751;"Okholm";"no";0;0;0;57,066666;9,583333
1752;"Okholm";"no";0;0;0;57,066666;9,583333
1753;"Okholm";"no";0;0;0;57,066666;9,583333
1754;"Okholm";"no";0;0;0;57,066666;9,583333
1755;"Okholm";"no";0;0;0;57,066666;9,583333
1756;"Okholm";"no";0;0;0;57,066666;9,583333
1757;"Okholm";"no";0;0;0;57,066666;9,583333
1758;"Okholm";"no";0;0;0;57,066666;9,583333
1759;"Okholm";"no";0;0;0;57,066666;9,583333
1760;"Okholm";"no";0;0;0;57,066666;9,583333
1761;"Okholm";"no";0;0;0;57,066666;9,583333
1762;"Okholm";"no";0;0;0;57,066666;9,583333
1763;"Okholm";"no";0;0;0;57,066666;9,583333
1764;"Okholm";"no";0;0;0;57,066666;9,583333
1765;"Okholm";"no";0;1;1;57,066666;9,583333
1766;"Okholm";"no";0;0;0;57,066666;9,583333
1767;"Okholm";"no";0;0;0;57,066666;9,583333
1768;"Okholm";"no";0;0;0;57,066666;9,583333
1769;"Okholm";"no";0;0;0;57,066666;9,583333
1770;"Okholm";"no";0;0;0;57,066666;9,583333
1771;"Okholm";"no";0;0;0;57,066666;9,583333
1772;"Okholm";"no";0;0;0;57,066666;9,583333
1773;"Okholm";"no";0;0;0;57,066666;9,583333
1774;"Okholm";"no";0;0;0;57,066666;9,583333
1775;"Okholm";"no";0;0;0;57,066666;9,583333
1776;"Okholm";"no";0;0;0;57,066666;9,583333
1777;"Okholm";"no";0;0;0;57,066666;9,583333
1778;"Okholm";"no";0;0;0;57,066666;9,583333
1779;"Okholm";"no";0;0;0;57,066666;9,583333
1780;"Okholm";"no";0;0;0;57,066666;9,583333
1781;"Okholm";"no";0;0;0;57,066666;9,583333
1782;"Okholm";"no";0;0;0;57,066666;9,583333
1783;"Okholm";"no";0;0;0;57,066666;9,583333
1784;"Okholm";"no";0;0;0;57,066666;9,583333
1785;"Okholm";"no";0;0;0;57,066666;9,583333
1786;"Okholm";"no";0;0;0;57,066666;9,583333
1787;"Okholm";"no";0;0;0;57,066666;9,583333
1788;"Okholm";"no";0;0;0;57,066666;9,583333
1789;"Okholm";"no";0;0;0;57,066666;9,583333
1790;"Okholm";"no";0;0;0;57,066666;9,583333
1791;"Okholm";"no";0;0;0;57,066666;9,583333
1792;"Okholm";"no";0;0;0;57,066666;9,583333
1793;"Okholm";"no";0;0;0;57,066666;9,583333
1794;"Okholm";"no";0;0;0;57,066666;9,583333
1795;"Okholm";"no";0;0;0;57,066666;9,583333
1796;"Okholm";"no";0;0;0;57,066666;9,583333
1797;"Okholm";"no";0;0;0;57,066666;9,583333
1798;"Okholm";"no";0;0;0;57,066666;9,583333
1799;"Okholm";"no";0;0;0;57,066666;9,583333
1800;"Okholm";"no";0;0;0;57,066666;9,583333
1801;"Okholm";"no";0;0;0;57,066666;9,583333
1802;"Okholm";"no";0;0;0;57,066666;9,583333
1803;"Okholm";"no";0;0;0;57,066666;9,583333
1804;"Okholm";"no";0;0;0;57,066666;9,583333
1805;"Okholm";"no";0;0;0;57,066666;9,583333
1806;"Okholm";"no";0;0;0;57,066666;9,583333
1807;"Okholm";"no";0;0;0;57,066666;9,583333
1808;"Okholm";"no";0;0;0;57,066666;9,583333
1809;"Okholm";"no";0;0;0;57,066666;9,583333
1810;"Okholm";"no";0;0;0;57,066666;9,583333
1811;"Okholm";"no";0;0;0;57,066666;9,583333
1812;"Okholm";"no";0;0;0;57,066666;9,583333
1813;"Okholm";"no";0;0;0;57,066666;9,583333
1814;"Okholm";"no";0;0;0;57,066666;9,583333
1815;"Okholm";"no";0;0;0;57,066666;9,583333
1816;"Okholm";"no";0;0;0;57,066666;9,583333
1817;"Okholm";"no";0;0;0;57,066666;9,583333
1818;"Okholm";"no";0;0;0;57,066666;9,583333
1819;"Okholm";"no";0;0;0;57,066666;9,583333
1820;"Okholm";"no";0;0;0;57,066666;9,583333
1821;"Okholm";"no";0;0;0;57,066666;9,583333
1822;"Okholm";"no";0;0;0;57,066666;9,583333
1823;"Okholm";"no";0;0;0;57,066666;9,583333
1824;"Okholm";"no";0;0;0;57,066666;9,583333
1825;"Okholm";"no";0;0;0;57,066666;9,583333
1826;"Okholm";"no";0;0;0;57,066666;9,583333
1827;"Okholm";"no";0;0;0;57,066666;9,583333
1828;"Okholm";"no";0;0;0;57,066666;9,583333
1829;"Okholm";"no";0;0;0;57,066666;9,583333
1830;"Okholm";"no";0;0;0;57,066666;9,583333
1831;"Okholm";"no";0;0;0;57,066666;9,583333
1832;"Okholm";"no";0;0;0;57,066666;9,583333
1833;"Okholm";"no";0;0;0;57,066666;9,583333
1834;"Okholm";"no";0;0;0;57,066666;9,583333
1835;"Okholm";"no";0;0;0;57,066666;9,583333
1836;"Okholm";"no";0;0;0;57,066666;9,583333
1837;"Okholm";"no";0;0;0;57,066666;9,583333
1838;"Okholm";"no";0;0;0;57,066666;9,583333
1839;"Okholm";"no";0;0;0;57,066666;9,583333
1840;"Okholm";"no";0;0;0;57,066666;9,583333
1841;"Okholm";"no";0;0;0;57,066666;9,583333
1842;"Okholm";"no";0;0;0;57,066666;9,583333
1843;"Okholm";"no";0;0;0;57,066666;9,583333
1844;"Okholm";"no";0;0;0;57,066666;9,583333
1845;"Okholm";"no";0;0;0;57,066666;9,583333
1846;"Okholm";"no";0;0;0;57,066666;9,583333
1847;"Okholm";"no";0;0;0;57,066666;9,583333
1848;"Okholm";"no";0;0;0;57,066666;9,583333
1849;"Okholm";"no";0;0;0;57,066666;9,583333
1850;"Okholm";"no";0;0;0;57,066666;9,583333
1851;"Okholm";"no";0;0;0;57,066666;9,583333
1852;"Okholm";"no";0;0;0;57,066666;9,583333
1853;"Okholm";"no";0;0;0;57,066666;9,583333
1854;"Okholm";"no";0;0;0;57,066666;9,583333
1855;"Okholm";"no";0;0;0;57,066666;9,583333
1856;"Okholm";"no";0;0;0;57,066666;9,583333
1857;"Okholm";"no";0;0;0;57,066666;9,583333
1634;"Rungsted";"no";0;0;0;55,869166;12,551388
1635;"Rungsted";"no";0;0;0;55,869166;12,551388
1636;"Rungsted";"no";0;0;0;55,869166;12,551388
1637;"Rungsted";"no";0;0;0;55,869166;12,551388
1638;"Rungsted";"no";0;0;0;55,869166;12,551388
1639;"Rungsted";"no";0;0;0;55,869166;12,551388
1640;"Rungsted";"no";0;0;0;55,869166;12,551388
1641;"Rungsted";"no";0;0;0;55,869166;12,551388
1642;"Rungsted";"no";0;0;0;55,869166;12,551388
1643;"Rungsted";"no";0;0;0;55,869166;12,551388
1644;"Rungsted";"no";0;0;0;55,869166;12,551388
1645;"Rungsted";"no";0;0;0;55,869166;12,551388
1646;"Rungsted";"no";0;0;0;55,869166;12,551388
1647;"Rungsted";"no";0;0;0;55,869166;12,551388
1648;"Rungsted";"no";0;0;0;55,869166;12,551388
1649;"Rungsted";"no";0;0;0;55,869166;12,551388
1650;"Rungsted";"no";0;0;0;55,869166;12,551388
1651;"Rungsted";"no";0;0;0;55,869166;12,551388
1652;"Rungsted";"no";0;0;0;55,869166;12,551388
1653;"Rungsted";"no";0;0;0;55,869166;12,551388
1654;"Rungsted";"no";0;0;0;55,869166;12,551388
1655;"Rungsted";"no";0;0;0;55,869166;12,551388
1656;"Rungsted";"no";0;0;0;55,869166;12,551388
1657;"Rungsted";"no";0;0;0;55,869166;12,551388
1658;"Rungsted";"no";0;0;0;55,869166;12,551388
1659;"Rungsted";"no";0;0;0;55,869166;12,551388
1660;"Rungsted";"no";0;0;0;55,869166;12,551388
1661;"Rungsted";"no";0;0;0;55,869166;12,551388
1662;"Rungsted";"no";0;0;0;55,869166;12,551388
1663;"Rungsted";"no";0;0;0;55,869166;12,551388
1664;"Rungsted";"no";0;0;0;55,869166;12,551388
1665;"Rungsted";"no";0;0;0;55,869166;12,551388
1666;"Rungsted";"no";0;0;0;55,869166;12,551388
1667;"Rungsted";"no";0;0;0;55,869166;12,551388
1668;"Rungsted";"no";0;0;0;55,869166;12,551388
1669;"Rungsted";"no";0;0;0;55,869166;12,551388
1670;"Rungsted";"no";0;0;0;55,869166;12,551388
1671;"Rungsted";"no";0;0;0;55,869166;12,551388
1672;"Rungsted";"no";0;0;0;55,869166;12,551388
1673;"Rungsted";"no";0;0;0;55,869166;12,551388
1674;"Rungsted";"no";0;0;0;55,869166;12,551388
1675;"Rungsted";"no";0;0;0;55,869166;12,551388
1676;"Rungsted";"no";0;0;0;55,869166;12,551388
1677;"Rungsted";"no";0;0;0;55,869166;12,551388
1678;"Rungsted";"no";0;0;0;55,869166;12,551388
1679;"Rungsted";"no";0;0;0;55,869166;12,551388
1680;"Rungsted";"no";0;0;0;55,869166;12,551388
1681;"Rungsted";"no";0;0;0;55,869166;12,551388
1682;"Rungsted";"no";0;0;0;55,869166;12,551388
1683;"Rungsted";"no";0;0;0;55,869166;12,551388
1684;"Rungsted";"no";0;0;0;55,869166;12,551388
1685;"Rungsted";"no";0;0;0;55,869166;12,551388
1686;"Rungsted";"no";0;0;0;55,869166;12,551388
1687;"Rungsted";"no";0;0;0;55,869166;12,551388
1688;"Rungsted";"no";0;0;0;55,869166;12,551388
1689;"Rungsted";"no";0;0;0;55,869166;12,551388
1690;"Rungsted";"no";0;0;0;55,869166;12,551388
1691;"Rungsted";"no";0;0;0;55,869166;12,551388
1692;"Rungsted";"no";0;0;0;55,869166;12,551388
1693;"Rungsted";"no";0;0;0;55,869166;12,551388
1694;"Rungsted";"no";0;0;0;55,869166;12,551388
1695;"Rungsted";"no";0;0;0;55,869166;12,551388
1696;"Rungsted";"no";0;0;0;55,869166;12,551388
1697;"Rungsted";"no";0;0;0;55,869166;12,551388
1698;"Rungsted";"no";0;0;0;55,869166;12,551388
1699;"Rungsted";"no";0;0;0;55,869166;12,551388
1700;"Rungsted";"no";0;0;0;55,869166;12,551388
1701;"Rungsted";"no";0;0;0;55,869166;12,551388
1702;"Rungsted";"no";0;0;0;55,869166;12,551388
1703;"Rungsted";"no";0;0;0;55,869166;12,551388
1704;"Rungsted";"no";0;0;0;55,869166;12,551388
1705;"Rungsted";"no";0;0;0;55,869166;12,551388
1706;"Rungsted";"no";0;0;0;55,869166;12,551388
1707;"Rungsted";"no";0;0;0;55,869166;12,551388
1708;"Rungsted";"no";0;0;0;55,869166;12,551388
1709;"Rungsted";"no";0;0;0;55,869166;12,551388
1710;"Rungsted";"no";0;0;0;55,869166;12,551388
1711;"Rungsted";"no";0;0;0;55,869166;12,551388
1712;"Rungsted";"no";0;0;0;55,869166;12,551388
1713;"Rungsted";"no";0;0;0;55,869166;12,551388
1714;"Rungsted";"no";0;0;0;55,869166;12,551388
1715;"Rungsted";"no";0;0;0;55,869166;12,551388
1716;"Rungsted";"no";0;0;0;55,869166;12,551388
1717;"Rungsted";"no";0;0;0;55,869166;12,551388
1718;"Rungsted";"no";0;0;0;55,869166;12,551388
1719;"Rungsted";"no";0;0;0;55,869166;12,551388
1720;"Rungsted";"no";0;0;0;55,869166;12,551388
1721;"Rungsted";"no";0;0;0;55,869166;12,551388
1722;"Rungsted";"no";0;0;0;55,869166;12,551388
1723;"Rungsted";"no";0;0;0;55,869166;12,551388
1724;"Rungsted";"no";0;0;0;55,869166;12,551388
1725;"Rungsted";"no";0;0;0;55,869166;12,551388
1726;"Rungsted";"no";0;0;0;55,869166;12,551388
1727;"Rungsted";"no";0;0;0;55,869166;12,551388
1728;"Rungsted";"no";0;0;0;55,869166;12,551388
1729;"Rungsted";"no";0;0;0;55,869166;12,551388
1730;"Rungsted";"no";0;0;0;55,869166;12,551388
1731;"Rungsted";"no";0;0;0;55,869166;12,551388
1732;"Rungsted";"no";0;0;0;55,869166;12,551388
1733;"Rungsted";"no";0;0;0;55,869166;12,551388
1734;"Rungsted";"no";0;0;0;55,869166;12,551388
1735;"Rungsted";"no";0;0;0;55,869166;12,551388
1736;"Rungsted";"no";0;0;0;55,869166;12,551388
1737;"Rungsted";"no";0;0;0;55,869166;12,551388
1738;"Rungsted";"no";0;0;0;55,869166;12,551388
1739;"Rungsted";"no";0;0;0;55,869166;12,551388
1740;"Rungsted";"no";0;0;0;55,869166;12,551388
1741;"Rungsted";"no";0;0;0;55,869166;12,551388
1742;"Rungsted";"no";0;0;0;55,869166;12,551388
1743;"Rungsted";"no";0;0;0;55,869166;12,551388
1744;"Rungsted";"no";0;0;0;55,869166;12,551388
1745;"Rungsted";"no";0;0;0;55,869166;12,551388
1746;"Rungsted";"no";0;0;0;55,869166;12,551388
1747;"Rungsted";"no";0;0;0;55,869166;12,551388
1748;"Rungsted";"no";0;0;0;55,869166;12,551388
1749;"Rungsted";"no";0;0;0;55,869166;12,551388
1750;"Rungsted";"no";0;0;0;55,869166;12,551388
1751;"Rungsted";"no";0;0;0;55,869166;12,551388
1752;"Rungsted";"no";0;0;0;55,869166;12,551388
1753;"Rungsted";"no";0;0;0;55,869166;12,551388
1754;"Rungsted";"no";0;0;0;55,869166;12,551388
1755;"Rungsted";"no";0;0;0;55,869166;12,551388
1756;"Rungsted";"no";0;0;0;55,869166;12,551388
1757;"Rungsted";"no";0;0;0;55,869166;12,551388
1758;"Rungsted";"no";0;0;0;55,869166;12,551388
1759;"Rungsted";"no";0;0;0;55,869166;12,551388
1760;"Rungsted";"no";0;0;0;55,869166;12,551388
1761;"Rungsted";"no";0;0;0;55,869166;12,551388
1762;"Rungsted";"no";0;0;0;55,869166;12,551388
1763;"Rungsted";"no";0;0;0;55,869166;12,551388
1764;"Rungsted";"no";0;0;0;55,869166;12,551388
1765;"Rungsted";"no";0;0;0;55,869166;12,551388
1766;"Rungsted";"no";0;0;0;55,869166;12,551388
1767;"Rungsted";"no";0;0;0;55,869166;12,551388
1768;"Rungsted";"no";0;0;0;55,869166;12,551388
1769;"Rungsted";"no";0;0;0;55,869166;12,551388
1770;"Rungsted";"no";0;0;0;55,869166;12,551388
1771;"Rungsted";"no";0;0;0;55,869166;12,551388
1772;"Rungsted";"no";0;1;1;55,869166;12,551388
1773;"Rungsted";"no";0;0;0;55,869166;12,551388
1774;"Rungsted";"no";0;0;0;55,869166;12,551388
1775;"Rungsted";"no";0;0;0;55,869166;12,551388
1776;"Rungsted";"no";0;0;0;55,869166;12,551388
1777;"Rungsted";"no";0;0;0;55,869166;12,551388
1778;"Rungsted";"no";0;0;0;55,869166;12,551388
1779;"Rungsted";"no";0;0;0;55,869166;12,551388
1780;"Rungsted";"no";0;0;0;55,869166;12,551388
1781;"Rungsted";"no";0;2;2;55,869166;12,551388
1782;"Rungsted";"no";0;0;0;55,869166;12,551388
1783;"Rungsted";"no";0;0;0;55,869166;12,551388
1784;"Rungsted";"no";0;0;0;55,869166;12,551388
1785;"Rungsted";"no";0;0;0;55,869166;12,551388
1786;"Rungsted";"no";0;0;0;55,869166;12,551388
1787;"Rungsted";"no";0;0;0;55,869166;12,551388
1788;"Rungsted";"no";0;0;0;55,869166;12,551388
1789;"Rungsted";"no";0;0;0;55,869166;12,551388
1790;"Rungsted";"no";0;0;0;55,869166;12,551388
1791;"Rungsted";"no";0;0;0;55,869166;12,551388
1792;"Rungsted";"no";0;0;0;55,869166;12,551388
1793;"Rungsted";"no";0;0;0;55,869166;12,551388
1794;"Rungsted";"no";0;0;0;55,869166;12,551388
1795;"Rungsted";"no";0;0;0;55,869166;12,551388
1796;"Rungsted";"no";0;0;0;55,869166;12,551388
1797;"Rungsted";"no";0;0;0;55,869166;12,551388
1798;"Rungsted";"no";0;0;0;55,869166;12,551388
1799;"Rungsted";"no";0;0;0;55,869166;12,551388
1800;"Rungsted";"no";0;0;0;55,869166;12,551388
1801;"Rungsted";"no";0;1;1;55,869166;12,551388
1802;"Rungsted";"no";0;0;0;55,869166;12,551388
1803;"Rungsted";"no";0;0;0;55,869166;12,551388
1804;"Rungsted";"no";0;0;0;55,869166;12,551388
1805;"Rungsted";"no";0;0;0;55,869166;12,551388
1806;"Rungsted";"no";0;0;0;55,869166;12,551388
1807;"Rungsted";"no";0;0;0;55,869166;12,551388
1808;"Rungsted";"no";0;0;0;55,869166;12,551388
1809;"Rungsted";"no";0;0;0;55,869166;12,551388
1810;"Rungsted";"no";0;0;0;55,869166;12,551388
1811;"Rungsted";"no";0;0;0;55,869166;12,551388
1812;"Rungsted";"no";0;0;0;55,869166;12,551388
1813;"Rungsted";"no";0;0;0;55,869166;12,551388
1814;"Rungsted";"no";0;0;0;55,869166;12,551388
1815;"Rungsted";"no";0;0;0;55,869166;12,551388
1816;"Rungsted";"no";0;0;0;55,869166;12,551388
1817;"Rungsted";"no";0;0;0;55,869166;12,551388
1818;"Rungsted";"no";0;0;0;55,869166;12,551388
1819;"Rungsted";"no";0;0;0;55,869166;12,551388
1820;"Rungsted";"no";0;0;0;55,869166;12,551388
1821;"Rungsted";"no";0;0;0;55,869166;12,551388
1822;"Rungsted";"no";0;0;0;55,869166;12,551388
1823;"Rungsted";"no";0;0;0;55,869166;12,551388
1824;"Rungsted";"no";0;0;0;55,869166;12,551388
1825;"Rungsted";"no";0;0;0;55,869166;12,551388
1826;"Rungsted";"no";0;0;0;55,869166;12,551388
1827;"Rungsted";"no";0;0;0;55,869166;12,551388
1828;"Rungsted";"no";0;1;1;55,869166;12,551388
1829;"Rungsted";"no";0;0;0;55,869166;12,551388
1830;"Rungsted";"no";0;2;2;55,869166;12,551388
1831;"Rungsted";"no";0;0;0;55,869166;12,551388
1832;"Rungsted";"no";0;0;0;55,869166;12,551388
1833;"Rungsted";"no";0;0;0;55,869166;12,551388
1834;"Rungsted";"no";0;0;0;55,869166;12,551388
1835;"Rungsted";"no";0;0;0;55,869166;12,551388
1836;"Rungsted";"no";0;0;0;55,869166;12,551388
1837;"Rungsted";"no";0;0;0;55,869166;12,551388
1838;"Rungsted";"no";0;0;0;55,869166;12,551388
1839;"Rungsted";"no";0;2;2;55,869166;12,551388
1840;"Rungsted";"no";0;2;2;55,869166;12,551388
1841;"Rungsted";"no";0;0;0;55,869166;12,551388
1842;"Rungsted";"no";0;3;3;55,869166;12,551388
1843;"Rungsted";"no";0;1;1;55,869166;12,551388
1844;"Rungsted";"no";0;0;0;55,869166;12,551388
1845;"Rungsted";"no";0;1;1;55,869166;12,551388
1846;"Rungsted";"no";0;1;1;55,869166;12,551388
1847;"Rungsted";"no";0;0;0;55,869166;12,551388
1848;"Rungsted";"no";0;0;0;55,869166;12,551388
1849;"Rungsted";"no";0;0;0;55,869166;12,551388
1850;"Rungsted";"no";0;0;0;55,869166;12,551388
1851;"Rungsted";"no";0;0;0;55,869166;12,551388
1852;"Rungsted";"no";0;0;0;55,869166;12,551388
1853;"Rungsted";"no";0;0;0;55,869166;12,551388
1854;"Rungsted";"no";0;0;0;55,869166;12,551388
1855;"Rungsted";"no";0;3;3;55,869166;12,551388
1856;"Rungsted";"no";0;4;4;55,869166;12,551388
1857;"Rungsted";"no";0;0;0;55,869166;12,551388
1634;"Hastrup";"no";0;0;0;55,4413;12,1693
1635;"Hastrup";"no";0;0;0;55,4413;12,1693
1636;"Hastrup";"no";0;0;0;55,4413;12,1693
1637;"Hastrup";"no";0;0;0;55,4413;12,1693
1638;"Hastrup";"no";0;0;0;55,4413;12,1693
1639;"Hastrup";"no";0;0;0;55,4413;12,1693
1640;"Hastrup";"no";0;0;0;55,4413;12,1693
1641;"Hastrup";"no";0;0;0;55,4413;12,1693
1642;"Hastrup";"no";0;0;0;55,4413;12,1693
1643;"Hastrup";"no";0;0;0;55,4413;12,1693
1644;"Hastrup";"no";0;0;0;55,4413;12,1693
1645;"Hastrup";"no";0;0;0;55,4413;12,1693
1646;"Hastrup";"no";0;0;0;55,4413;12,1693
1647;"Hastrup";"no";0;0;0;55,4413;12,1693
1648;"Hastrup";"no";0;0;0;55,4413;12,1693
1649;"Hastrup";"no";0;0;0;55,4413;12,1693
1650;"Hastrup";"no";0;0;0;55,4413;12,1693
1651;"Hastrup";"no";0;0;0;55,4413;12,1693
1652;"Hastrup";"no";0;0;0;55,4413;12,1693
1653;"Hastrup";"no";0;0;0;55,4413;12,1693
1654;"Hastrup";"no";0;0;0;55,4413;12,1693
1655;"Hastrup";"no";0;0;0;55,4413;12,1693
1656;"Hastrup";"no";0;0;0;55,4413;12,1693
1657;"Hastrup";"no";0;0;0;55,4413;12,1693
1658;"Hastrup";"no";0;0;0;55,4413;12,1693
1659;"Hastrup";"no";0;0;0;55,4413;12,1693
1660;"Hastrup";"no";0;0;0;55,4413;12,1693
1661;"Hastrup";"no";0;0;0;55,4413;12,1693
1662;"Hastrup";"no";0;0;0;55,4413;12,1693
1663;"Hastrup";"no";0;0;0;55,4413;12,1693
1664;"Hastrup";"no";0;0;0;55,4413;12,1693
1665;"Hastrup";"no";0;0;0;55,4413;12,1693
1666;"Hastrup";"no";0;0;0;55,4413;12,1693
1667;"Hastrup";"no";0;0;0;55,4413;12,1693
1668;"Hastrup";"no";0;0;0;55,4413;12,1693
1669;"Hastrup";"no";0;0;0;55,4413;12,1693
1670;"Hastrup";"no";0;0;0;55,4413;12,1693
1671;"Hastrup";"no";0;0;0;55,4413;12,1693
1672;"Hastrup";"no";0;0;0;55,4413;12,1693
1673;"Hastrup";"no";0;0;0;55,4413;12,1693
1674;"Hastrup";"no";0;0;0;55,4413;12,1693
1675;"Hastrup";"no";0;0;0;55,4413;12,1693
1676;"Hastrup";"no";0;0;0;55,4413;12,1693
1677;"Hastrup";"no";0;0;0;55,4413;12,1693
1678;"Hastrup";"no";0;0;0;55,4413;12,1693
1679;"Hastrup";"no";0;0;0;55,4413;12,1693
1680;"Hastrup";"no";0;0;0;55,4413;12,1693
1681;"Hastrup";"no";0;0;0;55,4413;12,1693
1682;"Hastrup";"no";0;0;0;55,4413;12,1693
1683;"Hastrup";"no";0;0;0;55,4413;12,1693
1684;"Hastrup";"no";0;0;0;55,4413;12,1693
1685;"Hastrup";"no";0;0;0;55,4413;12,1693
1686;"Hastrup";"no";0;0;0;55,4413;12,1693
1687;"Hastrup";"no";0;0;0;55,4413;12,1693
1688;"Hastrup";"no";0;0;0;55,4413;12,1693
1689;"Hastrup";"no";0;0;0;55,4413;12,1693
1690;"Hastrup";"no";0;0;0;55,4413;12,1693
1691;"Hastrup";"no";0;0;0;55,4413;12,1693
1692;"Hastrup";"no";0;0;0;55,4413;12,1693
1693;"Hastrup";"no";0;0;0;55,4413;12,1693
1694;"Hastrup";"no";0;0;0;55,4413;12,1693
1695;"Hastrup";"no";0;0;0;55,4413;12,1693
1696;"Hastrup";"no";0;0;0;55,4413;12,1693
1697;"Hastrup";"no";0;0;0;55,4413;12,1693
1698;"Hastrup";"no";0;0;0;55,4413;12,1693
1699;"Hastrup";"no";0;0;0;55,4413;12,1693
1700;"Hastrup";"no";0;0;0;55,4413;12,1693
1701;"Hastrup";"no";0;0;0;55,4413;12,1693
1702;"Hastrup";"no";0;0;0;55,4413;12,1693
1703;"Hastrup";"no";0;0;0;55,4413;12,1693
1704;"Hastrup";"no";0;0;0;55,4413;12,1693
1705;"Hastrup";"no";0;0;0;55,4413;12,1693
1706;"Hastrup";"no";0;0;0;55,4413;12,1693
1707;"Hastrup";"no";0;0;0;55,4413;12,1693
1708;"Hastrup";"no";0;0;0;55,4413;12,1693
1709;"Hastrup";"no";0;0;0;55,4413;12,1693
1710;"Hastrup";"no";0;0;0;55,4413;12,1693
1711;"Hastrup";"no";0;0;0;55,4413;12,1693
1712;"Hastrup";"no";0;0;0;55,4413;12,1693
1713;"Hastrup";"no";0;0;0;55,4413;12,1693
1714;"Hastrup";"no";0;0;0;55,4413;12,1693
1715;"Hastrup";"no";0;0;0;55,4413;12,1693
1716;"Hastrup";"no";0;0;0;55,4413;12,1693
1717;"Hastrup";"no";0;0;0;55,4413;12,1693
1718;"Hastrup";"no";0;0;0;55,4413;12,1693
1719;"Hastrup";"no";0;0;0;55,4413;12,1693
1720;"Hastrup";"no";0;0;0;55,4413;12,1693
1721;"Hastrup";"no";0;0;0;55,4413;12,1693
1722;"Hastrup";"no";0;0;0;55,4413;12,1693
1723;"Hastrup";"no";0;0;0;55,4413;12,1693
1724;"Hastrup";"no";0;0;0;55,4413;12,1693
1725;"Hastrup";"no";0;0;0;55,4413;12,1693
1726;"Hastrup";"no";0;0;0;55,4413;12,1693
1727;"Hastrup";"no";0;0;0;55,4413;12,1693
1728;"Hastrup";"no";0;0;0;55,4413;12,1693
1729;"Hastrup";"no";0;0;0;55,4413;12,1693
1730;"Hastrup";"no";0;0;0;55,4413;12,1693
1731;"Hastrup";"no";0;0;0;55,4413;12,1693
1732;"Hastrup";"no";0;0;0;55,4413;12,1693
1733;"Hastrup";"no";0;0;0;55,4413;12,1693
1734;"Hastrup";"no";0;0;0;55,4413;12,1693
1735;"Hastrup";"no";0;0;0;55,4413;12,1693
1736;"Hastrup";"no";0;0;0;55,4413;12,1693
1737;"Hastrup";"no";0;0;0;55,4413;12,1693
1738;"Hastrup";"no";0;0;0;55,4413;12,1693
1739;"Hastrup";"no";0;0;0;55,4413;12,1693
1740;"Hastrup";"no";0;0;0;55,4413;12,1693
1741;"Hastrup";"no";0;0;0;55,4413;12,1693
1742;"Hastrup";"no";0;0;0;55,4413;12,1693
1743;"Hastrup";"no";0;0;0;55,4413;12,1693
1744;"Hastrup";"no";0;0;0;55,4413;12,1693
1745;"Hastrup";"no";0;0;0;55,4413;12,1693
1746;"Hastrup";"no";0;0;0;55,4413;12,1693
1747;"Hastrup";"no";0;0;0;55,4413;12,1693
1748;"Hastrup";"no";0;0;0;55,4413;12,1693
1749;"Hastrup";"no";0;0;0;55,4413;12,1693
1750;"Hastrup";"no";0;0;0;55,4413;12,1693
1751;"Hastrup";"no";0;0;0;55,4413;12,1693
1752;"Hastrup";"no";0;0;0;55,4413;12,1693
1753;"Hastrup";"no";0;0;0;55,4413;12,1693
1754;"Hastrup";"no";0;0;0;55,4413;12,1693
1755;"Hastrup";"no";0;0;0;55,4413;12,1693
1756;"Hastrup";"no";0;0;0;55,4413;12,1693
1757;"Hastrup";"no";0;0;0;55,4413;12,1693
1758;"Hastrup";"no";0;0;0;55,4413;12,1693
1759;"Hastrup";"no";0;0;0;55,4413;12,1693
1760;"Hastrup";"no";0;0;0;55,4413;12,1693
1761;"Hastrup";"no";0;0;0;55,4413;12,1693
1762;"Hastrup";"no";0;0;0;55,4413;12,1693
1763;"Hastrup";"no";0;0;0;55,4413;12,1693
1764;"Hastrup";"no";0;0;0;55,4413;12,1693
1765;"Hastrup";"no";0;0;0;55,4413;12,1693
1766;"Hastrup";"no";0;0;0;55,4413;12,1693
1767;"Hastrup";"no";0;0;0;55,4413;12,1693
1768;"Hastrup";"no";0;0;0;55,4413;12,1693
1769;"Hastrup";"no";0;0;0;55,4413;12,1693
1770;"Hastrup";"no";0;0;0;55,4413;12,1693
1771;"Hastrup";"no";0;0;0;55,4413;12,1693
1772;"Hastrup";"no";0;0;0;55,4413;12,1693
1773;"Hastrup";"no";0;0;0;55,4413;12,1693
1774;"Hastrup";"no";0;0;0;55,4413;12,1693
1775;"Hastrup";"no";0;0;0;55,4413;12,1693
1776;"Hastrup";"no";0;0;0;55,4413;12,1693
1777;"Hastrup";"no";0;0;0;55,4413;12,1693
1778;"Hastrup";"no";0;0;0;55,4413;12,1693
1779;"Hastrup";"no";0;0;0;55,4413;12,1693
1780;"Hastrup";"no";0;0;0;55,4413;12,1693
1781;"Hastrup";"no";0;0;0;55,4413;12,1693
1782;"Hastrup";"no";0;0;0;55,4413;12,1693
1783;"Hastrup";"no";0;0;0;55,4413;12,1693
1784;"Hastrup";"no";0;0;0;55,4413;12,1693
1785;"Hastrup";"no";0;0;0;55,4413;12,1693
1786;"Hastrup";"no";0;0;0;55,4413;12,1693
1787;"Hastrup";"no";0;0;0;55,4413;12,1693
1788;"Hastrup";"no";0;0;0;55,4413;12,1693
1789;"Hastrup";"no";0;0;0;55,4413;12,1693
1790;"Hastrup";"no";0;0;0;55,4413;12,1693
1791;"Hastrup";"no";0;0;0;55,4413;12,1693
1792;"Hastrup";"no";0;0;0;55,4413;12,1693
1793;"Hastrup";"no";0;0;0;55,4413;12,1693
1794;"Hastrup";"no";0;0;0;55,4413;12,1693
1795;"Hastrup";"no";0;0;0;55,4413;12,1693
1796;"Hastrup";"no";0;0;0;55,4413;12,1693
1797;"Hastrup";"no";0;0;0;55,4413;12,1693
1798;"Hastrup";"no";0;0;0;55,4413;12,1693
1799;"Hastrup";"no";0;0;0;55,4413;12,1693
1800;"Hastrup";"no";0;0;0;55,4413;12,1693
1801;"Hastrup";"no";0;0;0;55,4413;12,1693
1802;"Hastrup";"no";0;0;0;55,4413;12,1693
1803;"Hastrup";"no";0;0;0;55,4413;12,1693
1804;"Hastrup";"no";0;0;0;55,4413;12,1693
1805;"Hastrup";"no";0;0;0;55,4413;12,1693
1806;"Hastrup";"no";0;0;0;55,4413;12,1693
1807;"Hastrup";"no";0;0;0;55,4413;12,1693
1808;"Hastrup";"no";0;0;0;55,4413;12,1693
1809;"Hastrup";"no";0;0;0;55,4413;12,1693
1810;"Hastrup";"no";0;0;0;55,4413;12,1693
1811;"Hastrup";"no";0;0;0;55,4413;12,1693
1812;"Hastrup";"no";0;0;0;55,4413;12,1693
1813;"Hastrup";"no";0;0;0;55,4413;12,1693
1814;"Hastrup";"no";0;0;0;55,4413;12,1693
1815;"Hastrup";"no";0;0;0;55,4413;12,1693
1816;"Hastrup";"no";0;0;0;55,4413;12,1693
1817;"Hastrup";"no";0;0;0;55,4413;12,1693
1818;"Hastrup";"no";0;0;0;55,4413;12,1693
1819;"Hastrup";"no";0;0;0;55,4413;12,1693
1820;"Hastrup";"no";0;0;0;55,4413;12,1693
1821;"Hastrup";"no";0;0;0;55,4413;12,1693
1822;"Hastrup";"no";0;0;0;55,4413;12,1693
1823;"Hastrup";"no";0;0;0;55,4413;12,1693
1824;"Hastrup";"no";0;1;1;55,4413;12,1693
1825;"Hastrup";"no";0;0;0;55,4413;12,1693
1826;"Hastrup";"no";0;0;0;55,4413;12,1693
1827;"Hastrup";"no";0;0;0;55,4413;12,1693
1828;"Hastrup";"no";0;0;0;55,4413;12,1693
1829;"Hastrup";"no";0;0;0;55,4413;12,1693
1830;"Hastrup";"no";0;0;0;55,4413;12,1693
1831;"Hastrup";"no";0;0;0;55,4413;12,1693
1832;"Hastrup";"no";0;0;0;55,4413;12,1693
1833;"Hastrup";"no";0;0;0;55,4413;12,1693
1834;"Hastrup";"no";0;0;0;55,4413;12,1693
1835;"Hastrup";"no";0;0;0;55,4413;12,1693
1836;"Hastrup";"no";0;0;0;55,4413;12,1693
1837;"Hastrup";"no";0;0;0;55,4413;12,1693
1838;"Hastrup";"no";0;0;0;55,4413;12,1693
1839;"Hastrup";"no";0;0;0;55,4413;12,1693
1840;"Hastrup";"no";0;0;0;55,4413;12,1693
1841;"Hastrup";"no";0;0;0;55,4413;12,1693
1842;"Hastrup";"no";0;0;0;55,4413;12,1693
1843;"Hastrup";"no";0;0;0;55,4413;12,1693
1844;"Hastrup";"no";0;0;0;55,4413;12,1693
1845;"Hastrup";"no";0;0;0;55,4413;12,1693
1846;"Hastrup";"no";0;0;0;55,4413;12,1693
1847;"Hastrup";"no";0;0;0;55,4413;12,1693
1848;"Hastrup";"no";0;0;0;55,4413;12,1693
1849;"Hastrup";"no";0;0;0;55,4413;12,1693
1850;"Hastrup";"no";0;0;0;55,4413;12,1693
1851;"Hastrup";"no";0;0;0;55,4413;12,1693
1852;"Hastrup";"no";0;0;0;55,4413;12,1693
1853;"Hastrup";"no";0;0;0;55,4413;12,1693
1854;"Hastrup";"no";0;0;0;55,4413;12,1693
1855;"Hastrup";"no";0;0;0;55,4413;12,1693
1856;"Hastrup";"no";0;1;1;55,4413;12,1693
1857;"Hastrup";"no";0;0;0;55,4413;12,1693
1634;"Klitmøller";"no";0;0;0;57,040555;8,491388
1635;"Klitmøller";"no";0;0;0;57,040555;8,491388
1636;"Klitmøller";"no";0;0;0;57,040555;8,491388
1637;"Klitmøller";"no";0;0;0;57,040555;8,491388
1638;"Klitmøller";"no";0;0;0;57,040555;8,491388
1639;"Klitmøller";"no";0;0;0;57,040555;8,491388
1640;"Klitmøller";"no";0;0;0;57,040555;8,491388
1641;"Klitmøller";"no";0;0;0;57,040555;8,491388
1642;"Klitmøller";"no";0;0;0;57,040555;8,491388
1643;"Klitmøller";"no";0;0;0;57,040555;8,491388
1644;"Klitmøller";"no";0;0;0;57,040555;8,491388
1645;"Klitmøller";"no";0;0;0;57,040555;8,491388
1646;"Klitmøller";"no";0;0;0;57,040555;8,491388
1647;"Klitmøller";"no";0;0;0;57,040555;8,491388
1648;"Klitmøller";"no";0;0;0;57,040555;8,491388
1649;"Klitmøller";"no";0;0;0;57,040555;8,491388
1650;"Klitmøller";"no";0;0;0;57,040555;8,491388
1651;"Klitmøller";"no";0;0;0;57,040555;8,491388
1652;"Klitmøller";"no";0;0;0;57,040555;8,491388
1653;"Klitmøller";"no";0;0;0;57,040555;8,491388
1654;"Klitmøller";"no";0;0;0;57,040555;8,491388
1655;"Klitmøller";"no";0;0;0;57,040555;8,491388
1656;"Klitmøller";"no";0;0;0;57,040555;8,491388
1657;"Klitmøller";"no";0;0;0;57,040555;8,491388
1658;"Klitmøller";"no";0;0;0;57,040555;8,491388
1659;"Klitmøller";"no";0;0;0;57,040555;8,491388
1660;"Klitmøller";"no";0;0;0;57,040555;8,491388
1661;"Klitmøller";"no";0;0;0;57,040555;8,491388
1662;"Klitmøller";"no";0;0;0;57,040555;8,491388
1663;"Klitmøller";"no";0;0;0;57,040555;8,491388
1664;"Klitmøller";"no";0;0;0;57,040555;8,491388
1665;"Klitmøller";"no";0;0;0;57,040555;8,491388
1666;"Klitmøller";"no";0;0;0;57,040555;8,491388
1667;"Klitmøller";"no";0;0;0;57,040555;8,491388
1668;"Klitmøller";"no";0;0;0;57,040555;8,491388
1669;"Klitmøller";"no";0;0;0;57,040555;8,491388
1670;"Klitmøller";"no";0;0;0;57,040555;8,491388
1671;"Klitmøller";"no";0;0;0;57,040555;8,491388
1672;"Klitmøller";"no";0;0;0;57,040555;8,491388
1673;"Klitmøller";"no";0;0;0;57,040555;8,491388
1674;"Klitmøller";"no";0;0;0;57,040555;8,491388
1675;"Klitmøller";"no";0;0;0;57,040555;8,491388
1676;"Klitmøller";"no";0;0;0;57,040555;8,491388
1677;"Klitmøller";"no";0;0;0;57,040555;8,491388
1678;"Klitmøller";"no";0;0;0;57,040555;8,491388
1679;"Klitmøller";"no";0;0;0;57,040555;8,491388
1680;"Klitmøller";"no";0;0;0;57,040555;8,491388
1681;"Klitmøller";"no";0;0;0;57,040555;8,491388
1682;"Klitmøller";"no";0;0;0;57,040555;8,491388
1683;"Klitmøller";"no";0;0;0;57,040555;8,491388
1684;"Klitmøller";"no";0;0;0;57,040555;8,491388
1685;"Klitmøller";"no";0;0;0;57,040555;8,491388
1686;"Klitmøller";"no";0;0;0;57,040555;8,491388
1687;"Klitmøller";"no";0;0;0;57,040555;8,491388
1688;"Klitmøller";"no";0;0;0;57,040555;8,491388
1689;"Klitmøller";"no";0;0;0;57,040555;8,491388
1690;"Klitmøller";"no";0;0;0;57,040555;8,491388
1691;"Klitmøller";"no";0;0;0;57,040555;8,491388
1692;"Klitmøller";"no";0;0;0;57,040555;8,491388
1693;"Klitmøller";"no";0;0;0;57,040555;8,491388
1694;"Klitmøller";"no";0;0;0;57,040555;8,491388
1695;"Klitmøller";"no";0;0;0;57,040555;8,491388
1696;"Klitmøller";"no";0;0;0;57,040555;8,491388
1697;"Klitmøller";"no";0;0;0;57,040555;8,491388
1698;"Klitmøller";"no";0;0;0;57,040555;8,491388
1699;"Klitmøller";"no";0;0;0;57,040555;8,491388
1700;"Klitmøller";"no";0;0;0;57,040555;8,491388
1701;"Klitmøller";"no";0;0;0;57,040555;8,491388
1702;"Klitmøller";"no";0;0;0;57,040555;8,491388
1703;"Klitmøller";"no";0;0;0;57,040555;8,491388
1704;"Klitmøller";"no";0;0;0;57,040555;8,491388
1705;"Klitmøller";"no";0;0;0;57,040555;8,491388
1706;"Klitmøller";"no";0;0;0;57,040555;8,491388
1707;"Klitmøller";"no";0;0;0;57,040555;8,491388
1708;"Klitmøller";"no";0;0;0;57,040555;8,491388
1709;"Klitmøller";"no";0;0;0;57,040555;8,491388
1710;"Klitmøller";"no";0;0;0;57,040555;8,491388
1711;"Klitmøller";"no";0;0;0;57,040555;8,491388
1712;"Klitmøller";"no";0;0;0;57,040555;8,491388
1713;"Klitmøller";"no";0;0;0;57,040555;8,491388
1714;"Klitmøller";"no";0;0;0;57,040555;8,491388
1715;"Klitmøller";"no";0;0;0;57,040555;8,491388
1716;"Klitmøller";"no";0;0;0;57,040555;8,491388
1717;"Klitmøller";"no";0;0;0;57,040555;8,491388
1718;"Klitmøller";"no";0;0;0;57,040555;8,491388
1719;"Klitmøller";"no";0;0;0;57,040555;8,491388
1720;"Klitmøller";"no";0;0;0;57,040555;8,491388
1721;"Klitmøller";"no";0;0;0;57,040555;8,491388
1722;"Klitmøller";"no";0;0;0;57,040555;8,491388
1723;"Klitmøller";"no";0;0;0;57,040555;8,491388
1724;"Klitmøller";"no";0;0;0;57,040555;8,491388
1725;"Klitmøller";"no";0;0;0;57,040555;8,491388
1726;"Klitmøller";"no";0;0;0;57,040555;8,491388
1727;"Klitmøller";"no";0;0;0;57,040555;8,491388
1728;"Klitmøller";"no";0;0;0;57,040555;8,491388
1729;"Klitmøller";"no";0;0;0;57,040555;8,491388
1730;"Klitmøller";"no";0;0;0;57,040555;8,491388
1731;"Klitmøller";"no";0;0;0;57,040555;8,491388
1732;"Klitmøller";"no";0;0;0;57,040555;8,491388
1733;"Klitmøller";"no";0;0;0;57,040555;8,491388
1734;"Klitmøller";"no";0;0;0;57,040555;8,491388
1735;"Klitmøller";"no";0;0;0;57,040555;8,491388
1736;"Klitmøller";"no";0;0;0;57,040555;8,491388
1737;"Klitmøller";"no";0;0;0;57,040555;8,491388
1738;"Klitmøller";"no";0;0;0;57,040555;8,491388
1739;"Klitmøller";"no";0;0;0;57,040555;8,491388
1740;"Klitmøller";"no";0;0;0;57,040555;8,491388
1741;"Klitmøller";"no";0;0;0;57,040555;8,491388
1742;"Klitmøller";"no";0;0;0;57,040555;8,491388
1743;"Klitmøller";"no";0;0;0;57,040555;8,491388
1744;"Klitmøller";"no";0;0;0;57,040555;8,491388
1745;"Klitmøller";"no";0;0;0;57,040555;8,491388
1746;"Klitmøller";"no";0;0;0;57,040555;8,491388
1747;"Klitmøller";"no";0;0;0;57,040555;8,491388
1748;"Klitmøller";"no";0;0;0;57,040555;8,491388
1749;"Klitmøller";"no";0;0;0;57,040555;8,491388
1750;"Klitmøller";"no";0;0;0;57,040555;8,491388
1751;"Klitmøller";"no";0;0;0;57,040555;8,491388
1752;"Klitmøller";"no";0;0;0;57,040555;8,491388
1753;"Klitmøller";"no";0;0;0;57,040555;8,491388
1754;"Klitmøller";"no";0;0;0;57,040555;8,491388
1755;"Klitmøller";"no";0;0;0;57,040555;8,491388
1756;"Klitmøller";"no";0;0;0;57,040555;8,491388
1757;"Klitmøller";"no";0;0;0;57,040555;8,491388
1758;"Klitmøller";"no";0;0;0;57,040555;8,491388
1759;"Klitmøller";"no";0;0;0;57,040555;8,491388
1760;"Klitmøller";"no";0;0;0;57,040555;8,491388
1761;"Klitmøller";"no";0;0;0;57,040555;8,491388
1762;"Klitmøller";"no";0;0;0;57,040555;8,491388
1763;"Klitmøller";"no";0;0;0;57,040555;8,491388
1764;"Klitmøller";"no";0;0;0;57,040555;8,491388
1765;"Klitmøller";"no";0;0;0;57,040555;8,491388
1766;"Klitmøller";"no";0;0;0;57,040555;8,491388
1767;"Klitmøller";"no";0;0;0;57,040555;8,491388
1768;"Klitmøller";"no";0;0;0;57,040555;8,491388
1769;"Klitmøller";"no";0;0;0;57,040555;8,491388
1770;"Klitmøller";"no";0;0;0;57,040555;8,491388
1771;"Klitmøller";"no";0;0;0;57,040555;8,491388
1772;"Klitmøller";"no";0;0;0;57,040555;8,491388
1773;"Klitmøller";"no";0;0;0;57,040555;8,491388
1774;"Klitmøller";"no";0;0;0;57,040555;8,491388
1775;"Klitmøller";"no";0;0;0;57,040555;8,491388
1776;"Klitmøller";"no";0;0;0;57,040555;8,491388
1777;"Klitmøller";"no";0;0;0;57,040555;8,491388
1778;"Klitmøller";"no";0;0;0;57,040555;8,491388
1779;"Klitmøller";"no";0;0;0;57,040555;8,491388
1780;"Klitmøller";"no";0;0;0;57,040555;8,491388
1781;"Klitmøller";"no";0;0;0;57,040555;8,491388
1782;"Klitmøller";"no";0;0;0;57,040555;8,491388
1783;"Klitmøller";"no";0;0;0;57,040555;8,491388
1784;"Klitmøller";"no";0;0;0;57,040555;8,491388
1785;"Klitmøller";"no";0;0;0;57,040555;8,491388
1786;"Klitmøller";"no";0;0;0;57,040555;8,491388
1787;"Klitmøller";"no";0;0;0;57,040555;8,491388
1788;"Klitmøller";"no";0;0;0;57,040555;8,491388
1789;"Klitmøller";"no";0;0;0;57,040555;8,491388
1790;"Klitmøller";"no";0;0;0;57,040555;8,491388
1791;"Klitmøller";"no";0;0;0;57,040555;8,491388
1792;"Klitmøller";"no";0;0;0;57,040555;8,491388
1793;"Klitmøller";"no";0;0;0;57,040555;8,491388
1794;"Klitmøller";"no";0;0;0;57,040555;8,491388
1795;"Klitmøller";"no";0;0;0;57,040555;8,491388
1796;"Klitmøller";"no";0;0;0;57,040555;8,491388
1797;"Klitmøller";"no";0;0;0;57,040555;8,491388
1798;"Klitmøller";"no";0;0;0;57,040555;8,491388
1799;"Klitmøller";"no";0;0;0;57,040555;8,491388
1800;"Klitmøller";"no";0;0;0;57,040555;8,491388
1801;"Klitmøller";"no";0;0;0;57,040555;8,491388
1802;"Klitmøller";"no";0;0;0;57,040555;8,491388
1803;"Klitmøller";"no";0;0;0;57,040555;8,491388
1804;"Klitmøller";"no";0;0;0;57,040555;8,491388
1805;"Klitmøller";"no";0;0;0;57,040555;8,491388
1806;"Klitmøller";"no";0;0;0;57,040555;8,491388
1807;"Klitmøller";"no";0;0;0;57,040555;8,491388
1808;"Klitmøller";"no";0;0;0;57,040555;8,491388
1809;"Klitmøller";"no";0;0;0;57,040555;8,491388
1810;"Klitmøller";"no";0;0;0;57,040555;8,491388
1811;"Klitmøller";"no";0;0;0;57,040555;8,491388
1812;"Klitmøller";"no";0;0;0;57,040555;8,491388
1813;"Klitmøller";"no";0;0;0;57,040555;8,491388
1814;"Klitmøller";"no";0;0;0;57,040555;8,491388
1815;"Klitmøller";"no";0;0;0;57,040555;8,491388
1816;"Klitmøller";"no";0;0;0;57,040555;8,491388
1817;"Klitmøller";"no";0;0;0;57,040555;8,491388
1818;"Klitmøller";"no";0;0;0;57,040555;8,491388
1819;"Klitmøller";"no";0;0;0;57,040555;8,491388
1820;"Klitmøller";"no";0;0;0;57,040555;8,491388
1821;"Klitmøller";"no";0;0;0;57,040555;8,491388
1822;"Klitmøller";"no";0;0;0;57,040555;8,491388
1823;"Klitmøller";"no";0;0;0;57,040555;8,491388
1824;"Klitmøller";"no";0;0;0;57,040555;8,491388
1825;"Klitmøller";"no";0;0;0;57,040555;8,491388
1826;"Klitmøller";"no";0;0;0;57,040555;8,491388
1827;"Klitmøller";"no";0;0;0;57,040555;8,491388
1828;"Klitmøller";"no";0;0;0;57,040555;8,491388
1829;"Klitmøller";"no";0;0;0;57,040555;8,491388
1830;"Klitmøller";"no";0;0;0;57,040555;8,491388
1831;"Klitmøller";"no";0;0;0;57,040555;8,491388
1832;"Klitmøller";"no";0;1;1;57,040555;8,491388
1833;"Klitmøller";"no";0;0;0;57,040555;8,491388
1834;"Klitmøller";"no";0;0;0;57,040555;8,491388
1835;"Klitmøller";"no";0;1;1;57,040555;8,491388
1836;"Klitmøller";"no";0;0;0;57,040555;8,491388
1837;"Klitmøller";"no";0;1;1;57,040555;8,491388
1838;"Klitmøller";"no";0;2;2;57,040555;8,491388
1839;"Klitmøller";"no";0;0;0;57,040555;8,491388
1840;"Klitmøller";"no";0;0;0;57,040555;8,491388
1841;"Klitmøller";"no";0;0;0;57,040555;8,491388
1842;"Klitmøller";"no";0;0;0;57,040555;8,491388
1843;"Klitmøller";"no";0;0;0;57,040555;8,491388
1844;"Klitmøller";"no";0;0;0;57,040555;8,491388
1845;"Klitmøller";"no";0;0;0;57,040555;8,491388
1846;"Klitmøller";"no";0;0;0;57,040555;8,491388
1847;"Klitmøller";"no";0;0;0;57,040555;8,491388
1848;"Klitmøller";"no";0;0;0;57,040555;8,491388
1849;"Klitmøller";"no";0;0;0;57,040555;8,491388
1850;"Klitmøller";"no";0;0;0;57,040555;8,491388
1851;"Klitmøller";"no";0;0;0;57,040555;8,491388
1852;"Klitmøller";"no";0;0;0;57,040555;8,491388
1853;"Klitmøller";"no";0;0;0;57,040555;8,491388
1854;"Klitmøller";"no";0;0;0;57,040555;8,491388
1855;"Klitmøller";"no";0;0;0;57,040555;8,491388
1856;"Klitmøller";"no";0;0;0;57,040555;8,491388
1857;"Klitmøller";"no";0;0;0;57,040555;8,491388
1634;"Nordholm";"no";0;0;0;55,484722;11,09
1635;"Nordholm";"no";0;0;0;55,484722;11,09
1636;"Nordholm";"no";0;0;0;55,484722;11,09
1637;"Nordholm";"no";0;0;0;55,484722;11,09
1638;"Nordholm";"no";0;0;0;55,484722;11,09
1639;"Nordholm";"no";0;0;0;55,484722;11,09
1640;"Nordholm";"no";0;0;0;55,484722;11,09
1641;"Nordholm";"no";0;0;0;55,484722;11,09
1642;"Nordholm";"no";0;0;0;55,484722;11,09
1643;"Nordholm";"no";0;0;0;55,484722;11,09
1644;"Nordholm";"no";0;0;0;55,484722;11,09
1645;"Nordholm";"no";0;0;0;55,484722;11,09
1646;"Nordholm";"no";0;0;0;55,484722;11,09
1647;"Nordholm";"no";0;0;0;55,484722;11,09
1648;"Nordholm";"no";0;0;0;55,484722;11,09
1649;"Nordholm";"no";0;0;0;55,484722;11,09
1650;"Nordholm";"no";0;0;0;55,484722;11,09
1651;"Nordholm";"no";0;0;0;55,484722;11,09
1652;"Nordholm";"no";0;0;0;55,484722;11,09
1653;"Nordholm";"no";0;0;0;55,484722;11,09
1654;"Nordholm";"no";0;0;0;55,484722;11,09
1655;"Nordholm";"no";0;0;0;55,484722;11,09
1656;"Nordholm";"no";0;0;0;55,484722;11,09
1657;"Nordholm";"no";0;0;0;55,484722;11,09
1658;"Nordholm";"no";0;0;0;55,484722;11,09
1659;"Nordholm";"no";0;0;0;55,484722;11,09
1660;"Nordholm";"no";0;0;0;55,484722;11,09
1661;"Nordholm";"no";0;0;0;55,484722;11,09
1662;"Nordholm";"no";0;0;0;55,484722;11,09
1663;"Nordholm";"no";0;0;0;55,484722;11,09
1664;"Nordholm";"no";0;0;0;55,484722;11,09
1665;"Nordholm";"no";0;0;0;55,484722;11,09
1666;"Nordholm";"no";0;0;0;55,484722;11,09
1667;"Nordholm";"no";0;0;0;55,484722;11,09
1668;"Nordholm";"no";0;0;0;55,484722;11,09
1669;"Nordholm";"no";0;0;0;55,484722;11,09
1670;"Nordholm";"no";0;0;0;55,484722;11,09
1671;"Nordholm";"no";0;0;0;55,484722;11,09
1672;"Nordholm";"no";0;0;0;55,484722;11,09
1673;"Nordholm";"no";0;0;0;55,484722;11,09
1674;"Nordholm";"no";0;0;0;55,484722;11,09
1675;"Nordholm";"no";0;0;0;55,484722;11,09
1676;"Nordholm";"no";0;0;0;55,484722;11,09
1677;"Nordholm";"no";0;0;0;55,484722;11,09
1678;"Nordholm";"no";0;0;0;55,484722;11,09
1679;"Nordholm";"no";0;0;0;55,484722;11,09
1680;"Nordholm";"no";0;0;0;55,484722;11,09
1681;"Nordholm";"no";0;0;0;55,484722;11,09
1682;"Nordholm";"no";0;0;0;55,484722;11,09
1683;"Nordholm";"no";0;0;0;55,484722;11,09
1684;"Nordholm";"no";0;0;0;55,484722;11,09
1685;"Nordholm";"no";0;0;0;55,484722;11,09
1686;"Nordholm";"no";0;0;0;55,484722;11,09
1687;"Nordholm";"no";0;0;0;55,484722;11,09
1688;"Nordholm";"no";0;0;0;55,484722;11,09
1689;"Nordholm";"no";0;0;0;55,484722;11,09
1690;"Nordholm";"no";0;0;0;55,484722;11,09
1691;"Nordholm";"no";0;0;0;55,484722;11,09
1692;"Nordholm";"no";0;0;0;55,484722;11,09
1693;"Nordholm";"no";0;0;0;55,484722;11,09
1694;"Nordholm";"no";0;0;0;55,484722;11,09
1695;"Nordholm";"no";0;0;0;55,484722;11,09
1696;"Nordholm";"no";0;0;0;55,484722;11,09
1697;"Nordholm";"no";0;0;0;55,484722;11,09
1698;"Nordholm";"no";0;0;0;55,484722;11,09
1699;"Nordholm";"no";0;0;0;55,484722;11,09
1700;"Nordholm";"no";0;0;0;55,484722;11,09
1701;"Nordholm";"no";0;0;0;55,484722;11,09
1702;"Nordholm";"no";0;0;0;55,484722;11,09
1703;"Nordholm";"no";0;0;0;55,484722;11,09
1704;"Nordholm";"no";0;0;0;55,484722;11,09
1705;"Nordholm";"no";0;0;0;55,484722;11,09
1706;"Nordholm";"no";0;0;0;55,484722;11,09
1707;"Nordholm";"no";0;0;0;55,484722;11,09
1708;"Nordholm";"no";0;0;0;55,484722;11,09
1709;"Nordholm";"no";0;0;0;55,484722;11,09
1710;"Nordholm";"no";0;0;0;55,484722;11,09
1711;"Nordholm";"no";0;0;0;55,484722;11,09
1712;"Nordholm";"no";0;0;0;55,484722;11,09
1713;"Nordholm";"no";0;0;0;55,484722;11,09
1714;"Nordholm";"no";0;0;0;55,484722;11,09
1715;"Nordholm";"no";0;0;0;55,484722;11,09
1716;"Nordholm";"no";0;0;0;55,484722;11,09
1717;"Nordholm";"no";0;0;0;55,484722;11,09
1718;"Nordholm";"no";0;0;0;55,484722;11,09
1719;"Nordholm";"no";0;0;0;55,484722;11,09
1720;"Nordholm";"no";0;0;0;55,484722;11,09
1721;"Nordholm";"no";0;0;0;55,484722;11,09
1722;"Nordholm";"no";0;0;0;55,484722;11,09
1723;"Nordholm";"no";0;0;0;55,484722;11,09
1724;"Nordholm";"no";0;0;0;55,484722;11,09
1725;"Nordholm";"no";0;0;0;55,484722;11,09
1726;"Nordholm";"no";0;0;0;55,484722;11,09
1727;"Nordholm";"no";0;0;0;55,484722;11,09
1728;"Nordholm";"no";0;0;0;55,484722;11,09
1729;"Nordholm";"no";0;0;0;55,484722;11,09
1730;"Nordholm";"no";0;0;0;55,484722;11,09
1731;"Nordholm";"no";0;0;0;55,484722;11,09
1732;"Nordholm";"no";0;0;0;55,484722;11,09
1733;"Nordholm";"no";0;0;0;55,484722;11,09
1734;"Nordholm";"no";0;0;0;55,484722;11,09
1735;"Nordholm";"no";0;0;0;55,484722;11,09
1736;"Nordholm";"no";0;0;0;55,484722;11,09
1737;"Nordholm";"no";0;0;0;55,484722;11,09
1738;"Nordholm";"no";0;0;0;55,484722;11,09
1739;"Nordholm";"no";0;0;0;55,484722;11,09
1740;"Nordholm";"no";0;0;0;55,484722;11,09
1741;"Nordholm";"no";0;0;0;55,484722;11,09
1742;"Nordholm";"no";0;0;0;55,484722;11,09
1743;"Nordholm";"no";0;0;0;55,484722;11,09
1744;"Nordholm";"no";0;0;0;55,484722;11,09
1745;"Nordholm";"no";0;0;0;55,484722;11,09
1746;"Nordholm";"no";0;0;0;55,484722;11,09
1747;"Nordholm";"no";0;0;0;55,484722;11,09
1748;"Nordholm";"no";0;0;0;55,484722;11,09
1749;"Nordholm";"no";0;0;0;55,484722;11,09
1750;"Nordholm";"no";0;0;0;55,484722;11,09
1751;"Nordholm";"no";0;0;0;55,484722;11,09
1752;"Nordholm";"no";0;0;0;55,484722;11,09
1753;"Nordholm";"no";0;0;0;55,484722;11,09
1754;"Nordholm";"no";0;0;0;55,484722;11,09
1755;"Nordholm";"no";0;0;0;55,484722;11,09
1756;"Nordholm";"no";0;0;0;55,484722;11,09
1757;"Nordholm";"no";0;0;0;55,484722;11,09
1758;"Nordholm";"no";0;0;0;55,484722;11,09
1759;"Nordholm";"no";0;0;0;55,484722;11,09
1760;"Nordholm";"no";0;0;0;55,484722;11,09
1761;"Nordholm";"no";0;0;0;55,484722;11,09
1762;"Nordholm";"no";0;0;0;55,484722;11,09
1763;"Nordholm";"no";0;0;0;55,484722;11,09
1764;"Nordholm";"no";0;0;0;55,484722;11,09
1765;"Nordholm";"no";0;0;0;55,484722;11,09
1766;"Nordholm";"no";0;0;0;55,484722;11,09
1767;"Nordholm";"no";0;0;0;55,484722;11,09
1768;"Nordholm";"no";0;0;0;55,484722;11,09
1769;"Nordholm";"no";0;0;0;55,484722;11,09
1770;"Nordholm";"no";0;0;0;55,484722;11,09
1771;"Nordholm";"no";0;0;0;55,484722;11,09
1772;"Nordholm";"no";0;0;0;55,484722;11,09
1773;"Nordholm";"no";0;0;0;55,484722;11,09
1774;"Nordholm";"no";0;0;0;55,484722;11,09
1775;"Nordholm";"no";0;0;0;55,484722;11,09
1776;"Nordholm";"no";0;0;0;55,484722;11,09
1777;"Nordholm";"no";0;0;0;55,484722;11,09
1778;"Nordholm";"no";0;0;0;55,484722;11,09
1779;"Nordholm";"no";0;0;0;55,484722;11,09
1780;"Nordholm";"no";0;0;0;55,484722;11,09
1781;"Nordholm";"no";0;0;0;55,484722;11,09
1782;"Nordholm";"no";0;0;0;55,484722;11,09
1783;"Nordholm";"no";0;0;0;55,484722;11,09
1784;"Nordholm";"no";0;0;0;55,484722;11,09
1785;"Nordholm";"no";0;0;0;55,484722;11,09
1786;"Nordholm";"no";0;0;0;55,484722;11,09
1787;"Nordholm";"no";0;0;0;55,484722;11,09
1788;"Nordholm";"no";0;0;0;55,484722;11,09
1789;"Nordholm";"no";0;0;0;55,484722;11,09
1790;"Nordholm";"no";0;0;0;55,484722;11,09
1791;"Nordholm";"no";0;0;0;55,484722;11,09
1792;"Nordholm";"no";0;0;0;55,484722;11,09
1793;"Nordholm";"no";0;0;0;55,484722;11,09
1794;"Nordholm";"no";0;0;0;55,484722;11,09
1795;"Nordholm";"no";0;0;0;55,484722;11,09
1796;"Nordholm";"no";0;0;0;55,484722;11,09
1797;"Nordholm";"no";0;0;0;55,484722;11,09
1798;"Nordholm";"no";0;0;0;55,484722;11,09
1799;"Nordholm";"no";0;0;0;55,484722;11,09
1800;"Nordholm";"no";0;0;0;55,484722;11,09
1801;"Nordholm";"no";0;0;0;55,484722;11,09
1802;"Nordholm";"no";0;0;0;55,484722;11,09
1803;"Nordholm";"no";0;0;0;55,484722;11,09
1804;"Nordholm";"no";0;0;0;55,484722;11,09
1805;"Nordholm";"no";0;0;0;55,484722;11,09
1806;"Nordholm";"no";0;0;0;55,484722;11,09
1807;"Nordholm";"no";0;0;0;55,484722;11,09
1808;"Nordholm";"no";0;0;0;55,484722;11,09
1809;"Nordholm";"no";0;0;0;55,484722;11,09
1810;"Nordholm";"no";0;0;0;55,484722;11,09
1811;"Nordholm";"no";0;0;0;55,484722;11,09
1812;"Nordholm";"no";0;0;0;55,484722;11,09
1813;"Nordholm";"no";0;0;0;55,484722;11,09
1814;"Nordholm";"no";0;0;0;55,484722;11,09
1815;"Nordholm";"no";0;0;0;55,484722;11,09
1816;"Nordholm";"no";0;0;0;55,484722;11,09
1817;"Nordholm";"no";0;0;0;55,484722;11,09
1818;"Nordholm";"no";0;0;0;55,484722;11,09
1819;"Nordholm";"no";0;0;0;55,484722;11,09
1820;"Nordholm";"no";0;0;0;55,484722;11,09
1821;"Nordholm";"no";0;0;0;55,484722;11,09
1822;"Nordholm";"no";0;0;0;55,484722;11,09
1823;"Nordholm";"no";0;0;0;55,484722;11,09
1824;"Nordholm";"no";0;0;0;55,484722;11,09
1825;"Nordholm";"no";0;0;0;55,484722;11,09
1826;"Nordholm";"no";0;0;0;55,484722;11,09
1827;"Nordholm";"no";0;0;0;55,484722;11,09
1828;"Nordholm";"no";0;0;0;55,484722;11,09
1829;"Nordholm";"no";0;0;0;55,484722;11,09
1830;"Nordholm";"no";0;0;0;55,484722;11,09
1831;"Nordholm";"no";0;0;0;55,484722;11,09
1832;"Nordholm";"no";0;0;0;55,484722;11,09
1833;"Nordholm";"no";0;0;0;55,484722;11,09
1834;"Nordholm";"no";0;1;1;55,484722;11,09
1835;"Nordholm";"no";0;0;0;55,484722;11,09
1836;"Nordholm";"no";0;0;0;55,484722;11,09
1837;"Nordholm";"no";0;0;0;55,484722;11,09
1838;"Nordholm";"no";0;0;0;55,484722;11,09
1839;"Nordholm";"no";0;0;0;55,484722;11,09
1840;"Nordholm";"no";0;0;0;55,484722;11,09
1841;"Nordholm";"no";0;0;0;55,484722;11,09
1842;"Nordholm";"no";0;0;0;55,484722;11,09
1843;"Nordholm";"no";0;0;0;55,484722;11,09
1844;"Nordholm";"no";0;0;0;55,484722;11,09
1845;"Nordholm";"no";0;0;0;55,484722;11,09
1846;"Nordholm";"no";0;0;0;55,484722;11,09
1847;"Nordholm";"no";0;0;0;55,484722;11,09
1848;"Nordholm";"no";0;0;0;55,484722;11,09
1849;"Nordholm";"no";0;0;0;55,484722;11,09
1850;"Nordholm";"no";0;0;0;55,484722;11,09
1851;"Nordholm";"no";0;0;0;55,484722;11,09
1852;"Nordholm";"no";0;0;0;55,484722;11,09
1853;"Nordholm";"no";0;0;0;55,484722;11,09
1854;"Nordholm";"no";0;0;0;55,484722;11,09
1855;"Nordholm";"no";0;0;0;55,484722;11,09
1856;"Nordholm";"no";0;0;0;55,484722;11,09
1857;"Nordholm";"no";0;0;0;55,484722;11,09
1634;"Espergærde";"no";0;0;0;56;12,566666
1635;"Espergærde";"no";0;0;0;56;12,566666
1636;"Espergærde";"no";0;0;0;56;12,566666
1637;"Espergærde";"no";0;0;0;56;12,566666
1638;"Espergærde";"no";0;0;0;56;12,566666
1639;"Espergærde";"no";0;0;0;56;12,566666
1640;"Espergærde";"no";0;0;0;56;12,566666
1641;"Espergærde";"no";0;0;0;56;12,566666
1642;"Espergærde";"no";0;0;0;56;12,566666
1643;"Espergærde";"no";0;0;0;56;12,566666
1644;"Espergærde";"no";0;0;0;56;12,566666
1645;"Espergærde";"no";0;0;0;56;12,566666
1646;"Espergærde";"no";0;0;0;56;12,566666
1647;"Espergærde";"no";0;0;0;56;12,566666
1648;"Espergærde";"no";0;0;0;56;12,566666
1649;"Espergærde";"no";0;0;0;56;12,566666
1650;"Espergærde";"no";0;0;0;56;12,566666
1651;"Espergærde";"no";0;0;0;56;12,566666
1652;"Espergærde";"no";0;0;0;56;12,566666
1653;"Espergærde";"no";0;0;0;56;12,566666
1654;"Espergærde";"no";0;0;0;56;12,566666
1655;"Espergærde";"no";0;0;0;56;12,566666
1656;"Espergærde";"no";0;0;0;56;12,566666
1657;"Espergærde";"no";0;0;0;56;12,566666
1658;"Espergærde";"no";0;0;0;56;12,566666
1659;"Espergærde";"no";0;0;0;56;12,566666
1660;"Espergærde";"no";0;0;0;56;12,566666
1661;"Espergærde";"no";0;0;0;56;12,566666
1662;"Espergærde";"no";0;0;0;56;12,566666
1663;"Espergærde";"no";0;0;0;56;12,566666
1664;"Espergærde";"no";0;0;0;56;12,566666
1665;"Espergærde";"no";0;0;0;56;12,566666
1666;"Espergærde";"no";0;0;0;56;12,566666
1667;"Espergærde";"no";0;0;0;56;12,566666
1668;"Espergærde";"no";0;0;0;56;12,566666
1669;"Espergærde";"no";0;0;0;56;12,566666
1670;"Espergærde";"no";0;0;0;56;12,566666
1671;"Espergærde";"no";0;0;0;56;12,566666
1672;"Espergærde";"no";0;0;0;56;12,566666
1673;"Espergærde";"no";0;0;0;56;12,566666
1674;"Espergærde";"no";0;0;0;56;12,566666
1675;"Espergærde";"no";0;0;0;56;12,566666
1676;"Espergærde";"no";0;0;0;56;12,566666
1677;"Espergærde";"no";0;0;0;56;12,566666
1678;"Espergærde";"no";0;0;0;56;12,566666
1679;"Espergærde";"no";0;0;0;56;12,566666
1680;"Espergærde";"no";0;0;0;56;12,566666
1681;"Espergærde";"no";0;0;0;56;12,566666
1682;"Espergærde";"no";0;0;0;56;12,566666
1683;"Espergærde";"no";0;0;0;56;12,566666
1684;"Espergærde";"no";0;0;0;56;12,566666
1685;"Espergærde";"no";0;0;0;56;12,566666
1686;"Espergærde";"no";0;0;0;56;12,566666
1687;"Espergærde";"no";0;0;0;56;12,566666
1688;"Espergærde";"no";0;0;0;56;12,566666
1689;"Espergærde";"no";0;0;0;56;12,566666
1690;"Espergærde";"no";0;0;0;56;12,566666
1691;"Espergærde";"no";0;0;0;56;12,566666
1692;"Espergærde";"no";0;0;0;56;12,566666
1693;"Espergærde";"no";0;0;0;56;12,566666
1694;"Espergærde";"no";0;0;0;56;12,566666
1695;"Espergærde";"no";0;0;0;56;12,566666
1696;"Espergærde";"no";0;0;0;56;12,566666
1697;"Espergærde";"no";0;0;0;56;12,566666
1698;"Espergærde";"no";0;0;0;56;12,566666
1699;"Espergærde";"no";0;0;0;56;12,566666
1700;"Espergærde";"no";0;0;0;56;12,566666
1701;"Espergærde";"no";0;0;0;56;12,566666
1702;"Espergærde";"no";0;0;0;56;12,566666
1703;"Espergærde";"no";0;0;0;56;12,566666
1704;"Espergærde";"no";0;0;0;56;12,566666
1705;"Espergærde";"no";0;0;0;56;12,566666
1706;"Espergærde";"no";0;0;0;56;12,566666
1707;"Espergærde";"no";0;0;0;56;12,566666
1708;"Espergærde";"no";0;0;0;56;12,566666
1709;"Espergærde";"no";0;0;0;56;12,566666
1710;"Espergærde";"no";0;0;0;56;12,566666
1711;"Espergærde";"no";0;0;0;56;12,566666
1712;"Espergærde";"no";0;0;0;56;12,566666
1713;"Espergærde";"no";0;0;0;56;12,566666
1714;"Espergærde";"no";0;0;0;56;12,566666
1715;"Espergærde";"no";0;0;0;56;12,566666
1716;"Espergærde";"no";0;0;0;56;12,566666
1717;"Espergærde";"no";0;0;0;56;12,566666
1718;"Espergærde";"no";0;0;0;56;12,566666
1719;"Espergærde";"no";0;0;0;56;12,566666
1720;"Espergærde";"no";0;0;0;56;12,566666
1721;"Espergærde";"no";0;0;0;56;12,566666
1722;"Espergærde";"no";0;0;0;56;12,566666
1723;"Espergærde";"no";0;0;0;56;12,566666
1724;"Espergærde";"no";0;0;0;56;12,566666
1725;"Espergærde";"no";0;0;0;56;12,566666
1726;"Espergærde";"no";0;0;0;56;12,566666
1727;"Espergærde";"no";0;0;0;56;12,566666
1728;"Espergærde";"no";0;0;0;56;12,566666
1729;"Espergærde";"no";0;0;0;56;12,566666
1730;"Espergærde";"no";0;0;0;56;12,566666
1731;"Espergærde";"no";0;0;0;56;12,566666
1732;"Espergærde";"no";0;0;0;56;12,566666
1733;"Espergærde";"no";0;0;0;56;12,566666
1734;"Espergærde";"no";0;0;0;56;12,566666
1735;"Espergærde";"no";0;0;0;56;12,566666
1736;"Espergærde";"no";0;0;0;56;12,566666
1737;"Espergærde";"no";0;0;0;56;12,566666
1738;"Espergærde";"no";0;0;0;56;12,566666
1739;"Espergærde";"no";0;0;0;56;12,566666
1740;"Espergærde";"no";0;0;0;56;12,566666
1741;"Espergærde";"no";0;0;0;56;12,566666
1742;"Espergærde";"no";0;0;0;56;12,566666
1743;"Espergærde";"no";0;0;0;56;12,566666
1744;"Espergærde";"no";0;0;0;56;12,566666
1745;"Espergærde";"no";0;0;0;56;12,566666
1746;"Espergærde";"no";0;0;0;56;12,566666
1747;"Espergærde";"no";0;0;0;56;12,566666
1748;"Espergærde";"no";0;0;0;56;12,566666
1749;"Espergærde";"no";0;0;0;56;12,566666
1750;"Espergærde";"no";0;0;0;56;12,566666
1751;"Espergærde";"no";0;0;0;56;12,566666
1752;"Espergærde";"no";0;0;0;56;12,566666
1753;"Espergærde";"no";0;0;0;56;12,566666
1754;"Espergærde";"no";0;0;0;56;12,566666
1755;"Espergærde";"no";0;0;0;56;12,566666
1756;"Espergærde";"no";0;0;0;56;12,566666
1757;"Espergærde";"no";0;0;0;56;12,566666
1758;"Espergærde";"no";0;0;0;56;12,566666
1759;"Espergærde";"no";0;0;0;56;12,566666
1760;"Espergærde";"no";0;0;0;56;12,566666
1761;"Espergærde";"no";0;0;0;56;12,566666
1762;"Espergærde";"no";0;0;0;56;12,566666
1763;"Espergærde";"no";0;0;0;56;12,566666
1764;"Espergærde";"no";0;0;0;56;12,566666
1765;"Espergærde";"no";0;0;0;56;12,566666
1766;"Espergærde";"no";0;0;0;56;12,566666
1767;"Espergærde";"no";0;0;0;56;12,566666
1768;"Espergærde";"no";0;0;0;56;12,566666
1769;"Espergærde";"no";0;0;0;56;12,566666
1770;"Espergærde";"no";0;0;0;56;12,566666
1771;"Espergærde";"no";0;0;0;56;12,566666
1772;"Espergærde";"no";0;0;0;56;12,566666
1773;"Espergærde";"no";0;0;0;56;12,566666
1774;"Espergærde";"no";0;0;0;56;12,566666
1775;"Espergærde";"no";0;0;0;56;12,566666
1776;"Espergærde";"no";0;0;0;56;12,566666
1777;"Espergærde";"no";0;0;0;56;12,566666
1778;"Espergærde";"no";0;0;0;56;12,566666
1779;"Espergærde";"no";0;0;0;56;12,566666
1780;"Espergærde";"no";0;0;0;56;12,566666
1781;"Espergærde";"no";0;0;0;56;12,566666
1782;"Espergærde";"no";0;0;0;56;12,566666
1783;"Espergærde";"no";0;0;0;56;12,566666
1784;"Espergærde";"no";0;0;0;56;12,566666
1785;"Espergærde";"no";0;0;0;56;12,566666
1786;"Espergærde";"no";0;0;0;56;12,566666
1787;"Espergærde";"no";0;0;0;56;12,566666
1788;"Espergærde";"no";0;0;0;56;12,566666
1789;"Espergærde";"no";0;0;0;56;12,566666
1790;"Espergærde";"no";0;0;0;56;12,566666
1791;"Espergærde";"no";0;0;0;56;12,566666
1792;"Espergærde";"no";0;0;0;56;12,566666
1793;"Espergærde";"no";0;0;0;56;12,566666
1794;"Espergærde";"no";0;0;0;56;12,566666
1795;"Espergærde";"no";0;0;0;56;12,566666
1796;"Espergærde";"no";0;0;0;56;12,566666
1797;"Espergærde";"no";0;0;0;56;12,566666
1798;"Espergærde";"no";0;0;0;56;12,566666
1799;"Espergærde";"no";0;0;0;56;12,566666
1800;"Espergærde";"no";0;0;0;56;12,566666
1801;"Espergærde";"no";0;0;0;56;12,566666
1802;"Espergærde";"no";0;0;0;56;12,566666
1803;"Espergærde";"no";0;0;0;56;12,566666
1804;"Espergærde";"no";0;0;0;56;12,566666
1805;"Espergærde";"no";0;0;0;56;12,566666
1806;"Espergærde";"no";0;0;0;56;12,566666
1807;"Espergærde";"no";0;0;0;56;12,566666
1808;"Espergærde";"no";0;0;0;56;12,566666
1809;"Espergærde";"no";0;0;0;56;12,566666
1810;"Espergærde";"no";0;0;0;56;12,566666
1811;"Espergærde";"no";0;0;0;56;12,566666
1812;"Espergærde";"no";0;0;0;56;12,566666
1813;"Espergærde";"no";0;0;0;56;12,566666
1814;"Espergærde";"no";0;0;0;56;12,566666
1815;"Espergærde";"no";0;0;0;56;12,566666
1816;"Espergærde";"no";0;0;0;56;12,566666
1817;"Espergærde";"no";0;0;0;56;12,566666
1818;"Espergærde";"no";0;0;0;56;12,566666
1819;"Espergærde";"no";0;0;0;56;12,566666
1820;"Espergærde";"no";0;0;0;56;12,566666
1821;"Espergærde";"no";0;0;0;56;12,566666
1822;"Espergærde";"no";0;0;0;56;12,566666
1823;"Espergærde";"no";0;0;0;56;12,566666
1824;"Espergærde";"no";0;0;0;56;12,566666
1825;"Espergærde";"no";0;0;0;56;12,566666
1826;"Espergærde";"no";0;0;0;56;12,566666
1827;"Espergærde";"no";0;0;0;56;12,566666
1828;"Espergærde";"no";0;0;0;56;12,566666
1829;"Espergærde";"no";0;0;0;56;12,566666
1830;"Espergærde";"no";0;0;0;56;12,566666
1831;"Espergærde";"no";0;0;0;56;12,566666
1832;"Espergærde";"no";0;0;0;56;12,566666
1833;"Espergærde";"no";0;0;0;56;12,566666
1834;"Espergærde";"no";0;0;0;56;12,566666
1835;"Espergærde";"no";0;0;0;56;12,566666
1836;"Espergærde";"no";0;0;0;56;12,566666
1837;"Espergærde";"no";0;0;0;56;12,566666
1838;"Espergærde";"no";0;1;1;56;12,566666
1839;"Espergærde";"no";0;0;0;56;12,566666
1840;"Espergærde";"no";0;0;0;56;12,566666
1841;"Espergærde";"no";0;0;0;56;12,566666
1842;"Espergærde";"no";0;0;0;56;12,566666
1843;"Espergærde";"no";0;0;0;56;12,566666
1844;"Espergærde";"no";0;0;0;56;12,566666
1845;"Espergærde";"no";0;0;0;56;12,566666
1846;"Espergærde";"no";0;0;0;56;12,566666
1847;"Espergærde";"no";0;0;0;56;12,566666
1848;"Espergærde";"no";0;0;0;56;12,566666
1849;"Espergærde";"no";0;0;0;56;12,566666
1850;"Espergærde";"no";0;0;0;56;12,566666
1851;"Espergærde";"no";0;0;0;56;12,566666
1852;"Espergærde";"no";0;0;0;56;12,566666
1853;"Espergærde";"no";0;0;0;56;12,566666
1854;"Espergærde";"no";0;0;0;56;12,566666
1855;"Espergærde";"no";0;0;0;56;12,566666
1856;"Espergærde";"no";0;0;0;56;12,566666
1857;"Espergærde";"no";0;0;0;56;12,566666
1634;"Limfjorden";"west";0;0;0;56,916666;9,166666
1635;"Limfjorden";"west";0;0;0;56,916666;9,166666
1636;"Limfjorden";"west";0;0;0;56,916666;9,166666
1637;"Limfjorden";"west";0;0;0;56,916666;9,166666
1638;"Limfjorden";"west";0;0;0;56,916666;9,166666
1639;"Limfjorden";"west";0;0;0;56,916666;9,166666
1640;"Limfjorden";"west";0;0;0;56,916666;9,166666
1641;"Limfjorden";"west";0;0;0;56,916666;9,166666
1642;"Limfjorden";"west";0;0;0;56,916666;9,166666
1643;"Limfjorden";"west";0;0;0;56,916666;9,166666
1644;"Limfjorden";"west";0;0;0;56,916666;9,166666
1645;"Limfjorden";"west";0;0;0;56,916666;9,166666
1646;"Limfjorden";"west";0;0;0;56,916666;9,166666
1647;"Limfjorden";"west";0;0;0;56,916666;9,166666
1648;"Limfjorden";"west";0;0;0;56,916666;9,166666
1649;"Limfjorden";"west";0;0;0;56,916666;9,166666
1650;"Limfjorden";"west";0;0;0;56,916666;9,166666
1651;"Limfjorden";"west";0;0;0;56,916666;9,166666
1652;"Limfjorden";"west";0;0;0;56,916666;9,166666
1653;"Limfjorden";"west";0;0;0;56,916666;9,166666
1654;"Limfjorden";"west";0;0;0;56,916666;9,166666
1655;"Limfjorden";"west";0;0;0;56,916666;9,166666
1656;"Limfjorden";"west";0;0;0;56,916666;9,166666
1657;"Limfjorden";"west";0;0;0;56,916666;9,166666
1658;"Limfjorden";"west";0;0;0;56,916666;9,166666
1659;"Limfjorden";"west";0;0;0;56,916666;9,166666
1660;"Limfjorden";"west";0;0;0;56,916666;9,166666
1661;"Limfjorden";"west";0;0;0;56,916666;9,166666
1662;"Limfjorden";"west";0;0;0;56,916666;9,166666
1663;"Limfjorden";"west";0;0;0;56,916666;9,166666
1664;"Limfjorden";"west";0;0;0;56,916666;9,166666
1665;"Limfjorden";"west";0;0;0;56,916666;9,166666
1666;"Limfjorden";"west";0;0;0;56,916666;9,166666
1667;"Limfjorden";"west";0;0;0;56,916666;9,166666
1668;"Limfjorden";"west";0;0;0;56,916666;9,166666
1669;"Limfjorden";"west";0;0;0;56,916666;9,166666
1670;"Limfjorden";"west";0;0;0;56,916666;9,166666
1671;"Limfjorden";"west";0;0;0;56,916666;9,166666
1672;"Limfjorden";"west";0;0;0;56,916666;9,166666
1673;"Limfjorden";"west";0;0;0;56,916666;9,166666
1674;"Limfjorden";"west";0;0;0;56,916666;9,166666
1675;"Limfjorden";"west";0;0;0;56,916666;9,166666
1676;"Limfjorden";"west";0;0;0;56,916666;9,166666
1677;"Limfjorden";"west";0;0;0;56,916666;9,166666
1678;"Limfjorden";"west";0;0;0;56,916666;9,166666
1679;"Limfjorden";"west";0;0;0;56,916666;9,166666
1680;"Limfjorden";"west";0;0;0;56,916666;9,166666
1681;"Limfjorden";"west";0;0;0;56,916666;9,166666
1682;"Limfjorden";"west";0;0;0;56,916666;9,166666
1683;"Limfjorden";"west";0;0;0;56,916666;9,166666
1684;"Limfjorden";"west";0;0;0;56,916666;9,166666
1685;"Limfjorden";"west";0;0;0;56,916666;9,166666
1686;"Limfjorden";"west";0;0;0;56,916666;9,166666
1687;"Limfjorden";"west";0;0;0;56,916666;9,166666
1688;"Limfjorden";"west";0;0;0;56,916666;9,166666
1689;"Limfjorden";"west";0;0;0;56,916666;9,166666
1690;"Limfjorden";"west";0;0;0;56,916666;9,166666
1691;"Limfjorden";"west";0;0;0;56,916666;9,166666
1692;"Limfjorden";"west";0;0;0;56,916666;9,166666
1693;"Limfjorden";"west";0;0;0;56,916666;9,166666
1694;"Limfjorden";"west";0;0;0;56,916666;9,166666
1695;"Limfjorden";"west";0;0;0;56,916666;9,166666
1696;"Limfjorden";"west";0;0;0;56,916666;9,166666
1697;"Limfjorden";"west";0;0;0;56,916666;9,166666
1698;"Limfjorden";"west";0;0;0;56,916666;9,166666
1699;"Limfjorden";"west";0;0;0;56,916666;9,166666
1700;"Limfjorden";"west";0;0;0;56,916666;9,166666
1701;"Limfjorden";"west";0;0;0;56,916666;9,166666
1702;"Limfjorden";"west";0;0;0;56,916666;9,166666
1703;"Limfjorden";"west";0;0;0;56,916666;9,166666
1704;"Limfjorden";"west";0;0;0;56,916666;9,166666
1705;"Limfjorden";"west";0;0;0;56,916666;9,166666
1706;"Limfjorden";"west";0;0;0;56,916666;9,166666
1707;"Limfjorden";"west";0;0;0;56,916666;9,166666
1708;"Limfjorden";"west";0;0;0;56,916666;9,166666
1709;"Limfjorden";"west";0;0;0;56,916666;9,166666
1710;"Limfjorden";"west";0;0;0;56,916666;9,166666
1711;"Limfjorden";"west";0;0;0;56,916666;9,166666
1712;"Limfjorden";"west";0;0;0;56,916666;9,166666
1713;"Limfjorden";"west";0;0;0;56,916666;9,166666
1714;"Limfjorden";"west";0;0;0;56,916666;9,166666
1715;"Limfjorden";"west";0;0;0;56,916666;9,166666
1716;"Limfjorden";"west";0;0;0;56,916666;9,166666
1717;"Limfjorden";"west";0;0;0;56,916666;9,166666
1718;"Limfjorden";"west";0;0;0;56,916666;9,166666
1719;"Limfjorden";"west";0;0;0;56,916666;9,166666
1720;"Limfjorden";"west";0;0;0;56,916666;9,166666
1721;"Limfjorden";"west";0;0;0;56,916666;9,166666
1722;"Limfjorden";"west";0;0;0;56,916666;9,166666
1723;"Limfjorden";"west";0;0;0;56,916666;9,166666
1724;"Limfjorden";"west";0;0;0;56,916666;9,166666
1725;"Limfjorden";"west";0;0;0;56,916666;9,166666
1726;"Limfjorden";"west";0;0;0;56,916666;9,166666
1727;"Limfjorden";"west";0;0;0;56,916666;9,166666
1728;"Limfjorden";"west";0;0;0;56,916666;9,166666
1729;"Limfjorden";"west";0;0;0;56,916666;9,166666
1730;"Limfjorden";"west";0;0;0;56,916666;9,166666
1731;"Limfjorden";"west";0;0;0;56,916666;9,166666
1732;"Limfjorden";"west";0;0;0;56,916666;9,166666
1733;"Limfjorden";"west";0;0;0;56,916666;9,166666
1734;"Limfjorden";"west";0;0;0;56,916666;9,166666
1735;"Limfjorden";"west";0;0;0;56,916666;9,166666
1736;"Limfjorden";"west";0;0;0;56,916666;9,166666
1737;"Limfjorden";"west";0;0;0;56,916666;9,166666
1738;"Limfjorden";"west";0;0;0;56,916666;9,166666
1739;"Limfjorden";"west";0;0;0;56,916666;9,166666
1740;"Limfjorden";"west";0;0;0;56,916666;9,166666
1741;"Limfjorden";"west";0;0;0;56,916666;9,166666
1742;"Limfjorden";"west";0;0;0;56,916666;9,166666
1743;"Limfjorden";"west";0;0;0;56,916666;9,166666
1744;"Limfjorden";"west";0;0;0;56,916666;9,166666
1745;"Limfjorden";"west";0;0;0;56,916666;9,166666
1746;"Limfjorden";"west";0;0;0;56,916666;9,166666
1747;"Limfjorden";"west";0;0;0;56,916666;9,166666
1748;"Limfjorden";"west";0;0;0;56,916666;9,166666
1749;"Limfjorden";"west";0;0;0;56,916666;9,166666
1750;"Limfjorden";"west";0;0;0;56,916666;9,166666
1751;"Limfjorden";"west";0;0;0;56,916666;9,166666
1752;"Limfjorden";"west";0;0;0;56,916666;9,166666
1753;"Limfjorden";"west";0;0;0;56,916666;9,166666
1754;"Limfjorden";"west";0;0;0;56,916666;9,166666
1755;"Limfjorden";"west";0;0;0;56,916666;9,166666
1756;"Limfjorden";"west";0;0;0;56,916666;9,166666
1757;"Limfjorden";"west";0;0;0;56,916666;9,166666
1758;"Limfjorden";"west";0;0;0;56,916666;9,166666
1759;"Limfjorden";"west";0;0;0;56,916666;9,166666
1760;"Limfjorden";"west";0;0;0;56,916666;9,166666
1761;"Limfjorden";"west";0;0;0;56,916666;9,166666
1762;"Limfjorden";"west";0;0;0;56,916666;9,166666
1763;"Limfjorden";"west";0;0;0;56,916666;9,166666
1764;"Limfjorden";"west";0;0;0;56,916666;9,166666
1765;"Limfjorden";"west";0;0;0;56,916666;9,166666
1766;"Limfjorden";"west";0;0;0;56,916666;9,166666
1767;"Limfjorden";"west";0;0;0;56,916666;9,166666
1768;"Limfjorden";"west";0;0;0;56,916666;9,166666
1769;"Limfjorden";"west";0;0;0;56,916666;9,166666
1770;"Limfjorden";"west";0;0;0;56,916666;9,166666
1771;"Limfjorden";"west";0;0;0;56,916666;9,166666
1772;"Limfjorden";"west";0;0;0;56,916666;9,166666
1773;"Limfjorden";"west";0;0;0;56,916666;9,166666
1774;"Limfjorden";"west";0;0;0;56,916666;9,166666
1775;"Limfjorden";"west";0;0;0;56,916666;9,166666
1776;"Limfjorden";"west";0;0;0;56,916666;9,166666
1777;"Limfjorden";"west";0;0;0;56,916666;9,166666
1778;"Limfjorden";"west";0;0;0;56,916666;9,166666
1779;"Limfjorden";"west";0;0;0;56,916666;9,166666
1780;"Limfjorden";"west";0;0;0;56,916666;9,166666
1781;"Limfjorden";"west";0;0;0;56,916666;9,166666
1782;"Limfjorden";"west";0;0;0;56,916666;9,166666
1783;"Limfjorden";"west";0;0;0;56,916666;9,166666
1784;"Limfjorden";"west";0;0;0;56,916666;9,166666
1785;"Limfjorden";"west";0;0;0;56,916666;9,166666
1786;"Limfjorden";"west";0;0;0;56,916666;9,166666
1787;"Limfjorden";"west";0;0;0;56,916666;9,166666
1788;"Limfjorden";"west";0;0;0;56,916666;9,166666
1789;"Limfjorden";"west";0;0;0;56,916666;9,166666
1790;"Limfjorden";"west";0;0;0;56,916666;9,166666
1791;"Limfjorden";"west";0;0;0;56,916666;9,166666
1792;"Limfjorden";"west";0;0;0;56,916666;9,166666
1793;"Limfjorden";"west";0;0;0;56,916666;9,166666
1794;"Limfjorden";"west";0;0;0;56,916666;9,166666
1795;"Limfjorden";"west";0;0;0;56,916666;9,166666
1796;"Limfjorden";"west";0;0;0;56,916666;9,166666
1797;"Limfjorden";"west";0;0;0;56,916666;9,166666
1798;"Limfjorden";"west";0;0;0;56,916666;9,166666
1799;"Limfjorden";"west";0;0;0;56,916666;9,166666
1800;"Limfjorden";"west";0;0;0;56,916666;9,166666
1801;"Limfjorden";"west";0;0;0;56,916666;9,166666
1802;"Limfjorden";"west";0;0;0;56,916666;9,166666
1803;"Limfjorden";"west";0;0;0;56,916666;9,166666
1804;"Limfjorden";"west";0;0;0;56,916666;9,166666
1805;"Limfjorden";"west";0;0;0;56,916666;9,166666
1806;"Limfjorden";"west";0;0;0;56,916666;9,166666
1807;"Limfjorden";"west";0;0;0;56,916666;9,166666
1808;"Limfjorden";"west";0;0;0;56,916666;9,166666
1809;"Limfjorden";"west";0;0;0;56,916666;9,166666
1810;"Limfjorden";"west";0;0;0;56,916666;9,166666
1811;"Limfjorden";"west";0;0;0;56,916666;9,166666
1812;"Limfjorden";"west";0;0;0;56,916666;9,166666
1813;"Limfjorden";"west";0;0;0;56,916666;9,166666
1814;"Limfjorden";"west";0;0;0;56,916666;9,166666
1815;"Limfjorden";"west";0;0;0;56,916666;9,166666
1816;"Limfjorden";"west";0;0;0;56,916666;9,166666
1817;"Limfjorden";"west";0;0;0;56,916666;9,166666
1818;"Limfjorden";"west";0;0;0;56,916666;9,166666
1819;"Limfjorden";"west";0;0;0;56,916666;9,166666
1820;"Limfjorden";"west";0;0;0;56,916666;9,166666
1821;"Limfjorden";"west";0;0;0;56,916666;9,166666
1822;"Limfjorden";"west";0;0;0;56,916666;9,166666
1823;"Limfjorden";"west";0;0;0;56,916666;9,166666
1824;"Limfjorden";"west";0;0;0;56,916666;9,166666
1825;"Limfjorden";"west";0;0;0;56,916666;9,166666
1826;"Limfjorden";"west";0;0;0;56,916666;9,166666
1827;"Limfjorden";"west";0;0;0;56,916666;9,166666
1828;"Limfjorden";"west";0;0;0;56,916666;9,166666
1829;"Limfjorden";"west";0;0;0;56,916666;9,166666
1830;"Limfjorden";"west";0;0;0;56,916666;9,166666
1831;"Limfjorden";"west";0;0;0;56,916666;9,166666
1832;"Limfjorden";"west";0;0;0;56,916666;9,166666
1833;"Limfjorden";"west";0;0;0;56,916666;9,166666
1834;"Limfjorden";"west";0;0;0;56,916666;9,166666
1835;"Limfjorden";"west";0;0;0;56,916666;9,166666
1836;"Limfjorden";"west";0;0;0;56,916666;9,166666
1837;"Limfjorden";"west";0;0;0;56,916666;9,166666
1838;"Limfjorden";"west";0;0;0;56,916666;9,166666
1839;"Limfjorden";"west";0;0;0;56,916666;9,166666
1840;"Limfjorden";"west";0;0;0;56,916666;9,166666
1841;"Limfjorden";"west";0;0;0;56,916666;9,166666
1842;"Limfjorden";"west";0;0;0;56,916666;9,166666
1843;"Limfjorden";"west";0;0;0;56,916666;9,166666
1844;"Limfjorden";"west";0;1;1;56,916666;9,166666
1845;"Limfjorden";"west";0;0;0;56,916666;9,166666
1846;"Limfjorden";"west";0;2;2;56,916666;9,166666
1847;"Limfjorden";"west";0;0;0;56,916666;9,166666
1848;"Limfjorden";"west";0;0;0;56,916666;9,166666
1849;"Limfjorden";"west";0;0;0;56,916666;9,166666
1850;"Limfjorden";"west";0;2;2;56,916666;9,166666
1851;"Limfjorden";"west";0;1;1;56,916666;9,166666
1852;"Limfjorden";"west";0;0;0;56,916666;9,166666
1853;"Limfjorden";"west";0;1;1;56,916666;9,166666
1854;"Limfjorden";"west";0;0;0;56,916666;9,166666
1855;"Limfjorden";"west";0;0;0;56,916666;9,166666
1856;"Limfjorden";"west";0;1;1;56,916666;9,166666
1857;"Limfjorden";"west";0;0;0;56,916666;9,166666
1634;"Bøgeskov";"no";0;0;0;56,022777;10,095
1635;"Bøgeskov";"no";0;0;0;56,022777;10,095
1636;"Bøgeskov";"no";0;0;0;56,022777;10,095
1637;"Bøgeskov";"no";0;0;0;56,022777;10,095
1638;"Bøgeskov";"no";0;0;0;56,022777;10,095
1639;"Bøgeskov";"no";0;0;0;56,022777;10,095
1640;"Bøgeskov";"no";0;0;0;56,022777;10,095
1641;"Bøgeskov";"no";0;0;0;56,022777;10,095
1642;"Bøgeskov";"no";0;0;0;56,022777;10,095
1643;"Bøgeskov";"no";0;0;0;56,022777;10,095
1644;"Bøgeskov";"no";0;0;0;56,022777;10,095
1645;"Bøgeskov";"no";0;0;0;56,022777;10,095
1646;"Bøgeskov";"no";0;0;0;56,022777;10,095
1647;"Bøgeskov";"no";0;0;0;56,022777;10,095
1648;"Bøgeskov";"no";0;0;0;56,022777;10,095
1649;"Bøgeskov";"no";0;0;0;56,022777;10,095
1650;"Bøgeskov";"no";0;0;0;56,022777;10,095
1651;"Bøgeskov";"no";0;0;0;56,022777;10,095
1652;"Bøgeskov";"no";0;0;0;56,022777;10,095
1653;"Bøgeskov";"no";0;0;0;56,022777;10,095
1654;"Bøgeskov";"no";0;0;0;56,022777;10,095
1655;"Bøgeskov";"no";0;0;0;56,022777;10,095
1656;"Bøgeskov";"no";0;0;0;56,022777;10,095
1657;"Bøgeskov";"no";0;0;0;56,022777;10,095
1658;"Bøgeskov";"no";0;0;0;56,022777;10,095
1659;"Bøgeskov";"no";0;0;0;56,022777;10,095
1660;"Bøgeskov";"no";0;0;0;56,022777;10,095
1661;"Bøgeskov";"no";0;0;0;56,022777;10,095
1662;"Bøgeskov";"no";0;0;0;56,022777;10,095
1663;"Bøgeskov";"no";0;0;0;56,022777;10,095
1664;"Bøgeskov";"no";0;0;0;56,022777;10,095
1665;"Bøgeskov";"no";0;0;0;56,022777;10,095
1666;"Bøgeskov";"no";0;0;0;56,022777;10,095
1667;"Bøgeskov";"no";0;0;0;56,022777;10,095
1668;"Bøgeskov";"no";0;0;0;56,022777;10,095
1669;"Bøgeskov";"no";0;0;0;56,022777;10,095
1670;"Bøgeskov";"no";0;0;0;56,022777;10,095
1671;"Bøgeskov";"no";0;0;0;56,022777;10,095
1672;"Bøgeskov";"no";0;0;0;56,022777;10,095
1673;"Bøgeskov";"no";0;0;0;56,022777;10,095
1674;"Bøgeskov";"no";0;0;0;56,022777;10,095
1675;"Bøgeskov";"no";0;0;0;56,022777;10,095
1676;"Bøgeskov";"no";0;0;0;56,022777;10,095
1677;"Bøgeskov";"no";0;0;0;56,022777;10,095
1678;"Bøgeskov";"no";0;0;0;56,022777;10,095
1679;"Bøgeskov";"no";0;0;0;56,022777;10,095
1680;"Bøgeskov";"no";0;0;0;56,022777;10,095
1681;"Bøgeskov";"no";0;0;0;56,022777;10,095
1682;"Bøgeskov";"no";0;0;0;56,022777;10,095
1683;"Bøgeskov";"no";0;0;0;56,022777;10,095
1684;"Bøgeskov";"no";0;0;0;56,022777;10,095
1685;"Bøgeskov";"no";0;0;0;56,022777;10,095
1686;"Bøgeskov";"no";0;0;0;56,022777;10,095
1687;"Bøgeskov";"no";0;0;0;56,022777;10,095
1688;"Bøgeskov";"no";0;0;0;56,022777;10,095
1689;"Bøgeskov";"no";0;0;0;56,022777;10,095
1690;"Bøgeskov";"no";0;0;0;56,022777;10,095
1691;"Bøgeskov";"no";0;0;0;56,022777;10,095
1692;"Bøgeskov";"no";0;0;0;56,022777;10,095
1693;"Bøgeskov";"no";0;0;0;56,022777;10,095
1694;"Bøgeskov";"no";0;0;0;56,022777;10,095
1695;"Bøgeskov";"no";0;0;0;56,022777;10,095
1696;"Bøgeskov";"no";0;0;0;56,022777;10,095
1697;"Bøgeskov";"no";0;0;0;56,022777;10,095
1698;"Bøgeskov";"no";0;0;0;56,022777;10,095
1699;"Bøgeskov";"no";0;0;0;56,022777;10,095
1700;"Bøgeskov";"no";0;0;0;56,022777;10,095
1701;"Bøgeskov";"no";0;0;0;56,022777;10,095
1702;"Bøgeskov";"no";0;0;0;56,022777;10,095
1703;"Bøgeskov";"no";0;0;0;56,022777;10,095
1704;"Bøgeskov";"no";0;0;0;56,022777;10,095
1705;"Bøgeskov";"no";0;0;0;56,022777;10,095
1706;"Bøgeskov";"no";0;0;0;56,022777;10,095
1707;"Bøgeskov";"no";0;0;0;56,022777;10,095
1708;"Bøgeskov";"no";0;0;0;56,022777;10,095
1709;"Bøgeskov";"no";0;0;0;56,022777;10,095
1710;"Bøgeskov";"no";0;0;0;56,022777;10,095
1711;"Bøgeskov";"no";0;0;0;56,022777;10,095
1712;"Bøgeskov";"no";0;0;0;56,022777;10,095
1713;"Bøgeskov";"no";0;0;0;56,022777;10,095
1714;"Bøgeskov";"no";0;0;0;56,022777;10,095
1715;"Bøgeskov";"no";0;0;0;56,022777;10,095
1716;"Bøgeskov";"no";0;0;0;56,022777;10,095
1717;"Bøgeskov";"no";0;0;0;56,022777;10,095
1718;"Bøgeskov";"no";0;0;0;56,022777;10,095
1719;"Bøgeskov";"no";0;0;0;56,022777;10,095
1720;"Bøgeskov";"no";0;0;0;56,022777;10,095
1721;"Bøgeskov";"no";0;0;0;56,022777;10,095
1722;"Bøgeskov";"no";0;0;0;56,022777;10,095
1723;"Bøgeskov";"no";0;0;0;56,022777;10,095
1724;"Bøgeskov";"no";0;0;0;56,022777;10,095
1725;"Bøgeskov";"no";0;0;0;56,022777;10,095
1726;"Bøgeskov";"no";0;0;0;56,022777;10,095
1727;"Bøgeskov";"no";0;0;0;56,022777;10,095
1728;"Bøgeskov";"no";0;0;0;56,022777;10,095
1729;"Bøgeskov";"no";0;0;0;56,022777;10,095
1730;"Bøgeskov";"no";0;0;0;56,022777;10,095
1731;"Bøgeskov";"no";0;0;0;56,022777;10,095
1732;"Bøgeskov";"no";0;0;0;56,022777;10,095
1733;"Bøgeskov";"no";0;0;0;56,022777;10,095
1734;"Bøgeskov";"no";0;0;0;56,022777;10,095
1735;"Bøgeskov";"no";0;0;0;56,022777;10,095
1736;"Bøgeskov";"no";0;0;0;56,022777;10,095
1737;"Bøgeskov";"no";0;0;0;56,022777;10,095
1738;"Bøgeskov";"no";0;0;0;56,022777;10,095
1739;"Bøgeskov";"no";0;0;0;56,022777;10,095
1740;"Bøgeskov";"no";0;0;0;56,022777;10,095
1741;"Bøgeskov";"no";0;0;0;56,022777;10,095
1742;"Bøgeskov";"no";0;0;0;56,022777;10,095
1743;"Bøgeskov";"no";0;0;0;56,022777;10,095
1744;"Bøgeskov";"no";0;0;0;56,022777;10,095
1745;"Bøgeskov";"no";0;0;0;56,022777;10,095
1746;"Bøgeskov";"no";0;0;0;56,022777;10,095
1747;"Bøgeskov";"no";0;0;0;56,022777;10,095
1748;"Bøgeskov";"no";0;0;0;56,022777;10,095
1749;"Bøgeskov";"no";0;0;0;56,022777;10,095
1750;"Bøgeskov";"no";0;0;0;56,022777;10,095
1751;"Bøgeskov";"no";0;0;0;56,022777;10,095
1752;"Bøgeskov";"no";0;0;0;56,022777;10,095
1753;"Bøgeskov";"no";0;0;0;56,022777;10,095
1754;"Bøgeskov";"no";0;0;0;56,022777;10,095
1755;"Bøgeskov";"no";0;0;0;56,022777;10,095
1756;"Bøgeskov";"no";0;0;0;56,022777;10,095
1757;"Bøgeskov";"no";0;0;0;56,022777;10,095
1758;"Bøgeskov";"no";0;0;0;56,022777;10,095
1759;"Bøgeskov";"no";0;0;0;56,022777;10,095
1760;"Bøgeskov";"no";0;0;0;56,022777;10,095
1761;"Bøgeskov";"no";0;0;0;56,022777;10,095
1762;"Bøgeskov";"no";0;0;0;56,022777;10,095
1763;"Bøgeskov";"no";0;0;0;56,022777;10,095
1764;"Bøgeskov";"no";0;0;0;56,022777;10,095
1765;"Bøgeskov";"no";0;0;0;56,022777;10,095
1766;"Bøgeskov";"no";0;0;0;56,022777;10,095
1767;"Bøgeskov";"no";0;0;0;56,022777;10,095
1768;"Bøgeskov";"no";0;0;0;56,022777;10,095
1769;"Bøgeskov";"no";0;0;0;56,022777;10,095
1770;"Bøgeskov";"no";0;0;0;56,022777;10,095
1771;"Bøgeskov";"no";0;0;0;56,022777;10,095
1772;"Bøgeskov";"no";0;0;0;56,022777;10,095
1773;"Bøgeskov";"no";0;0;0;56,022777;10,095
1774;"Bøgeskov";"no";0;0;0;56,022777;10,095
1775;"Bøgeskov";"no";0;0;0;56,022777;10,095
1776;"Bøgeskov";"no";0;0;0;56,022777;10,095
1777;"Bøgeskov";"no";0;0;0;56,022777;10,095
1778;"Bøgeskov";"no";0;0;0;56,022777;10,095
1779;"Bøgeskov";"no";0;0;0;56,022777;10,095
1780;"Bøgeskov";"no";0;0;0;56,022777;10,095
1781;"Bøgeskov";"no";0;0;0;56,022777;10,095
1782;"Bøgeskov";"no";0;0;0;56,022777;10,095
1783;"Bøgeskov";"no";0;0;0;56,022777;10,095
1784;"Bøgeskov";"no";0;0;0;56,022777;10,095
1785;"Bøgeskov";"no";0;0;0;56,022777;10,095
1786;"Bøgeskov";"no";0;0;0;56,022777;10,095
1787;"Bøgeskov";"no";0;0;0;56,022777;10,095
1788;"Bøgeskov";"no";0;0;0;56,022777;10,095
1789;"Bøgeskov";"no";0;0;0;56,022777;10,095
1790;"Bøgeskov";"no";0;0;0;56,022777;10,095
1791;"Bøgeskov";"no";0;0;0;56,022777;10,095
1792;"Bøgeskov";"no";0;0;0;56,022777;10,095
1793;"Bøgeskov";"no";0;0;0;56,022777;10,095
1794;"Bøgeskov";"no";0;0;0;56,022777;10,095
1795;"Bøgeskov";"no";0;0;0;56,022777;10,095
1796;"Bøgeskov";"no";0;0;0;56,022777;10,095
1797;"Bøgeskov";"no";0;0;0;56,022777;10,095
1798;"Bøgeskov";"no";0;0;0;56,022777;10,095
1799;"Bøgeskov";"no";0;0;0;56,022777;10,095
1800;"Bøgeskov";"no";0;0;0;56,022777;10,095
1801;"Bøgeskov";"no";0;0;0;56,022777;10,095
1802;"Bøgeskov";"no";0;0;0;56,022777;10,095
1803;"Bøgeskov";"no";0;0;0;56,022777;10,095
1804;"Bøgeskov";"no";0;0;0;56,022777;10,095
1805;"Bøgeskov";"no";0;0;0;56,022777;10,095
1806;"Bøgeskov";"no";0;0;0;56,022777;10,095
1807;"Bøgeskov";"no";0;0;0;56,022777;10,095
1808;"Bøgeskov";"no";0;0;0;56,022777;10,095
1809;"Bøgeskov";"no";0;0;0;56,022777;10,095
1810;"Bøgeskov";"no";0;0;0;56,022777;10,095
1811;"Bøgeskov";"no";0;0;0;56,022777;10,095
1812;"Bøgeskov";"no";0;0;0;56,022777;10,095
1813;"Bøgeskov";"no";0;0;0;56,022777;10,095
1814;"Bøgeskov";"no";0;0;0;56,022777;10,095
1815;"Bøgeskov";"no";0;0;0;56,022777;10,095
1816;"Bøgeskov";"no";0;0;0;56,022777;10,095
1817;"Bøgeskov";"no";0;0;0;56,022777;10,095
1818;"Bøgeskov";"no";0;0;0;56,022777;10,095
1819;"Bøgeskov";"no";0;0;0;56,022777;10,095
1820;"Bøgeskov";"no";0;0;0;56,022777;10,095
1821;"Bøgeskov";"no";0;0;0;56,022777;10,095
1822;"Bøgeskov";"no";0;0;0;56,022777;10,095
1823;"Bøgeskov";"no";0;0;0;56,022777;10,095
1824;"Bøgeskov";"no";0;0;0;56,022777;10,095
1825;"Bøgeskov";"no";0;0;0;56,022777;10,095
1826;"Bøgeskov";"no";0;0;0;56,022777;10,095
1827;"Bøgeskov";"no";0;0;0;56,022777;10,095
1828;"Bøgeskov";"no";0;0;0;56,022777;10,095
1829;"Bøgeskov";"no";0;0;0;56,022777;10,095
1830;"Bøgeskov";"no";0;0;0;56,022777;10,095
1831;"Bøgeskov";"no";0;0;0;56,022777;10,095
1832;"Bøgeskov";"no";0;0;0;56,022777;10,095
1833;"Bøgeskov";"no";0;0;0;56,022777;10,095
1834;"Bøgeskov";"no";0;0;0;56,022777;10,095
1835;"Bøgeskov";"no";0;0;0;56,022777;10,095
1836;"Bøgeskov";"no";0;0;0;56,022777;10,095
1837;"Bøgeskov";"no";0;0;0;56,022777;10,095
1838;"Bøgeskov";"no";0;0;0;56,022777;10,095
1839;"Bøgeskov";"no";0;0;0;56,022777;10,095
1840;"Bøgeskov";"no";0;0;0;56,022777;10,095
1841;"Bøgeskov";"no";0;0;0;56,022777;10,095
1842;"Bøgeskov";"no";0;0;0;56,022777;10,095
1843;"Bøgeskov";"no";0;0;0;56,022777;10,095
1844;"Bøgeskov";"no";0;0;0;56,022777;10,095
1845;"Bøgeskov";"no";0;0;0;56,022777;10,095
1846;"Bøgeskov";"no";0;1;1;56,022777;10,095
1847;"Bøgeskov";"no";0;0;0;56,022777;10,095
1848;"Bøgeskov";"no";0;0;0;56,022777;10,095
1849;"Bøgeskov";"no";0;0;0;56,022777;10,095
1850;"Bøgeskov";"no";0;0;0;56,022777;10,095
1851;"Bøgeskov";"no";0;0;0;56,022777;10,095
1852;"Bøgeskov";"no";0;0;0;56,022777;10,095
1853;"Bøgeskov";"no";0;0;0;56,022777;10,095
1854;"Bøgeskov";"no";0;0;0;56,022777;10,095
1855;"Bøgeskov";"no";0;0;0;56,022777;10,095
1856;"Bøgeskov";"no";0;0;0;56,022777;10,095
1857;"Bøgeskov";"no";0;0;0;56,022777;10,095
1634;"Skøttrup";"no";0;0;0;57,372777;9,759722
1635;"Skøttrup";"no";0;0;0;57,372777;9,759722
1636;"Skøttrup";"no";0;0;0;57,372777;9,759722
1637;"Skøttrup";"no";0;0;0;57,372777;9,759722
1638;"Skøttrup";"no";0;0;0;57,372777;9,759722
1639;"Skøttrup";"no";0;0;0;57,372777;9,759722
1640;"Skøttrup";"no";0;0;0;57,372777;9,759722
1641;"Skøttrup";"no";0;0;0;57,372777;9,759722
1642;"Skøttrup";"no";0;0;0;57,372777;9,759722
1643;"Skøttrup";"no";0;0;0;57,372777;9,759722
1644;"Skøttrup";"no";0;0;0;57,372777;9,759722
1645;"Skøttrup";"no";0;0;0;57,372777;9,759722
1646;"Skøttrup";"no";0;0;0;57,372777;9,759722
1647;"Skøttrup";"no";0;0;0;57,372777;9,759722
1648;"Skøttrup";"no";0;0;0;57,372777;9,759722
1649;"Skøttrup";"no";0;0;0;57,372777;9,759722
1650;"Skøttrup";"no";0;0;0;57,372777;9,759722
1651;"Skøttrup";"no";0;0;0;57,372777;9,759722
1652;"Skøttrup";"no";0;0;0;57,372777;9,759722
1653;"Skøttrup";"no";0;0;0;57,372777;9,759722
1654;"Skøttrup";"no";0;0;0;57,372777;9,759722
1655;"Skøttrup";"no";0;0;0;57,372777;9,759722
1656;"Skøttrup";"no";0;0;0;57,372777;9,759722
1657;"Skøttrup";"no";0;0;0;57,372777;9,759722
1658;"Skøttrup";"no";0;0;0;57,372777;9,759722
1659;"Skøttrup";"no";0;0;0;57,372777;9,759722
1660;"Skøttrup";"no";0;0;0;57,372777;9,759722
1661;"Skøttrup";"no";0;0;0;57,372777;9,759722
1662;"Skøttrup";"no";0;0;0;57,372777;9,759722
1663;"Skøttrup";"no";0;0;0;57,372777;9,759722
1664;"Skøttrup";"no";0;0;0;57,372777;9,759722
1665;"Skøttrup";"no";0;0;0;57,372777;9,759722
1666;"Skøttrup";"no";0;0;0;57,372777;9,759722
1667;"Skøttrup";"no";0;0;0;57,372777;9,759722
1668;"Skøttrup";"no";0;0;0;57,372777;9,759722
1669;"Skøttrup";"no";0;0;0;57,372777;9,759722
1670;"Skøttrup";"no";0;0;0;57,372777;9,759722
1671;"Skøttrup";"no";0;0;0;57,372777;9,759722
1672;"Skøttrup";"no";0;0;0;57,372777;9,759722
1673;"Skøttrup";"no";0;0;0;57,372777;9,759722
1674;"Skøttrup";"no";0;0;0;57,372777;9,759722
1675;"Skøttrup";"no";0;0;0;57,372777;9,759722
1676;"Skøttrup";"no";0;0;0;57,372777;9,759722
1677;"Skøttrup";"no";0;0;0;57,372777;9,759722
1678;"Skøttrup";"no";0;0;0;57,372777;9,759722
1679;"Skøttrup";"no";0;0;0;57,372777;9,759722
1680;"Skøttrup";"no";0;0;0;57,372777;9,759722
1681;"Skøttrup";"no";0;0;0;57,372777;9,759722
1682;"Skøttrup";"no";0;0;0;57,372777;9,759722
1683;"Skøttrup";"no";0;0;0;57,372777;9,759722
1684;"Skøttrup";"no";0;0;0;57,372777;9,759722
1685;"Skøttrup";"no";0;0;0;57,372777;9,759722
1686;"Skøttrup";"no";0;0;0;57,372777;9,759722
1687;"Skøttrup";"no";0;0;0;57,372777;9,759722
1688;"Skøttrup";"no";0;0;0;57,372777;9,759722
1689;"Skøttrup";"no";0;0;0;57,372777;9,759722
1690;"Skøttrup";"no";0;0;0;57,372777;9,759722
1691;"Skøttrup";"no";0;0;0;57,372777;9,759722
1692;"Skøttrup";"no";0;0;0;57,372777;9,759722
1693;"Skøttrup";"no";0;0;0;57,372777;9,759722
1694;"Skøttrup";"no";0;0;0;57,372777;9,759722
1695;"Skøttrup";"no";0;0;0;57,372777;9,759722
1696;"Skøttrup";"no";0;0;0;57,372777;9,759722
1697;"Skøttrup";"no";0;0;0;57,372777;9,759722
1698;"Skøttrup";"no";0;0;0;57,372777;9,759722
1699;"Skøttrup";"no";0;0;0;57,372777;9,759722
1700;"Skøttrup";"no";0;0;0;57,372777;9,759722
1701;"Skøttrup";"no";0;0;0;57,372777;9,759722
1702;"Skøttrup";"no";0;0;0;57,372777;9,759722
1703;"Skøttrup";"no";0;0;0;57,372777;9,759722
1704;"Skøttrup";"no";0;0;0;57,372777;9,759722
1705;"Skøttrup";"no";0;0;0;57,372777;9,759722
1706;"Skøttrup";"no";0;0;0;57,372777;9,759722
1707;"Skøttrup";"no";0;0;0;57,372777;9,759722
1708;"Skøttrup";"no";0;0;0;57,372777;9,759722
1709;"Skøttrup";"no";0;0;0;57,372777;9,759722
1710;"Skøttrup";"no";0;0;0;57,372777;9,759722
1711;"Skøttrup";"no";0;0;0;57,372777;9,759722
1712;"Skøttrup";"no";0;0;0;57,372777;9,759722
1713;"Skøttrup";"no";0;0;0;57,372777;9,759722
1714;"Skøttrup";"no";0;0;0;57,372777;9,759722
1715;"Skøttrup";"no";0;0;0;57,372777;9,759722
1716;"Skøttrup";"no";0;0;0;57,372777;9,759722
1717;"Skøttrup";"no";0;0;0;57,372777;9,759722
1718;"Skøttrup";"no";0;0;0;57,372777;9,759722
1719;"Skøttrup";"no";0;0;0;57,372777;9,759722
1720;"Skøttrup";"no";0;0;0;57,372777;9,759722
1721;"Skøttrup";"no";0;0;0;57,372777;9,759722
1722;"Skøttrup";"no";0;0;0;57,372777;9,759722
1723;"Skøttrup";"no";0;0;0;57,372777;9,759722
1724;"Skøttrup";"no";0;0;0;57,372777;9,759722
1725;"Skøttrup";"no";0;0;0;57,372777;9,759722
1726;"Skøttrup";"no";0;0;0;57,372777;9,759722
1727;"Skøttrup";"no";0;0;0;57,372777;9,759722
1728;"Skøttrup";"no";0;0;0;57,372777;9,759722
1729;"Skøttrup";"no";0;0;0;57,372777;9,759722
1730;"Skøttrup";"no";0;0;0;57,372777;9,759722
1731;"Skøttrup";"no";0;0;0;57,372777;9,759722
1732;"Skøttrup";"no";0;0;0;57,372777;9,759722
1733;"Skøttrup";"no";0;0;0;57,372777;9,759722
1734;"Skøttrup";"no";0;0;0;57,372777;9,759722
1735;"Skøttrup";"no";0;0;0;57,372777;9,759722
1736;"Skøttrup";"no";0;0;0;57,372777;9,759722
1737;"Skøttrup";"no";0;0;0;57,372777;9,759722
1738;"Skøttrup";"no";0;0;0;57,372777;9,759722
1739;"Skøttrup";"no";0;0;0;57,372777;9,759722
1740;"Skøttrup";"no";0;0;0;57,372777;9,759722
1741;"Skøttrup";"no";0;0;0;57,372777;9,759722
1742;"Skøttrup";"no";0;0;0;57,372777;9,759722
1743;"Skøttrup";"no";0;0;0;57,372777;9,759722
1744;"Skøttrup";"no";0;0;0;57,372777;9,759722
1745;"Skøttrup";"no";0;0;0;57,372777;9,759722
1746;"Skøttrup";"no";0;0;0;57,372777;9,759722
1747;"Skøttrup";"no";0;0;0;57,372777;9,759722
1748;"Skøttrup";"no";0;0;0;57,372777;9,759722
1749;"Skøttrup";"no";0;0;0;57,372777;9,759722
1750;"Skøttrup";"no";0;0;0;57,372777;9,759722
1751;"Skøttrup";"no";0;0;0;57,372777;9,759722
1752;"Skøttrup";"no";0;0;0;57,372777;9,759722
1753;"Skøttrup";"no";0;0;0;57,372777;9,759722
1754;"Skøttrup";"no";0;0;0;57,372777;9,759722
1755;"Skøttrup";"no";0;0;0;57,372777;9,759722
1756;"Skøttrup";"no";0;0;0;57,372777;9,759722
1757;"Skøttrup";"no";0;0;0;57,372777;9,759722
1758;"Skøttrup";"no";0;0;0;57,372777;9,759722
1759;"Skøttrup";"no";0;0;0;57,372777;9,759722
1760;"Skøttrup";"no";0;0;0;57,372777;9,759722
1761;"Skøttrup";"no";0;0;0;57,372777;9,759722
1762;"Skøttrup";"no";0;0;0;57,372777;9,759722
1763;"Skøttrup";"no";0;0;0;57,372777;9,759722
1764;"Skøttrup";"no";0;0;0;57,372777;9,759722
1765;"Skøttrup";"no";0;0;0;57,372777;9,759722
1766;"Skøttrup";"no";0;0;0;57,372777;9,759722
1767;"Skøttrup";"no";0;0;0;57,372777;9,759722
1768;"Skøttrup";"no";0;0;0;57,372777;9,759722
1769;"Skøttrup";"no";0;0;0;57,372777;9,759722
1770;"Skøttrup";"no";0;0;0;57,372777;9,759722
1771;"Skøttrup";"no";0;0;0;57,372777;9,759722
1772;"Skøttrup";"no";0;0;0;57,372777;9,759722
1773;"Skøttrup";"no";0;0;0;57,372777;9,759722
1774;"Skøttrup";"no";0;0;0;57,372777;9,759722
1775;"Skøttrup";"no";0;0;0;57,372777;9,759722
1776;"Skøttrup";"no";0;0;0;57,372777;9,759722
1777;"Skøttrup";"no";0;0;0;57,372777;9,759722
1778;"Skøttrup";"no";0;0;0;57,372777;9,759722
1779;"Skøttrup";"no";0;0;0;57,372777;9,759722
1780;"Skøttrup";"no";0;0;0;57,372777;9,759722
1781;"Skøttrup";"no";0;0;0;57,372777;9,759722
1782;"Skøttrup";"no";0;0;0;57,372777;9,759722
1783;"Skøttrup";"no";0;0;0;57,372777;9,759722
1784;"Skøttrup";"no";0;0;0;57,372777;9,759722
1785;"Skøttrup";"no";0;0;0;57,372777;9,759722
1786;"Skøttrup";"no";0;0;0;57,372777;9,759722
1787;"Skøttrup";"no";0;0;0;57,372777;9,759722
1788;"Skøttrup";"no";0;0;0;57,372777;9,759722
1789;"Skøttrup";"no";0;0;0;57,372777;9,759722
1790;"Skøttrup";"no";0;0;0;57,372777;9,759722
1791;"Skøttrup";"no";0;0;0;57,372777;9,759722
1792;"Skøttrup";"no";0;0;0;57,372777;9,759722
1793;"Skøttrup";"no";0;0;0;57,372777;9,759722
1794;"Skøttrup";"no";0;0;0;57,372777;9,759722
1795;"Skøttrup";"no";0;0;0;57,372777;9,759722
1796;"Skøttrup";"no";0;0;0;57,372777;9,759722
1797;"Skøttrup";"no";0;0;0;57,372777;9,759722
1798;"Skøttrup";"no";0;0;0;57,372777;9,759722
1799;"Skøttrup";"no";0;0;0;57,372777;9,759722
1800;"Skøttrup";"no";0;0;0;57,372777;9,759722
1801;"Skøttrup";"no";0;0;0;57,372777;9,759722
1802;"Skøttrup";"no";0;0;0;57,372777;9,759722
1803;"Skøttrup";"no";0;0;0;57,372777;9,759722
1804;"Skøttrup";"no";0;0;0;57,372777;9,759722
1805;"Skøttrup";"no";0;0;0;57,372777;9,759722
1806;"Skøttrup";"no";0;0;0;57,372777;9,759722
1807;"Skøttrup";"no";0;0;0;57,372777;9,759722
1808;"Skøttrup";"no";0;0;0;57,372777;9,759722
1809;"Skøttrup";"no";0;0;0;57,372777;9,759722
1810;"Skøttrup";"no";0;0;0;57,372777;9,759722
1811;"Skøttrup";"no";0;0;0;57,372777;9,759722
1812;"Skøttrup";"no";0;0;0;57,372777;9,759722
1813;"Skøttrup";"no";0;0;0;57,372777;9,759722
1814;"Skøttrup";"no";0;0;0;57,372777;9,759722
1815;"Skøttrup";"no";0;0;0;57,372777;9,759722
1816;"Skøttrup";"no";0;0;0;57,372777;9,759722
1817;"Skøttrup";"no";0;0;0;57,372777;9,759722
1818;"Skøttrup";"no";0;0;0;57,372777;9,759722
1819;"Skøttrup";"no";0;0;0;57,372777;9,759722
1820;"Skøttrup";"no";0;0;0;57,372777;9,759722
1821;"Skøttrup";"no";0;0;0;57,372777;9,759722
1822;"Skøttrup";"no";0;0;0;57,372777;9,759722
1823;"Skøttrup";"no";0;0;0;57,372777;9,759722
1824;"Skøttrup";"no";0;0;0;57,372777;9,759722
1825;"Skøttrup";"no";0;0;0;57,372777;9,759722
1826;"Skøttrup";"no";0;0;0;57,372777;9,759722
1827;"Skøttrup";"no";0;0;0;57,372777;9,759722
1828;"Skøttrup";"no";0;0;0;57,372777;9,759722
1829;"Skøttrup";"no";0;0;0;57,372777;9,759722
1830;"Skøttrup";"no";0;0;0;57,372777;9,759722
1831;"Skøttrup";"no";0;0;0;57,372777;9,759722
1832;"Skøttrup";"no";0;0;0;57,372777;9,759722
1833;"Skøttrup";"no";0;0;0;57,372777;9,759722
1834;"Skøttrup";"no";0;0;0;57,372777;9,759722
1835;"Skøttrup";"no";0;0;0;57,372777;9,759722
1836;"Skøttrup";"no";0;0;0;57,372777;9,759722
1837;"Skøttrup";"no";0;0;0;57,372777;9,759722
1838;"Skøttrup";"no";0;0;0;57,372777;9,759722
1839;"Skøttrup";"no";0;0;0;57,372777;9,759722
1840;"Skøttrup";"no";0;0;0;57,372777;9,759722
1841;"Skøttrup";"no";0;0;0;57,372777;9,759722
1842;"Skøttrup";"no";0;0;0;57,372777;9,759722
1843;"Skøttrup";"no";0;0;0;57,372777;9,759722
1844;"Skøttrup";"no";0;0;0;57,372777;9,759722
1845;"Skøttrup";"no";0;0;0;57,372777;9,759722
1846;"Skøttrup";"no";0;1;1;57,372777;9,759722
1847;"Skøttrup";"no";0;0;0;57,372777;9,759722
1848;"Skøttrup";"no";0;0;0;57,372777;9,759722
1849;"Skøttrup";"no";0;0;0;57,372777;9,759722
1850;"Skøttrup";"no";0;0;0;57,372777;9,759722
1851;"Skøttrup";"no";0;0;0;57,372777;9,759722
1852;"Skøttrup";"no";0;0;0;57,372777;9,759722
1853;"Skøttrup";"no";0;0;0;57,372777;9,759722
1854;"Skøttrup";"no";0;0;0;57,372777;9,759722
1855;"Skøttrup";"no";0;0;0;57,372777;9,759722
1856;"Skøttrup";"no";0;0;0;57,372777;9,759722
1857;"Skøttrup";"no";0;0;0;57,372777;9,759722
1634;"Sydstranden";"no";0;0;0;55,584166;12,648888
1635;"Sydstranden";"no";0;0;0;55,584166;12,648888
1636;"Sydstranden";"no";0;0;0;55,584166;12,648888
1637;"Sydstranden";"no";0;0;0;55,584166;12,648888
1638;"Sydstranden";"no";0;0;0;55,584166;12,648888
1639;"Sydstranden";"no";0;0;0;55,584166;12,648888
1640;"Sydstranden";"no";0;0;0;55,584166;12,648888
1641;"Sydstranden";"no";0;0;0;55,584166;12,648888
1642;"Sydstranden";"no";0;0;0;55,584166;12,648888
1643;"Sydstranden";"no";0;0;0;55,584166;12,648888
1644;"Sydstranden";"no";0;0;0;55,584166;12,648888
1645;"Sydstranden";"no";0;0;0;55,584166;12,648888
1646;"Sydstranden";"no";0;0;0;55,584166;12,648888
1647;"Sydstranden";"no";0;0;0;55,584166;12,648888
1648;"Sydstranden";"no";0;0;0;55,584166;12,648888
1649;"Sydstranden";"no";0;0;0;55,584166;12,648888
1650;"Sydstranden";"no";0;0;0;55,584166;12,648888
1651;"Sydstranden";"no";0;0;0;55,584166;12,648888
1652;"Sydstranden";"no";0;0;0;55,584166;12,648888
1653;"Sydstranden";"no";0;0;0;55,584166;12,648888
1654;"Sydstranden";"no";0;0;0;55,584166;12,648888
1655;"Sydstranden";"no";0;0;0;55,584166;12,648888
1656;"Sydstranden";"no";0;0;0;55,584166;12,648888
1657;"Sydstranden";"no";0;0;0;55,584166;12,648888
1658;"Sydstranden";"no";0;0;0;55,584166;12,648888
1659;"Sydstranden";"no";0;0;0;55,584166;12,648888
1660;"Sydstranden";"no";0;0;0;55,584166;12,648888
1661;"Sydstranden";"no";0;0;0;55,584166;12,648888
1662;"Sydstranden";"no";0;0;0;55,584166;12,648888
1663;"Sydstranden";"no";0;0;0;55,584166;12,648888
1664;"Sydstranden";"no";0;0;0;55,584166;12,648888
1665;"Sydstranden";"no";0;0;0;55,584166;12,648888
1666;"Sydstranden";"no";0;0;0;55,584166;12,648888
1667;"Sydstranden";"no";0;0;0;55,584166;12,648888
1668;"Sydstranden";"no";0;0;0;55,584166;12,648888
1669;"Sydstranden";"no";0;0;0;55,584166;12,648888
1670;"Sydstranden";"no";0;0;0;55,584166;12,648888
1671;"Sydstranden";"no";0;0;0;55,584166;12,648888
1672;"Sydstranden";"no";0;0;0;55,584166;12,648888
1673;"Sydstranden";"no";0;0;0;55,584166;12,648888
1674;"Sydstranden";"no";0;0;0;55,584166;12,648888
1675;"Sydstranden";"no";0;0;0;55,584166;12,648888
1676;"Sydstranden";"no";0;0;0;55,584166;12,648888
1677;"Sydstranden";"no";0;0;0;55,584166;12,648888
1678;"Sydstranden";"no";0;0;0;55,584166;12,648888
1679;"Sydstranden";"no";0;0;0;55,584166;12,648888
1680;"Sydstranden";"no";0;0;0;55,584166;12,648888
1681;"Sydstranden";"no";0;0;0;55,584166;12,648888
1682;"Sydstranden";"no";0;0;0;55,584166;12,648888
1683;"Sydstranden";"no";0;0;0;55,584166;12,648888
1684;"Sydstranden";"no";0;0;0;55,584166;12,648888
1685;"Sydstranden";"no";0;0;0;55,584166;12,648888
1686;"Sydstranden";"no";0;0;0;55,584166;12,648888
1687;"Sydstranden";"no";0;0;0;55,584166;12,648888
1688;"Sydstranden";"no";0;0;0;55,584166;12,648888
1689;"Sydstranden";"no";0;0;0;55,584166;12,648888
1690;"Sydstranden";"no";0;0;0;55,584166;12,648888
1691;"Sydstranden";"no";0;0;0;55,584166;12,648888
1692;"Sydstranden";"no";0;0;0;55,584166;12,648888
1693;"Sydstranden";"no";0;0;0;55,584166;12,648888
1694;"Sydstranden";"no";0;0;0;55,584166;12,648888
1695;"Sydstranden";"no";0;0;0;55,584166;12,648888
1696;"Sydstranden";"no";0;0;0;55,584166;12,648888
1697;"Sydstranden";"no";0;0;0;55,584166;12,648888
1698;"Sydstranden";"no";0;0;0;55,584166;12,648888
1699;"Sydstranden";"no";0;0;0;55,584166;12,648888
1700;"Sydstranden";"no";0;0;0;55,584166;12,648888
1701;"Sydstranden";"no";0;0;0;55,584166;12,648888
1702;"Sydstranden";"no";0;0;0;55,584166;12,648888
1703;"Sydstranden";"no";0;0;0;55,584166;12,648888
1704;"Sydstranden";"no";0;0;0;55,584166;12,648888
1705;"Sydstranden";"no";0;0;0;55,584166;12,648888
1706;"Sydstranden";"no";0;0;0;55,584166;12,648888
1707;"Sydstranden";"no";0;0;0;55,584166;12,648888
1708;"Sydstranden";"no";0;0;0;55,584166;12,648888
1709;"Sydstranden";"no";0;0;0;55,584166;12,648888
1710;"Sydstranden";"no";0;0;0;55,584166;12,648888
1711;"Sydstranden";"no";0;0;0;55,584166;12,648888
1712;"Sydstranden";"no";0;0;0;55,584166;12,648888
1713;"Sydstranden";"no";0;0;0;55,584166;12,648888
1714;"Sydstranden";"no";0;0;0;55,584166;12,648888
1715;"Sydstranden";"no";0;0;0;55,584166;12,648888
1716;"Sydstranden";"no";0;0;0;55,584166;12,648888
1717;"Sydstranden";"no";0;0;0;55,584166;12,648888
1718;"Sydstranden";"no";0;0;0;55,584166;12,648888
1719;"Sydstranden";"no";0;0;0;55,584166;12,648888
1720;"Sydstranden";"no";0;0;0;55,584166;12,648888
1721;"Sydstranden";"no";0;0;0;55,584166;12,648888
1722;"Sydstranden";"no";0;0;0;55,584166;12,648888
1723;"Sydstranden";"no";0;0;0;55,584166;12,648888
1724;"Sydstranden";"no";0;0;0;55,584166;12,648888
1725;"Sydstranden";"no";0;0;0;55,584166;12,648888
1726;"Sydstranden";"no";0;0;0;55,584166;12,648888
1727;"Sydstranden";"no";0;0;0;55,584166;12,648888
1728;"Sydstranden";"no";0;0;0;55,584166;12,648888
1729;"Sydstranden";"no";0;0;0;55,584166;12,648888
1730;"Sydstranden";"no";0;0;0;55,584166;12,648888
1731;"Sydstranden";"no";0;0;0;55,584166;12,648888
1732;"Sydstranden";"no";0;0;0;55,584166;12,648888
1733;"Sydstranden";"no";0;0;0;55,584166;12,648888
1734;"Sydstranden";"no";0;0;0;55,584166;12,648888
1735;"Sydstranden";"no";0;0;0;55,584166;12,648888
1736;"Sydstranden";"no";0;0;0;55,584166;12,648888
1737;"Sydstranden";"no";0;0;0;55,584166;12,648888
1738;"Sydstranden";"no";0;0;0;55,584166;12,648888
1739;"Sydstranden";"no";0;0;0;55,584166;12,648888
1740;"Sydstranden";"no";0;0;0;55,584166;12,648888
1741;"Sydstranden";"no";0;0;0;55,584166;12,648888
1742;"Sydstranden";"no";0;0;0;55,584166;12,648888
1743;"Sydstranden";"no";0;0;0;55,584166;12,648888
1744;"Sydstranden";"no";0;0;0;55,584166;12,648888
1745;"Sydstranden";"no";0;0;0;55,584166;12,648888
1746;"Sydstranden";"no";0;0;0;55,584166;12,648888
1747;"Sydstranden";"no";0;0;0;55,584166;12,648888
1748;"Sydstranden";"no";0;0;0;55,584166;12,648888
1749;"Sydstranden";"no";0;0;0;55,584166;12,648888
1750;"Sydstranden";"no";0;0;0;55,584166;12,648888
1751;"Sydstranden";"no";0;0;0;55,584166;12,648888
1752;"Sydstranden";"no";0;0;0;55,584166;12,648888
1753;"Sydstranden";"no";0;0;0;55,584166;12,648888
1754;"Sydstranden";"no";0;0;0;55,584166;12,648888
1755;"Sydstranden";"no";0;0;0;55,584166;12,648888
1756;"Sydstranden";"no";0;0;0;55,584166;12,648888
1757;"Sydstranden";"no";0;0;0;55,584166;12,648888
1758;"Sydstranden";"no";0;0;0;55,584166;12,648888
1759;"Sydstranden";"no";0;0;0;55,584166;12,648888
1760;"Sydstranden";"no";0;0;0;55,584166;12,648888
1761;"Sydstranden";"no";0;0;0;55,584166;12,648888
1762;"Sydstranden";"no";0;0;0;55,584166;12,648888
1763;"Sydstranden";"no";0;0;0;55,584166;12,648888
1764;"Sydstranden";"no";0;0;0;55,584166;12,648888
1765;"Sydstranden";"no";0;0;0;55,584166;12,648888
1766;"Sydstranden";"no";0;0;0;55,584166;12,648888
1767;"Sydstranden";"no";0;0;0;55,584166;12,648888
1768;"Sydstranden";"no";0;0;0;55,584166;12,648888
1769;"Sydstranden";"no";0;0;0;55,584166;12,648888
1770;"Sydstranden";"no";0;0;0;55,584166;12,648888
1771;"Sydstranden";"no";0;0;0;55,584166;12,648888
1772;"Sydstranden";"no";0;0;0;55,584166;12,648888
1773;"Sydstranden";"no";0;0;0;55,584166;12,648888
1774;"Sydstranden";"no";0;0;0;55,584166;12,648888
1775;"Sydstranden";"no";0;0;0;55,584166;12,648888
1776;"Sydstranden";"no";0;0;0;55,584166;12,648888
1777;"Sydstranden";"no";0;0;0;55,584166;12,648888
1778;"Sydstranden";"no";0;0;0;55,584166;12,648888
1779;"Sydstranden";"no";0;0;0;55,584166;12,648888
1780;"Sydstranden";"no";0;0;0;55,584166;12,648888
1781;"Sydstranden";"no";0;0;0;55,584166;12,648888
1782;"Sydstranden";"no";0;0;0;55,584166;12,648888
1783;"Sydstranden";"no";0;0;0;55,584166;12,648888
1784;"Sydstranden";"no";0;0;0;55,584166;12,648888
1785;"Sydstranden";"no";0;0;0;55,584166;12,648888
1786;"Sydstranden";"no";0;0;0;55,584166;12,648888
1787;"Sydstranden";"no";0;0;0;55,584166;12,648888
1788;"Sydstranden";"no";0;0;0;55,584166;12,648888
1789;"Sydstranden";"no";0;0;0;55,584166;12,648888
1790;"Sydstranden";"no";0;0;0;55,584166;12,648888
1791;"Sydstranden";"no";0;0;0;55,584166;12,648888
1792;"Sydstranden";"no";0;0;0;55,584166;12,648888
1793;"Sydstranden";"no";0;0;0;55,584166;12,648888
1794;"Sydstranden";"no";0;0;0;55,584166;12,648888
1795;"Sydstranden";"no";0;0;0;55,584166;12,648888
1796;"Sydstranden";"no";0;0;0;55,584166;12,648888
1797;"Sydstranden";"no";0;0;0;55,584166;12,648888
1798;"Sydstranden";"no";0;0;0;55,584166;12,648888
1799;"Sydstranden";"no";0;0;0;55,584166;12,648888
1800;"Sydstranden";"no";0;0;0;55,584166;12,648888
1801;"Sydstranden";"no";0;0;0;55,584166;12,648888
1802;"Sydstranden";"no";0;0;0;55,584166;12,648888
1803;"Sydstranden";"no";0;0;0;55,584166;12,648888
1804;"Sydstranden";"no";0;0;0;55,584166;12,648888
1805;"Sydstranden";"no";0;0;0;55,584166;12,648888
1806;"Sydstranden";"no";0;0;0;55,584166;12,648888
1807;"Sydstranden";"no";0;0;0;55,584166;12,648888
1808;"Sydstranden";"no";0;0;0;55,584166;12,648888
1809;"Sydstranden";"no";0;0;0;55,584166;12,648888
1810;"Sydstranden";"no";0;0;0;55,584166;12,648888
1811;"Sydstranden";"no";0;0;0;55,584166;12,648888
1812;"Sydstranden";"no";0;0;0;55,584166;12,648888
1813;"Sydstranden";"no";0;0;0;55,584166;12,648888
1814;"Sydstranden";"no";0;0;0;55,584166;12,648888
1815;"Sydstranden";"no";0;0;0;55,584166;12,648888
1816;"Sydstranden";"no";0;0;0;55,584166;12,648888
1817;"Sydstranden";"no";0;0;0;55,584166;12,648888
1818;"Sydstranden";"no";0;0;0;55,584166;12,648888
1819;"Sydstranden";"no";0;0;0;55,584166;12,648888
1820;"Sydstranden";"no";0;0;0;55,584166;12,648888
1821;"Sydstranden";"no";0;0;0;55,584166;12,648888
1822;"Sydstranden";"no";0;0;0;55,584166;12,648888
1823;"Sydstranden";"no";0;0;0;55,584166;12,648888
1824;"Sydstranden";"no";0;0;0;55,584166;12,648888
1825;"Sydstranden";"no";0;0;0;55,584166;12,648888
1826;"Sydstranden";"no";0;0;0;55,584166;12,648888
1827;"Sydstranden";"no";0;0;0;55,584166;12,648888
1828;"Sydstranden";"no";0;0;0;55,584166;12,648888
1829;"Sydstranden";"no";0;0;0;55,584166;12,648888
1830;"Sydstranden";"no";0;0;0;55,584166;12,648888
1831;"Sydstranden";"no";0;0;0;55,584166;12,648888
1832;"Sydstranden";"no";0;0;0;55,584166;12,648888
1833;"Sydstranden";"no";0;0;0;55,584166;12,648888
1834;"Sydstranden";"no";0;0;0;55,584166;12,648888
1835;"Sydstranden";"no";0;0;0;55,584166;12,648888
1836;"Sydstranden";"no";0;0;0;55,584166;12,648888
1837;"Sydstranden";"no";0;0;0;55,584166;12,648888
1838;"Sydstranden";"no";0;0;0;55,584166;12,648888
1839;"Sydstranden";"no";0;0;0;55,584166;12,648888
1840;"Sydstranden";"no";0;0;0;55,584166;12,648888
1841;"Sydstranden";"no";0;0;0;55,584166;12,648888
1842;"Sydstranden";"no";0;0;0;55,584166;12,648888
1843;"Sydstranden";"no";0;0;0;55,584166;12,648888
1844;"Sydstranden";"no";0;0;0;55,584166;12,648888
1845;"Sydstranden";"no";0;0;0;55,584166;12,648888
1846;"Sydstranden";"no";0;1;1;55,584166;12,648888
1847;"Sydstranden";"no";0;0;0;55,584166;12,648888
1848;"Sydstranden";"no";0;0;0;55,584166;12,648888
1849;"Sydstranden";"no";0;0;0;55,584166;12,648888
1850;"Sydstranden";"no";0;0;0;55,584166;12,648888
1851;"Sydstranden";"no";0;0;0;55,584166;12,648888
1852;"Sydstranden";"no";0;0;0;55,584166;12,648888
1853;"Sydstranden";"no";0;0;0;55,584166;12,648888
1854;"Sydstranden";"no";0;0;0;55,584166;12,648888
1855;"Sydstranden";"no";0;0;0;55,584166;12,648888
1856;"Sydstranden";"no";0;0;0;55,584166;12,648888
1857;"Sydstranden";"no";0;0;0;55,584166;12,648888
1634;"Visby";"no";0;0;0;56,793611;8,45
1635;"Visby";"no";0;0;0;56,793611;8,45
1636;"Visby";"no";0;0;0;56,793611;8,45
1637;"Visby";"no";0;0;0;56,793611;8,45
1638;"Visby";"no";0;0;0;56,793611;8,45
1639;"Visby";"no";0;0;0;56,793611;8,45
1640;"Visby";"no";0;0;0;56,793611;8,45
1641;"Visby";"no";0;0;0;56,793611;8,45
1642;"Visby";"no";0;0;0;56,793611;8,45
1643;"Visby";"no";0;0;0;56,793611;8,45
1644;"Visby";"no";0;0;0;56,793611;8,45
1645;"Visby";"no";0;0;0;56,793611;8,45
1646;"Visby";"no";0;0;0;56,793611;8,45
1647;"Visby";"no";0;0;0;56,793611;8,45
1648;"Visby";"no";0;0;0;56,793611;8,45
1649;"Visby";"no";0;0;0;56,793611;8,45
1650;"Visby";"no";0;0;0;56,793611;8,45
1651;"Visby";"no";0;0;0;56,793611;8,45
1652;"Visby";"no";0;0;0;56,793611;8,45
1653;"Visby";"no";0;0;0;56,793611;8,45
1654;"Visby";"no";0;0;0;56,793611;8,45
1655;"Visby";"no";0;0;0;56,793611;8,45
1656;"Visby";"no";0;0;0;56,793611;8,45
1657;"Visby";"no";0;0;0;56,793611;8,45
1658;"Visby";"no";0;0;0;56,793611;8,45
1659;"Visby";"no";0;0;0;56,793611;8,45
1660;"Visby";"no";0;0;0;56,793611;8,45
1661;"Visby";"no";0;0;0;56,793611;8,45
1662;"Visby";"no";0;0;0;56,793611;8,45
1663;"Visby";"no";0;0;0;56,793611;8,45
1664;"Visby";"no";0;0;0;56,793611;8,45
1665;"Visby";"no";0;0;0;56,793611;8,45
1666;"Visby";"no";0;0;0;56,793611;8,45
1667;"Visby";"no";0;0;0;56,793611;8,45
1668;"Visby";"no";0;0;0;56,793611;8,45
1669;"Visby";"no";0;0;0;56,793611;8,45
1670;"Visby";"no";0;0;0;56,793611;8,45
1671;"Visby";"no";0;0;0;56,793611;8,45
1672;"Visby";"no";0;0;0;56,793611;8,45
1673;"Visby";"no";0;0;0;56,793611;8,45
1674;"Visby";"no";0;0;0;56,793611;8,45
1675;"Visby";"no";0;0;0;56,793611;8,45
1676;"Visby";"no";0;0;0;56,793611;8,45
1677;"Visby";"no";0;0;0;56,793611;8,45
1678;"Visby";"no";0;0;0;56,793611;8,45
1679;"Visby";"no";0;0;0;56,793611;8,45
1680;"Visby";"no";0;0;0;56,793611;8,45
1681;"Visby";"no";0;0;0;56,793611;8,45
1682;"Visby";"no";0;0;0;56,793611;8,45
1683;"Visby";"no";0;0;0;56,793611;8,45
1684;"Visby";"no";0;0;0;56,793611;8,45
1685;"Visby";"no";0;0;0;56,793611;8,45
1686;"Visby";"no";0;0;0;56,793611;8,45
1687;"Visby";"no";0;0;0;56,793611;8,45
1688;"Visby";"no";0;0;0;56,793611;8,45
1689;"Visby";"no";0;0;0;56,793611;8,45
1690;"Visby";"no";0;0;0;56,793611;8,45
1691;"Visby";"no";0;0;0;56,793611;8,45
1692;"Visby";"no";0;0;0;56,793611;8,45
1693;"Visby";"no";0;0;0;56,793611;8,45
1694;"Visby";"no";0;0;0;56,793611;8,45
1695;"Visby";"no";0;0;0;56,793611;8,45
1696;"Visby";"no";0;0;0;56,793611;8,45
1697;"Visby";"no";0;0;0;56,793611;8,45
1698;"Visby";"no";0;0;0;56,793611;8,45
1699;"Visby";"no";0;0;0;56,793611;8,45
1700;"Visby";"no";0;0;0;56,793611;8,45
1701;"Visby";"no";0;0;0;56,793611;8,45
1702;"Visby";"no";0;0;0;56,793611;8,45
1703;"Visby";"no";0;0;0;56,793611;8,45
1704;"Visby";"no";0;0;0;56,793611;8,45
1705;"Visby";"no";0;0;0;56,793611;8,45
1706;"Visby";"no";0;0;0;56,793611;8,45
1707;"Visby";"no";0;0;0;56,793611;8,45
1708;"Visby";"no";0;0;0;56,793611;8,45
1709;"Visby";"no";0;0;0;56,793611;8,45
1710;"Visby";"no";0;0;0;56,793611;8,45
1711;"Visby";"no";0;0;0;56,793611;8,45
1712;"Visby";"no";0;0;0;56,793611;8,45
1713;"Visby";"no";0;0;0;56,793611;8,45
1714;"Visby";"no";0;0;0;56,793611;8,45
1715;"Visby";"no";0;0;0;56,793611;8,45
1716;"Visby";"no";0;0;0;56,793611;8,45
1717;"Visby";"no";0;0;0;56,793611;8,45
1718;"Visby";"no";0;0;0;56,793611;8,45
1719;"Visby";"no";0;0;0;56,793611;8,45
1720;"Visby";"no";0;0;0;56,793611;8,45
1721;"Visby";"no";0;0;0;56,793611;8,45
1722;"Visby";"no";0;0;0;56,793611;8,45
1723;"Visby";"no";0;0;0;56,793611;8,45
1724;"Visby";"no";0;0;0;56,793611;8,45
1725;"Visby";"no";0;0;0;56,793611;8,45
1726;"Visby";"no";0;0;0;56,793611;8,45
1727;"Visby";"no";0;0;0;56,793611;8,45
1728;"Visby";"no";0;0;0;56,793611;8,45
1729;"Visby";"no";0;0;0;56,793611;8,45
1730;"Visby";"no";0;0;0;56,793611;8,45
1731;"Visby";"no";0;0;0;56,793611;8,45
1732;"Visby";"no";0;0;0;56,793611;8,45
1733;"Visby";"no";0;0;0;56,793611;8,45
1734;"Visby";"no";0;0;0;56,793611;8,45
1735;"Visby";"no";0;0;0;56,793611;8,45
1736;"Visby";"no";0;0;0;56,793611;8,45
1737;"Visby";"no";0;0;0;56,793611;8,45
1738;"Visby";"no";0;0;0;56,793611;8,45
1739;"Visby";"no";0;0;0;56,793611;8,45
1740;"Visby";"no";0;0;0;56,793611;8,45
1741;"Visby";"no";0;0;0;56,793611;8,45
1742;"Visby";"no";0;0;0;56,793611;8,45
1743;"Visby";"no";0;0;0;56,793611;8,45
1744;"Visby";"no";0;0;0;56,793611;8,45
1745;"Visby";"no";0;0;0;56,793611;8,45
1746;"Visby";"no";0;0;0;56,793611;8,45
1747;"Visby";"no";0;0;0;56,793611;8,45
1748;"Visby";"no";0;0;0;56,793611;8,45
1749;"Visby";"no";0;0;0;56,793611;8,45
1750;"Visby";"no";0;0;0;56,793611;8,45
1751;"Visby";"no";0;0;0;56,793611;8,45
1752;"Visby";"no";0;0;0;56,793611;8,45
1753;"Visby";"no";0;0;0;56,793611;8,45
1754;"Visby";"no";0;0;0;56,793611;8,45
1755;"Visby";"no";0;0;0;56,793611;8,45
1756;"Visby";"no";0;0;0;56,793611;8,45
1757;"Visby";"no";0;0;0;56,793611;8,45
1758;"Visby";"no";0;0;0;56,793611;8,45
1759;"Visby";"no";0;0;0;56,793611;8,45
1760;"Visby";"no";0;0;0;56,793611;8,45
1761;"Visby";"no";0;0;0;56,793611;8,45
1762;"Visby";"no";0;0;0;56,793611;8,45
1763;"Visby";"no";0;0;0;56,793611;8,45
1764;"Visby";"no";0;0;0;56,793611;8,45
1765;"Visby";"no";0;0;0;56,793611;8,45
1766;"Visby";"no";0;0;0;56,793611;8,45
1767;"Visby";"no";0;0;0;56,793611;8,45
1768;"Visby";"no";0;0;0;56,793611;8,45
1769;"Visby";"no";0;0;0;56,793611;8,45
1770;"Visby";"no";0;0;0;56,793611;8,45
1771;"Visby";"no";0;0;0;56,793611;8,45
1772;"Visby";"no";0;0;0;56,793611;8,45
1773;"Visby";"no";0;0;0;56,793611;8,45
1774;"Visby";"no";0;0;0;56,793611;8,45
1775;"Visby";"no";0;0;0;56,793611;8,45
1776;"Visby";"no";0;0;0;56,793611;8,45
1777;"Visby";"no";0;0;0;56,793611;8,45
1778;"Visby";"no";0;0;0;56,793611;8,45
1779;"Visby";"no";0;0;0;56,793611;8,45
1780;"Visby";"no";0;0;0;56,793611;8,45
1781;"Visby";"no";0;0;0;56,793611;8,45
1782;"Visby";"no";0;0;0;56,793611;8,45
1783;"Visby";"no";0;0;0;56,793611;8,45
1784;"Visby";"no";0;0;0;56,793611;8,45
1785;"Visby";"no";0;0;0;56,793611;8,45
1786;"Visby";"no";0;0;0;56,793611;8,45
1787;"Visby";"no";0;0;0;56,793611;8,45
1788;"Visby";"no";0;0;0;56,793611;8,45
1789;"Visby";"no";0;0;0;56,793611;8,45
1790;"Visby";"no";0;0;0;56,793611;8,45
1791;"Visby";"no";0;0;0;56,793611;8,45
1792;"Visby";"no";0;0;0;56,793611;8,45
1793;"Visby";"no";0;0;0;56,793611;8,45
1794;"Visby";"no";0;0;0;56,793611;8,45
1795;"Visby";"no";0;0;0;56,793611;8,45
1796;"Visby";"no";0;0;0;56,793611;8,45
1797;"Visby";"no";0;0;0;56,793611;8,45
1798;"Visby";"no";0;0;0;56,793611;8,45
1799;"Visby";"no";0;0;0;56,793611;8,45
1800;"Visby";"no";0;0;0;56,793611;8,45
1801;"Visby";"no";0;0;0;56,793611;8,45
1802;"Visby";"no";0;0;0;56,793611;8,45
1803;"Visby";"no";0;0;0;56,793611;8,45
1804;"Visby";"no";0;0;0;56,793611;8,45
1805;"Visby";"no";0;0;0;56,793611;8,45
1806;"Visby";"no";0;0;0;56,793611;8,45
1807;"Visby";"no";0;0;0;56,793611;8,45
1808;"Visby";"no";0;0;0;56,793611;8,45
1809;"Visby";"no";0;0;0;56,793611;8,45
1810;"Visby";"no";0;0;0;56,793611;8,45
1811;"Visby";"no";0;0;0;56,793611;8,45
1812;"Visby";"no";0;0;0;56,793611;8,45
1813;"Visby";"no";0;0;0;56,793611;8,45
1814;"Visby";"no";0;0;0;56,793611;8,45
1815;"Visby";"no";0;0;0;56,793611;8,45
1816;"Visby";"no";0;0;0;56,793611;8,45
1817;"Visby";"no";0;0;0;56,793611;8,45
1818;"Visby";"no";0;0;0;56,793611;8,45
1819;"Visby";"no";0;0;0;56,793611;8,45
1820;"Visby";"no";0;0;0;56,793611;8,45
1821;"Visby";"no";0;0;0;56,793611;8,45
1822;"Visby";"no";0;0;0;56,793611;8,45
1823;"Visby";"no";0;0;0;56,793611;8,45
1824;"Visby";"no";0;0;0;56,793611;8,45
1825;"Visby";"no";0;0;0;56,793611;8,45
1826;"Visby";"no";0;0;0;56,793611;8,45
1827;"Visby";"no";0;0;0;56,793611;8,45
1828;"Visby";"no";0;0;0;56,793611;8,45
1829;"Visby";"no";0;0;0;56,793611;8,45
1830;"Visby";"no";0;0;0;56,793611;8,45
1831;"Visby";"no";0;0;0;56,793611;8,45
1832;"Visby";"no";0;0;0;56,793611;8,45
1833;"Visby";"no";0;0;0;56,793611;8,45
1834;"Visby";"no";0;0;0;56,793611;8,45
1835;"Visby";"no";0;0;0;56,793611;8,45
1836;"Visby";"no";0;0;0;56,793611;8,45
1837;"Visby";"no";0;0;0;56,793611;8,45
1838;"Visby";"no";0;0;0;56,793611;8,45
1839;"Visby";"no";0;0;0;56,793611;8,45
1840;"Visby";"no";0;0;0;56,793611;8,45
1841;"Visby";"no";0;0;0;56,793611;8,45
1842;"Visby";"no";0;0;0;56,793611;8,45
1843;"Visby";"no";0;0;0;56,793611;8,45
1844;"Visby";"no";0;0;0;56,793611;8,45
1845;"Visby";"no";0;0;0;56,793611;8,45
1846;"Visby";"no";0;0;0;56,793611;8,45
1847;"Visby";"no";0;0;0;56,793611;8,45
1848;"Visby";"no";0;1;1;56,793611;8,45
1849;"Visby";"no";0;0;0;56,793611;8,45
1850;"Visby";"no";0;0;0;56,793611;8,45
1851;"Visby";"no";0;0;0;56,793611;8,45
1852;"Visby";"no";0;0;0;56,793611;8,45
1853;"Visby";"no";0;0;0;56,793611;8,45
1854;"Visby";"no";0;0;0;56,793611;8,45
1855;"Visby";"no";0;0;0;56,793611;8,45
1856;"Visby";"no";0;0;0;56,793611;8,45
1857;"Visby";"no";0;0;0;56,793611;8,45
1634;"Troense";"no";0;0;0;55,033055;10,643611
1635;"Troense";"no";0;0;0;55,033055;10,643611
1636;"Troense";"no";0;0;0;55,033055;10,643611
1637;"Troense";"no";0;0;0;55,033055;10,643611
1638;"Troense";"no";0;0;0;55,033055;10,643611
1639;"Troense";"no";0;0;0;55,033055;10,643611
1640;"Troense";"no";0;0;0;55,033055;10,643611
1641;"Troense";"no";0;0;0;55,033055;10,643611
1642;"Troense";"no";0;0;0;55,033055;10,643611
1643;"Troense";"no";0;0;0;55,033055;10,643611
1644;"Troense";"no";0;0;0;55,033055;10,643611
1645;"Troense";"no";0;0;0;55,033055;10,643611
1646;"Troense";"no";0;0;0;55,033055;10,643611
1647;"Troense";"no";0;0;0;55,033055;10,643611
1648;"Troense";"no";0;0;0;55,033055;10,643611
1649;"Troense";"no";0;0;0;55,033055;10,643611
1650;"Troense";"no";0;0;0;55,033055;10,643611
1651;"Troense";"no";0;0;0;55,033055;10,643611
1652;"Troense";"no";0;0;0;55,033055;10,643611
1653;"Troense";"no";0;0;0;55,033055;10,643611
1654;"Troense";"no";0;0;0;55,033055;10,643611
1655;"Troense";"no";0;0;0;55,033055;10,643611
1656;"Troense";"no";0;0;0;55,033055;10,643611
1657;"Troense";"no";0;0;0;55,033055;10,643611
1658;"Troense";"no";0;0;0;55,033055;10,643611
1659;"Troense";"no";0;0;0;55,033055;10,643611
1660;"Troense";"no";0;0;0;55,033055;10,643611
1661;"Troense";"no";0;0;0;55,033055;10,643611
1662;"Troense";"no";0;0;0;55,033055;10,643611
1663;"Troense";"no";0;0;0;55,033055;10,643611
1664;"Troense";"no";0;0;0;55,033055;10,643611
1665;"Troense";"no";0;0;0;55,033055;10,643611
1666;"Troense";"no";0;0;0;55,033055;10,643611
1667;"Troense";"no";0;0;0;55,033055;10,643611
1668;"Troense";"no";0;0;0;55,033055;10,643611
1669;"Troense";"no";0;0;0;55,033055;10,643611
1670;"Troense";"no";0;0;0;55,033055;10,643611
1671;"Troense";"no";0;0;0;55,033055;10,643611
1672;"Troense";"no";0;0;0;55,033055;10,643611
1673;"Troense";"no";0;0;0;55,033055;10,643611
1674;"Troense";"no";0;0;0;55,033055;10,643611
1675;"Troense";"no";0;0;0;55,033055;10,643611
1676;"Troense";"no";0;0;0;55,033055;10,643611
1677;"Troense";"no";0;0;0;55,033055;10,643611
1678;"Troense";"no";0;0;0;55,033055;10,643611
1679;"Troense";"no";0;0;0;55,033055;10,643611
1680;"Troense";"no";0;0;0;55,033055;10,643611
1681;"Troense";"no";0;0;0;55,033055;10,643611
1682;"Troense";"no";0;0;0;55,033055;10,643611
1683;"Troense";"no";0;0;0;55,033055;10,643611
1684;"Troense";"no";0;0;0;55,033055;10,643611
1685;"Troense";"no";0;0;0;55,033055;10,643611
1686;"Troense";"no";0;0;0;55,033055;10,643611
1687;"Troense";"no";0;0;0;55,033055;10,643611
1688;"Troense";"no";0;0;0;55,033055;10,643611
1689;"Troense";"no";0;0;0;55,033055;10,643611
1690;"Troense";"no";0;0;0;55,033055;10,643611
1691;"Troense";"no";0;0;0;55,033055;10,643611
1692;"Troense";"no";0;0;0;55,033055;10,643611
1693;"Troense";"no";0;0;0;55,033055;10,643611
1694;"Troense";"no";0;0;0;55,033055;10,643611
1695;"Troense";"no";0;0;0;55,033055;10,643611
1696;"Troense";"no";0;0;0;55,033055;10,643611
1697;"Troense";"no";0;0;0;55,033055;10,643611
1698;"Troense";"no";0;0;0;55,033055;10,643611
1699;"Troense";"no";0;0;0;55,033055;10,643611
1700;"Troense";"no";0;0;0;55,033055;10,643611
1701;"Troense";"no";0;0;0;55,033055;10,643611
1702;"Troense";"no";0;0;0;55,033055;10,643611
1703;"Troense";"no";0;0;0;55,033055;10,643611
1704;"Troense";"no";0;0;0;55,033055;10,643611
1705;"Troense";"no";0;0;0;55,033055;10,643611
1706;"Troense";"no";0;0;0;55,033055;10,643611
1707;"Troense";"no";0;0;0;55,033055;10,643611
1708;"Troense";"no";0;0;0;55,033055;10,643611
1709;"Troense";"no";0;0;0;55,033055;10,643611
1710;"Troense";"no";0;0;0;55,033055;10,643611
1711;"Troense";"no";0;0;0;55,033055;10,643611
1712;"Troense";"no";0;0;0;55,033055;10,643611
1713;"Troense";"no";0;0;0;55,033055;10,643611
1714;"Troense";"no";0;0;0;55,033055;10,643611
1715;"Troense";"no";0;0;0;55,033055;10,643611
1716;"Troense";"no";0;0;0;55,033055;10,643611
1717;"Troense";"no";0;0;0;55,033055;10,643611
1718;"Troense";"no";0;0;0;55,033055;10,643611
1719;"Troense";"no";0;0;0;55,033055;10,643611
1720;"Troense";"no";0;0;0;55,033055;10,643611
1721;"Troense";"no";0;0;0;55,033055;10,643611
1722;"Troense";"no";0;0;0;55,033055;10,643611
1723;"Troense";"no";0;0;0;55,033055;10,643611
1724;"Troense";"no";0;0;0;55,033055;10,643611
1725;"Troense";"no";0;0;0;55,033055;10,643611
1726;"Troense";"no";0;0;0;55,033055;10,643611
1727;"Troense";"no";0;0;0;55,033055;10,643611
1728;"Troense";"no";0;0;0;55,033055;10,643611
1729;"Troense";"no";0;0;0;55,033055;10,643611
1730;"Troense";"no";0;0;0;55,033055;10,643611
1731;"Troense";"no";0;0;0;55,033055;10,643611
1732;"Troense";"no";0;0;0;55,033055;10,643611
1733;"Troense";"no";0;0;0;55,033055;10,643611
1734;"Troense";"no";0;0;0;55,033055;10,643611
1735;"Troense";"no";0;0;0;55,033055;10,643611
1736;"Troense";"no";0;0;0;55,033055;10,643611
1737;"Troense";"no";0;0;0;55,033055;10,643611
1738;"Troense";"no";0;0;0;55,033055;10,643611
1739;"Troense";"no";0;0;0;55,033055;10,643611
1740;"Troense";"no";0;0;0;55,033055;10,643611
1741;"Troense";"no";0;0;0;55,033055;10,643611
1742;"Troense";"no";0;0;0;55,033055;10,643611
1743;"Troense";"no";0;0;0;55,033055;10,643611
1744;"Troense";"no";0;0;0;55,033055;10,643611
1745;"Troense";"no";0;0;0;55,033055;10,643611
1746;"Troense";"no";0;0;0;55,033055;10,643611
1747;"Troense";"no";0;0;0;55,033055;10,643611
1748;"Troense";"no";0;0;0;55,033055;10,643611
1749;"Troense";"no";0;0;0;55,033055;10,643611
1750;"Troense";"no";0;0;0;55,033055;10,643611
1751;"Troense";"no";0;0;0;55,033055;10,643611
1752;"Troense";"no";0;0;0;55,033055;10,643611
1753;"Troense";"no";0;0;0;55,033055;10,643611
1754;"Troense";"no";0;0;0;55,033055;10,643611
1755;"Troense";"no";0;0;0;55,033055;10,643611
1756;"Troense";"no";0;0;0;55,033055;10,643611
1757;"Troense";"no";0;0;0;55,033055;10,643611
1758;"Troense";"no";0;0;0;55,033055;10,643611
1759;"Troense";"no";0;0;0;55,033055;10,643611
1760;"Troense";"no";0;0;0;55,033055;10,643611
1761;"Troense";"no";0;0;0;55,033055;10,643611
1762;"Troense";"no";0;0;0;55,033055;10,643611
1763;"Troense";"no";0;0;0;55,033055;10,643611
1764;"Troense";"no";0;0;0;55,033055;10,643611
1765;"Troense";"no";0;0;0;55,033055;10,643611
1766;"Troense";"no";0;0;0;55,033055;10,643611
1767;"Troense";"no";0;0;0;55,033055;10,643611
1768;"Troense";"no";0;0;0;55,033055;10,643611
1769;"Troense";"no";0;0;0;55,033055;10,643611
1770;"Troense";"no";0;0;0;55,033055;10,643611
1771;"Troense";"no";0;0;0;55,033055;10,643611
1772;"Troense";"no";0;0;0;55,033055;10,643611
1773;"Troense";"no";0;0;0;55,033055;10,643611
1774;"Troense";"no";0;0;0;55,033055;10,643611
1775;"Troense";"no";0;0;0;55,033055;10,643611
1776;"Troense";"no";0;0;0;55,033055;10,643611
1777;"Troense";"no";0;0;0;55,033055;10,643611
1778;"Troense";"no";0;0;0;55,033055;10,643611
1779;"Troense";"no";0;0;0;55,033055;10,643611
1780;"Troense";"no";0;0;0;55,033055;10,643611
1781;"Troense";"no";0;0;0;55,033055;10,643611
1782;"Troense";"no";0;0;0;55,033055;10,643611
1783;"Troense";"no";0;0;0;55,033055;10,643611
1784;"Troense";"no";0;0;0;55,033055;10,643611
1785;"Troense";"no";0;0;0;55,033055;10,643611
1786;"Troense";"no";0;0;0;55,033055;10,643611
1787;"Troense";"no";0;0;0;55,033055;10,643611
1788;"Troense";"no";0;0;0;55,033055;10,643611
1789;"Troense";"no";0;0;0;55,033055;10,643611
1790;"Troense";"no";0;0;0;55,033055;10,643611
1791;"Troense";"no";0;0;0;55,033055;10,643611
1792;"Troense";"no";0;0;0;55,033055;10,643611
1793;"Troense";"no";0;0;0;55,033055;10,643611
1794;"Troense";"no";0;0;0;55,033055;10,643611
1795;"Troense";"no";0;0;0;55,033055;10,643611
1796;"Troense";"no";0;0;0;55,033055;10,643611
1797;"Troense";"no";0;0;0;55,033055;10,643611
1798;"Troense";"no";0;0;0;55,033055;10,643611
1799;"Troense";"no";0;0;0;55,033055;10,643611
1800;"Troense";"no";0;0;0;55,033055;10,643611
1801;"Troense";"no";0;0;0;55,033055;10,643611
1802;"Troense";"no";0;0;0;55,033055;10,643611
1803;"Troense";"no";0;0;0;55,033055;10,643611
1804;"Troense";"no";0;0;0;55,033055;10,643611
1805;"Troense";"no";0;0;0;55,033055;10,643611
1806;"Troense";"no";0;0;0;55,033055;10,643611
1807;"Troense";"no";0;0;0;55,033055;10,643611
1808;"Troense";"no";0;0;0;55,033055;10,643611
1809;"Troense";"no";0;0;0;55,033055;10,643611
1810;"Troense";"no";0;0;0;55,033055;10,643611
1811;"Troense";"no";0;0;0;55,033055;10,643611
1812;"Troense";"no";0;0;0;55,033055;10,643611
1813;"Troense";"no";0;0;0;55,033055;10,643611
1814;"Troense";"no";0;0;0;55,033055;10,643611
1815;"Troense";"no";0;0;0;55,033055;10,643611
1816;"Troense";"no";0;0;0;55,033055;10,643611
1817;"Troense";"no";0;0;0;55,033055;10,643611
1818;"Troense";"no";0;0;0;55,033055;10,643611
1819;"Troense";"no";0;0;0;55,033055;10,643611
1820;"Troense";"no";0;0;0;55,033055;10,643611
1821;"Troense";"no";0;0;0;55,033055;10,643611
1822;"Troense";"no";0;0;0;55,033055;10,643611
1823;"Troense";"no";0;0;0;55,033055;10,643611
1824;"Troense";"no";0;0;0;55,033055;10,643611
1825;"Troense";"no";0;0;0;55,033055;10,643611
1826;"Troense";"no";0;0;0;55,033055;10,643611
1827;"Troense";"no";0;0;0;55,033055;10,643611
1828;"Troense";"no";0;0;0;55,033055;10,643611
1829;"Troense";"no";0;0;0;55,033055;10,643611
1830;"Troense";"no";0;0;0;55,033055;10,643611
1831;"Troense";"no";0;0;0;55,033055;10,643611
1832;"Troense";"no";0;0;0;55,033055;10,643611
1833;"Troense";"no";0;0;0;55,033055;10,643611
1834;"Troense";"no";0;0;0;55,033055;10,643611
1835;"Troense";"no";0;0;0;55,033055;10,643611
1836;"Troense";"no";0;0;0;55,033055;10,643611
1837;"Troense";"no";0;0;0;55,033055;10,643611
1838;"Troense";"no";0;0;0;55,033055;10,643611
1839;"Troense";"no";0;0;0;55,033055;10,643611
1840;"Troense";"no";0;0;0;55,033055;10,643611
1841;"Troense";"no";0;0;0;55,033055;10,643611
1842;"Troense";"no";0;0;0;55,033055;10,643611
1843;"Troense";"no";0;0;0;55,033055;10,643611
1844;"Troense";"no";0;0;0;55,033055;10,643611
1845;"Troense";"no";0;0;0;55,033055;10,643611
1846;"Troense";"no";0;0;0;55,033055;10,643611
1847;"Troense";"no";0;0;0;55,033055;10,643611
1848;"Troense";"no";0;0;0;55,033055;10,643611
1849;"Troense";"no";0;1;1;55,033055;10,643611
1850;"Troense";"no";0;0;0;55,033055;10,643611
1851;"Troense";"no";0;0;0;55,033055;10,643611
1852;"Troense";"no";0;1;1;55,033055;10,643611
1853;"Troense";"no";0;0;0;55,033055;10,643611
1854;"Troense";"no";0;0;0;55,033055;10,643611
1855;"Troense";"no";0;0;0;55,033055;10,643611
1856;"Troense";"no";0;0;0;55,033055;10,643611
1857;"Troense";"no";0;0;0;55,033055;10,643611
1634;"Gamle Kalkbrænderi";"no";0;0;0;55,7046;12,5901
1635;"Gamle Kalkbrænderi";"no";0;0;0;55,7046;12,5901
1636;"Gamle Kalkbrænderi";"no";0;0;0;55,7046;12,5901
1637;"Gamle Kalkbrænderi";"no";0;0;0;55,7046;12,5901
1638;"Gamle Kalkbrænderi";"no";0;0;0;55,7046;12,5901
1639;"Gamle Kalkbrænderi";"no";0;0;0;55,7046;12,5901
1640;"Gamle Kalkbrænderi";"no";0;0;0;55,7046;12,5901
1641;"Gamle Kalkbrænderi";"no";0;0;0;55,7046;12,5901
1642;"Gamle Kalkbrænderi";"no";0;0;0;55,7046;12,5901
1643;"Gamle Kalkbrænderi";"no";0;0;0;55,7046;12,5901
1644;"Gamle Kalkbrænderi";"no";0;0;0;55,7046;12,5901
1645;"Gamle Kalkbrænderi";"no";0;0;0;55,7046;12,5901
1646;"Gamle Kalkbrænderi";"no";0;0;0;55,7046;12,5901
1647;"Gamle Kalkbrænderi";"no";0;0;0;55,7046;12,5901
1648;"Gamle Kalkbrænderi";"no";0;0;0;55,7046;12,5901
1649;"Gamle Kalkbrænderi";"no";0;0;0;55,7046;12,5901
1650;"Gamle Kalkbrænderi";"no";0;0;0;55,7046;12,5901
1651;"Gamle Kalkbrænderi";"no";0;0;0;55,7046;12,5901
1652;"Gamle Kalkbrænderi";"no";0;0;0;55,7046;12,5901
1653;"Gamle Kalkbrænderi";"no";0;0;0;55,7046;12,5901
1654;"Gamle Kalkbrænderi";"no";0;0;0;55,7046;12,5901
1655;"Gamle Kalkbrænderi";"no";0;0;0;55,7046;12,5901
1656;"Gamle Kalkbrænderi";"no";0;0;0;55,7046;12,5901
1657;"Gamle Kalkbrænderi";"no";0;0;0;55,7046;12,5901
1658;"Gamle Kalkbrænderi";"no";0;0;0;55,7046;12,5901
1659;"Gamle Kalkbrænderi";"no";0;0;0;55,7046;12,5901
1660;"Gamle Kalkbrænderi";"no";0;0;0;55,7046;12,5901
1661;"Gamle Kalkbrænderi";"no";0;0;0;55,7046;12,5901
1662;"Gamle Kalkbrænderi";"no";0;0;0;55,7046;12,5901
1663;"Gamle Kalkbrænderi";"no";0;0;0;55,7046;12,5901
1664;"Gamle Kalkbrænderi";"no";0;0;0;55,7046;12,5901
1665;"Gamle Kalkbrænderi";"no";0;0;0;55,7046;12,5901
1666;"Gamle Kalkbrænderi";"no";0;0;0;55,7046;12,5901
1667;"Gamle Kalkbrænderi";"no";0;0;0;55,7046;12,5901
1668;"Gamle Kalkbrænderi";"no";0;0;0;55,7046;12,5901
1669;"Gamle Kalkbrænderi";"no";0;0;0;55,7046;12,5901
1670;"Gamle Kalkbrænderi";"no";0;0;0;55,7046;12,5901
1671;"Gamle Kalkbrænderi";"no";0;0;0;55,7046;12,5901
1672;"Gamle Kalkbrænderi";"no";0;0;0;55,7046;12,5901
1673;"Gamle Kalkbrænderi";"no";0;0;0;55,7046;12,5901
1674;"Gamle Kalkbrænderi";"no";0;0;0;55,7046;12,5901
1675;"Gamle Kalkbrænderi";"no";0;0;0;55,7046;12,5901
1676;"Gamle Kalkbrænderi";"no";0;0;0;55,7046;12,5901
1677;"Gamle Kalkbrænderi";"no";0;0;0;55,7046;12,5901
1678;"Gamle Kalkbrænderi";"no";0;0;0;55,7046;12,5901
1679;"Gamle Kalkbrænderi";"no";0;0;0;55,7046;12,5901
1680;"Gamle Kalkbrænderi";"no";0;0;0;55,7046;12,5901
1681;"Gamle Kalkbrænderi";"no";0;0;0;55,7046;12,5901
1682;"Gamle Kalkbrænderi";"no";0;0;0;55,7046;12,5901
1683;"Gamle Kalkbrænderi";"no";0;0;0;55,7046;12,5901
1684;"Gamle Kalkbrænderi";"no";0;0;0;55,7046;12,5901
1685;"Gamle Kalkbrænderi";"no";0;0;0;55,7046;12,5901
1686;"Gamle Kalkbrænderi";"no";0;0;0;55,7046;12,5901
1687;"Gamle Kalkbrænderi";"no";0;0;0;55,7046;12,5901
1688;"Gamle Kalkbrænderi";"no";0;0;0;55,7046;12,5901
1689;"Gamle Kalkbrænderi";"no";0;0;0;55,7046;12,5901
1690;"Gamle Kalkbrænderi";"no";0;0;0;55,7046;12,5901
1691;"Gamle Kalkbrænderi";"no";0;0;0;55,7046;12,5901
1692;"Gamle Kalkbrænderi";"no";0;0;0;55,7046;12,5901
1693;"Gamle Kalkbrænderi";"no";0;0;0;55,7046;12,5901
1694;"Gamle Kalkbrænderi";"no";0;0;0;55,7046;12,5901
1695;"Gamle Kalkbrænderi";"no";0;0;0;55,7046;12,5901
1696;"Gamle Kalkbrænderi";"no";0;0;0;55,7046;12,5901
1697;"Gamle Kalkbrænderi";"no";0;0;0;55,7046;12,5901
1698;"Gamle Kalkbrænderi";"no";0;0;0;55,7046;12,5901
1699;"Gamle Kalkbrænderi";"no";0;0;0;55,7046;12,5901
1700;"Gamle Kalkbrænderi";"no";0;0;0;55,7046;12,5901
1701;"Gamle Kalkbrænderi";"no";0;0;0;55,7046;12,5901
1702;"Gamle Kalkbrænderi";"no";0;0;0;55,7046;12,5901
1703;"Gamle Kalkbrænderi";"no";0;0;0;55,7046;12,5901
1704;"Gamle Kalkbrænderi";"no";0;0;0;55,7046;12,5901
1705;"Gamle Kalkbrænderi";"no";0;0;0;55,7046;12,5901
1706;"Gamle Kalkbrænderi";"no";0;0;0;55,7046;12,5901
1707;"Gamle Kalkbrænderi";"no";0;0;0;55,7046;12,5901
1708;"Gamle Kalkbrænderi";"no";0;0;0;55,7046;12,5901
1709;"Gamle Kalkbrænderi";"no";0;0;0;55,7046;12,5901
1710;"Gamle Kalkbrænderi";"no";0;0;0;55,7046;12,5901
1711;"Gamle Kalkbrænderi";"no";0;0;0;55,7046;12,5901
1712;"Gamle Kalkbrænderi";"no";0;0;0;55,7046;12,5901
1713;"Gamle Kalkbrænderi";"no";0;0;0;55,7046;12,5901
1714;"Gamle Kalkbrænderi";"no";0;0;0;55,7046;12,5901
1715;"Gamle Kalkbrænderi";"no";0;0;0;55,7046;12,5901
1716;"Gamle Kalkbrænderi";"no";0;0;0;55,7046;12,5901
1717;"Gamle Kalkbrænderi";"no";0;0;0;55,7046;12,5901
1718;"Gamle Kalkbrænderi";"no";0;0;0;55,7046;12,5901
1719;"Gamle Kalkbrænderi";"no";0;0;0;55,7046;12,5901
1720;"Gamle Kalkbrænderi";"no";0;0;0;55,7046;12,5901
1721;"Gamle Kalkbrænderi";"no";0;0;0;55,7046;12,5901
1722;"Gamle Kalkbrænderi";"no";0;0;0;55,7046;12,5901
1723;"Gamle Kalkbrænderi";"no";0;0;0;55,7046;12,5901
1724;"Gamle Kalkbrænderi";"no";0;0;0;55,7046;12,5901
1725;"Gamle Kalkbrænderi";"no";0;0;0;55,7046;12,5901
1726;"Gamle Kalkbrænderi";"no";0;0;0;55,7046;12,5901
1727;"Gamle Kalkbrænderi";"no";0;0;0;55,7046;12,5901
1728;"Gamle Kalkbrænderi";"no";0;0;0;55,7046;12,5901
1729;"Gamle Kalkbrænderi";"no";0;0;0;55,7046;12,5901
1730;"Gamle Kalkbrænderi";"no";0;0;0;55,7046;12,5901
1731;"Gamle Kalkbrænderi";"no";0;0;0;55,7046;12,5901
1732;"Gamle Kalkbrænderi";"no";0;0;0;55,7046;12,5901
1733;"Gamle Kalkbrænderi";"no";0;0;0;55,7046;12,5901
1734;"Gamle Kalkbrænderi";"no";0;0;0;55,7046;12,5901
1735;"Gamle Kalkbrænderi";"no";0;0;0;55,7046;12,5901
1736;"Gamle Kalkbrænderi";"no";0;0;0;55,7046;12,5901
1737;"Gamle Kalkbrænderi";"no";0;0;0;55,7046;12,5901
1738;"Gamle Kalkbrænderi";"no";0;0;0;55,7046;12,5901
1739;"Gamle Kalkbrænderi";"no";0;0;0;55,7046;12,5901
1740;"Gamle Kalkbrænderi";"no";0;0;0;55,7046;12,5901
1741;"Gamle Kalkbrænderi";"no";0;0;0;55,7046;12,5901
1742;"Gamle Kalkbrænderi";"no";0;0;0;55,7046;12,5901
1743;"Gamle Kalkbrænderi";"no";0;0;0;55,7046;12,5901
1744;"Gamle Kalkbrænderi";"no";0;0;0;55,7046;12,5901
1745;"Gamle Kalkbrænderi";"no";0;0;0;55,7046;12,5901
1746;"Gamle Kalkbrænderi";"no";0;0;0;55,7046;12,5901
1747;"Gamle Kalkbrænderi";"no";0;0;0;55,7046;12,5901
1748;"Gamle Kalkbrænderi";"no";0;0;0;55,7046;12,5901
1749;"Gamle Kalkbrænderi";"no";0;0;0;55,7046;12,5901
1750;"Gamle Kalkbrænderi";"no";0;0;0;55,7046;12,5901
1751;"Gamle Kalkbrænderi";"no";0;0;0;55,7046;12,5901
1752;"Gamle Kalkbrænderi";"no";0;0;0;55,7046;12,5901
1753;"Gamle Kalkbrænderi";"no";0;0;0;55,7046;12,5901
1754;"Gamle Kalkbrænderi";"no";0;0;0;55,7046;12,5901
1755;"Gamle Kalkbrænderi";"no";0;0;0;55,7046;12,5901
1756;"Gamle Kalkbrænderi";"no";0;0;0;55,7046;12,5901
1757;"Gamle Kalkbrænderi";"no";0;0;0;55,7046;12,5901
1758;"Gamle Kalkbrænderi";"no";0;0;0;55,7046;12,5901
1759;"Gamle Kalkbrænderi";"no";0;0;0;55,7046;12,5901
1760;"Gamle Kalkbrænderi";"no";0;0;0;55,7046;12,5901
1761;"Gamle Kalkbrænderi";"no";0;0;0;55,7046;12,5901
1762;"Gamle Kalkbrænderi";"no";0;0;0;55,7046;12,5901
1763;"Gamle Kalkbrænderi";"no";0;0;0;55,7046;12,5901
1764;"Gamle Kalkbrænderi";"no";0;0;0;55,7046;12,5901
1765;"Gamle Kalkbrænderi";"no";0;0;0;55,7046;12,5901
1766;"Gamle Kalkbrænderi";"no";0;0;0;55,7046;12,5901
1767;"Gamle Kalkbrænderi";"no";0;0;0;55,7046;12,5901
1768;"Gamle Kalkbrænderi";"no";0;0;0;55,7046;12,5901
1769;"Gamle Kalkbrænderi";"no";0;0;0;55,7046;12,5901
1770;"Gamle Kalkbrænderi";"no";0;0;0;55,7046;12,5901
1771;"Gamle Kalkbrænderi";"no";0;0;0;55,7046;12,5901
1772;"Gamle Kalkbrænderi";"no";0;0;0;55,7046;12,5901
1773;"Gamle Kalkbrænderi";"no";0;0;0;55,7046;12,5901
1774;"Gamle Kalkbrænderi";"no";0;0;0;55,7046;12,5901
1775;"Gamle Kalkbrænderi";"no";0;0;0;55,7046;12,5901
1776;"Gamle Kalkbrænderi";"no";0;0;0;55,7046;12,5901
1777;"Gamle Kalkbrænderi";"no";0;0;0;55,7046;12,5901
1778;"Gamle Kalkbrænderi";"no";0;0;0;55,7046;12,5901
1779;"Gamle Kalkbrænderi";"no";0;0;0;55,7046;12,5901
1780;"Gamle Kalkbrænderi";"no";0;0;0;55,7046;12,5901
1781;"Gamle Kalkbrænderi";"no";0;0;0;55,7046;12,5901
1782;"Gamle Kalkbrænderi";"no";0;0;0;55,7046;12,5901
1783;"Gamle Kalkbrænderi";"no";0;0;0;55,7046;12,5901
1784;"Gamle Kalkbrænderi";"no";0;0;0;55,7046;12,5901
1785;"Gamle Kalkbrænderi";"no";0;0;0;55,7046;12,5901
1786;"Gamle Kalkbrænderi";"no";0;0;0;55,7046;12,5901
1787;"Gamle Kalkbrænderi";"no";0;0;0;55,7046;12,5901
1788;"Gamle Kalkbrænderi";"no";0;0;0;55,7046;12,5901
1789;"Gamle Kalkbrænderi";"no";0;0;0;55,7046;12,5901
1790;"Gamle Kalkbrænderi";"no";0;0;0;55,7046;12,5901
1791;"Gamle Kalkbrænderi";"no";0;0;0;55,7046;12,5901
1792;"Gamle Kalkbrænderi";"no";0;0;0;55,7046;12,5901
1793;"Gamle Kalkbrænderi";"no";0;0;0;55,7046;12,5901
1794;"Gamle Kalkbrænderi";"no";0;0;0;55,7046;12,5901
1795;"Gamle Kalkbrænderi";"no";0;0;0;55,7046;12,5901
1796;"Gamle Kalkbrænderi";"no";0;0;0;55,7046;12,5901
1797;"Gamle Kalkbrænderi";"no";0;0;0;55,7046;12,5901
1798;"Gamle Kalkbrænderi";"no";0;0;0;55,7046;12,5901
1799;"Gamle Kalkbrænderi";"no";0;0;0;55,7046;12,5901
1800;"Gamle Kalkbrænderi";"no";0;0;0;55,7046;12,5901
1801;"Gamle Kalkbrænderi";"no";0;0;0;55,7046;12,5901
1802;"Gamle Kalkbrænderi";"no";0;0;0;55,7046;12,5901
1803;"Gamle Kalkbrænderi";"no";0;0;0;55,7046;12,5901
1804;"Gamle Kalkbrænderi";"no";0;0;0;55,7046;12,5901
1805;"Gamle Kalkbrænderi";"no";0;0;0;55,7046;12,5901
1806;"Gamle Kalkbrænderi";"no";0;0;0;55,7046;12,5901
1807;"Gamle Kalkbrænderi";"no";0;0;0;55,7046;12,5901
1808;"Gamle Kalkbrænderi";"no";0;0;0;55,7046;12,5901
1809;"Gamle Kalkbrænderi";"no";0;0;0;55,7046;12,5901
1810;"Gamle Kalkbrænderi";"no";0;0;0;55,7046;12,5901
1811;"Gamle Kalkbrænderi";"no";0;0;0;55,7046;12,5901
1812;"Gamle Kalkbrænderi";"no";0;0;0;55,7046;12,5901
1813;"Gamle Kalkbrænderi";"no";0;0;0;55,7046;12,5901
1814;"Gamle Kalkbrænderi";"no";0;0;0;55,7046;12,5901
1815;"Gamle Kalkbrænderi";"no";0;0;0;55,7046;12,5901
1816;"Gamle Kalkbrænderi";"no";0;0;0;55,7046;12,5901
1817;"Gamle Kalkbrænderi";"no";0;0;0;55,7046;12,5901
1818;"Gamle Kalkbrænderi";"no";0;0;0;55,7046;12,5901
1819;"Gamle Kalkbrænderi";"no";0;0;0;55,7046;12,5901
1820;"Gamle Kalkbrænderi";"no";0;0;0;55,7046;12,5901
1821;"Gamle Kalkbrænderi";"no";0;0;0;55,7046;12,5901
1822;"Gamle Kalkbrænderi";"no";0;0;0;55,7046;12,5901
1823;"Gamle Kalkbrænderi";"no";0;0;0;55,7046;12,5901
1824;"Gamle Kalkbrænderi";"no";0;0;0;55,7046;12,5901
1825;"Gamle Kalkbrænderi";"no";0;0;0;55,7046;12,5901
1826;"Gamle Kalkbrænderi";"no";0;0;0;55,7046;12,5901
1827;"Gamle Kalkbrænderi";"no";0;0;0;55,7046;12,5901
1828;"Gamle Kalkbrænderi";"no";0;0;0;55,7046;12,5901
1829;"Gamle Kalkbrænderi";"no";0;0;0;55,7046;12,5901
1830;"Gamle Kalkbrænderi";"no";0;0;0;55,7046;12,5901
1831;"Gamle Kalkbrænderi";"no";0;0;0;55,7046;12,5901
1832;"Gamle Kalkbrænderi";"no";0;0;0;55,7046;12,5901
1833;"Gamle Kalkbrænderi";"no";0;0;0;55,7046;12,5901
1834;"Gamle Kalkbrænderi";"no";0;0;0;55,7046;12,5901
1835;"Gamle Kalkbrænderi";"no";0;0;0;55,7046;12,5901
1836;"Gamle Kalkbrænderi";"no";0;0;0;55,7046;12,5901
1837;"Gamle Kalkbrænderi";"no";0;0;0;55,7046;12,5901
1838;"Gamle Kalkbrænderi";"no";0;0;0;55,7046;12,5901
1839;"Gamle Kalkbrænderi";"no";0;0;0;55,7046;12,5901
1840;"Gamle Kalkbrænderi";"no";0;0;0;55,7046;12,5901
1841;"Gamle Kalkbrænderi";"no";0;0;0;55,7046;12,5901
1842;"Gamle Kalkbrænderi";"no";0;0;0;55,7046;12,5901
1843;"Gamle Kalkbrænderi";"no";0;0;0;55,7046;12,5901
1844;"Gamle Kalkbrænderi";"no";0;0;0;55,7046;12,5901
1845;"Gamle Kalkbrænderi";"no";0;0;0;55,7046;12,5901
1846;"Gamle Kalkbrænderi";"no";0;0;0;55,7046;12,5901
1847;"Gamle Kalkbrænderi";"no";0;0;0;55,7046;12,5901
1848;"Gamle Kalkbrænderi";"no";0;0;0;55,7046;12,5901
1849;"Gamle Kalkbrænderi";"no";0;0;0;55,7046;12,5901
1850;"Gamle Kalkbrænderi";"no";0;1;1;55,7046;12,5901
1851;"Gamle Kalkbrænderi";"no";0;1;1;55,7046;12,5901
1852;"Gamle Kalkbrænderi";"no";0;2;2;55,7046;12,5901
1853;"Gamle Kalkbrænderi";"no";0;3;3;55,7046;12,5901
1854;"Gamle Kalkbrænderi";"no";0;3;3;55,7046;12,5901
1855;"Gamle Kalkbrænderi";"no";0;1;1;55,7046;12,5901
1856;"Gamle Kalkbrænderi";"no";0;0;0;55,7046;12,5901
1857;"Gamle Kalkbrænderi";"no";0;0;0;55,7046;12,5901
1634;"Nakke";"no";0;0;0;55,923333;11,730277
1635;"Nakke";"no";0;0;0;55,923333;11,730277
1636;"Nakke";"no";0;0;0;55,923333;11,730277
1637;"Nakke";"no";0;0;0;55,923333;11,730277
1638;"Nakke";"no";0;0;0;55,923333;11,730277
1639;"Nakke";"no";0;0;0;55,923333;11,730277
1640;"Nakke";"no";0;0;0;55,923333;11,730277
1641;"Nakke";"no";0;0;0;55,923333;11,730277
1642;"Nakke";"no";0;0;0;55,923333;11,730277
1643;"Nakke";"no";0;0;0;55,923333;11,730277
1644;"Nakke";"no";0;0;0;55,923333;11,730277
1645;"Nakke";"no";0;0;0;55,923333;11,730277
1646;"Nakke";"no";0;0;0;55,923333;11,730277
1647;"Nakke";"no";0;0;0;55,923333;11,730277
1648;"Nakke";"no";0;0;0;55,923333;11,730277
1649;"Nakke";"no";0;0;0;55,923333;11,730277
1650;"Nakke";"no";0;0;0;55,923333;11,730277
1651;"Nakke";"no";0;0;0;55,923333;11,730277
1652;"Nakke";"no";0;0;0;55,923333;11,730277
1653;"Nakke";"no";0;0;0;55,923333;11,730277
1654;"Nakke";"no";0;0;0;55,923333;11,730277
1655;"Nakke";"no";0;0;0;55,923333;11,730277
1656;"Nakke";"no";0;0;0;55,923333;11,730277
1657;"Nakke";"no";0;0;0;55,923333;11,730277
1658;"Nakke";"no";0;0;0;55,923333;11,730277
1659;"Nakke";"no";0;0;0;55,923333;11,730277
1660;"Nakke";"no";0;0;0;55,923333;11,730277
1661;"Nakke";"no";0;0;0;55,923333;11,730277
1662;"Nakke";"no";0;0;0;55,923333;11,730277
1663;"Nakke";"no";0;0;0;55,923333;11,730277
1664;"Nakke";"no";0;0;0;55,923333;11,730277
1665;"Nakke";"no";0;0;0;55,923333;11,730277
1666;"Nakke";"no";0;0;0;55,923333;11,730277
1667;"Nakke";"no";0;0;0;55,923333;11,730277
1668;"Nakke";"no";0;0;0;55,923333;11,730277
1669;"Nakke";"no";0;0;0;55,923333;11,730277
1670;"Nakke";"no";0;0;0;55,923333;11,730277
1671;"Nakke";"no";0;0;0;55,923333;11,730277
1672;"Nakke";"no";0;0;0;55,923333;11,730277
1673;"Nakke";"no";0;0;0;55,923333;11,730277
1674;"Nakke";"no";0;0;0;55,923333;11,730277
1675;"Nakke";"no";0;0;0;55,923333;11,730277
1676;"Nakke";"no";0;0;0;55,923333;11,730277
1677;"Nakke";"no";0;0;0;55,923333;11,730277
1678;"Nakke";"no";0;0;0;55,923333;11,730277
1679;"Nakke";"no";0;0;0;55,923333;11,730277
1680;"Nakke";"no";0;0;0;55,923333;11,730277
1681;"Nakke";"no";0;0;0;55,923333;11,730277
1682;"Nakke";"no";0;0;0;55,923333;11,730277
1683;"Nakke";"no";0;0;0;55,923333;11,730277
1684;"Nakke";"no";0;0;0;55,923333;11,730277
1685;"Nakke";"no";0;0;0;55,923333;11,730277
1686;"Nakke";"no";0;0;0;55,923333;11,730277
1687;"Nakke";"no";0;0;0;55,923333;11,730277
1688;"Nakke";"no";0;0;0;55,923333;11,730277
1689;"Nakke";"no";0;0;0;55,923333;11,730277
1690;"Nakke";"no";0;0;0;55,923333;11,730277
1691;"Nakke";"no";0;0;0;55,923333;11,730277
1692;"Nakke";"no";0;0;0;55,923333;11,730277
1693;"Nakke";"no";0;0;0;55,923333;11,730277
1694;"Nakke";"no";0;0;0;55,923333;11,730277
1695;"Nakke";"no";0;0;0;55,923333;11,730277
1696;"Nakke";"no";0;0;0;55,923333;11,730277
1697;"Nakke";"no";0;0;0;55,923333;11,730277
1698;"Nakke";"no";0;0;0;55,923333;11,730277
1699;"Nakke";"no";0;0;0;55,923333;11,730277
1700;"Nakke";"no";0;0;0;55,923333;11,730277
1701;"Nakke";"no";0;0;0;55,923333;11,730277
1702;"Nakke";"no";0;0;0;55,923333;11,730277
1703;"Nakke";"no";0;0;0;55,923333;11,730277
1704;"Nakke";"no";0;0;0;55,923333;11,730277
1705;"Nakke";"no";0;0;0;55,923333;11,730277
1706;"Nakke";"no";0;0;0;55,923333;11,730277
1707;"Nakke";"no";0;0;0;55,923333;11,730277
1708;"Nakke";"no";0;0;0;55,923333;11,730277
1709;"Nakke";"no";0;0;0;55,923333;11,730277
1710;"Nakke";"no";0;0;0;55,923333;11,730277
1711;"Nakke";"no";0;0;0;55,923333;11,730277
1712;"Nakke";"no";0;0;0;55,923333;11,730277
1713;"Nakke";"no";0;0;0;55,923333;11,730277
1714;"Nakke";"no";0;0;0;55,923333;11,730277
1715;"Nakke";"no";0;0;0;55,923333;11,730277
1716;"Nakke";"no";0;0;0;55,923333;11,730277
1717;"Nakke";"no";0;0;0;55,923333;11,730277
1718;"Nakke";"no";0;0;0;55,923333;11,730277
1719;"Nakke";"no";0;0;0;55,923333;11,730277
1720;"Nakke";"no";0;0;0;55,923333;11,730277
1721;"Nakke";"no";0;0;0;55,923333;11,730277
1722;"Nakke";"no";0;0;0;55,923333;11,730277
1723;"Nakke";"no";0;0;0;55,923333;11,730277
1724;"Nakke";"no";0;0;0;55,923333;11,730277
1725;"Nakke";"no";0;0;0;55,923333;11,730277
1726;"Nakke";"no";0;0;0;55,923333;11,730277
1727;"Nakke";"no";0;0;0;55,923333;11,730277
1728;"Nakke";"no";0;0;0;55,923333;11,730277
1729;"Nakke";"no";0;0;0;55,923333;11,730277
1730;"Nakke";"no";0;0;0;55,923333;11,730277
1731;"Nakke";"no";0;0;0;55,923333;11,730277
1732;"Nakke";"no";0;0;0;55,923333;11,730277
1733;"Nakke";"no";0;0;0;55,923333;11,730277
1734;"Nakke";"no";0;0;0;55,923333;11,730277
1735;"Nakke";"no";0;0;0;55,923333;11,730277
1736;"Nakke";"no";0;0;0;55,923333;11,730277
1737;"Nakke";"no";0;0;0;55,923333;11,730277
1738;"Nakke";"no";0;0;0;55,923333;11,730277
1739;"Nakke";"no";0;0;0;55,923333;11,730277
1740;"Nakke";"no";0;0;0;55,923333;11,730277
1741;"Nakke";"no";0;0;0;55,923333;11,730277
1742;"Nakke";"no";0;0;0;55,923333;11,730277
1743;"Nakke";"no";0;0;0;55,923333;11,730277
1744;"Nakke";"no";0;0;0;55,923333;11,730277
1745;"Nakke";"no";0;0;0;55,923333;11,730277
1746;"Nakke";"no";0;0;0;55,923333;11,730277
1747;"Nakke";"no";0;0;0;55,923333;11,730277
1748;"Nakke";"no";0;0;0;55,923333;11,730277
1749;"Nakke";"no";0;0;0;55,923333;11,730277
1750;"Nakke";"no";0;0;0;55,923333;11,730277
1751;"Nakke";"no";0;0;0;55,923333;11,730277
1752;"Nakke";"no";0;0;0;55,923333;11,730277
1753;"Nakke";"no";0;0;0;55,923333;11,730277
1754;"Nakke";"no";0;0;0;55,923333;11,730277
1755;"Nakke";"no";0;0;0;55,923333;11,730277
1756;"Nakke";"no";0;0;0;55,923333;11,730277
1757;"Nakke";"no";0;0;0;55,923333;11,730277
1758;"Nakke";"no";0;0;0;55,923333;11,730277
1759;"Nakke";"no";0;0;0;55,923333;11,730277
1760;"Nakke";"no";0;0;0;55,923333;11,730277
1761;"Nakke";"no";0;0;0;55,923333;11,730277
1762;"Nakke";"no";0;0;0;55,923333;11,730277
1763;"Nakke";"no";0;0;0;55,923333;11,730277
1764;"Nakke";"no";0;0;0;55,923333;11,730277
1765;"Nakke";"no";0;0;0;55,923333;11,730277
1766;"Nakke";"no";0;0;0;55,923333;11,730277
1767;"Nakke";"no";0;0;0;55,923333;11,730277
1768;"Nakke";"no";0;0;0;55,923333;11,730277
1769;"Nakke";"no";0;0;0;55,923333;11,730277
1770;"Nakke";"no";0;0;0;55,923333;11,730277
1771;"Nakke";"no";0;0;0;55,923333;11,730277
1772;"Nakke";"no";0;0;0;55,923333;11,730277
1773;"Nakke";"no";0;0;0;55,923333;11,730277
1774;"Nakke";"no";0;0;0;55,923333;11,730277
1775;"Nakke";"no";0;0;0;55,923333;11,730277
1776;"Nakke";"no";0;0;0;55,923333;11,730277
1777;"Nakke";"no";0;0;0;55,923333;11,730277
1778;"Nakke";"no";0;0;0;55,923333;11,730277
1779;"Nakke";"no";0;0;0;55,923333;11,730277
1780;"Nakke";"no";0;0;0;55,923333;11,730277
1781;"Nakke";"no";0;0;0;55,923333;11,730277
1782;"Nakke";"no";0;0;0;55,923333;11,730277
1783;"Nakke";"no";0;0;0;55,923333;11,730277
1784;"Nakke";"no";0;0;0;55,923333;11,730277
1785;"Nakke";"no";0;0;0;55,923333;11,730277
1786;"Nakke";"no";0;0;0;55,923333;11,730277
1787;"Nakke";"no";0;0;0;55,923333;11,730277
1788;"Nakke";"no";0;0;0;55,923333;11,730277
1789;"Nakke";"no";0;0;0;55,923333;11,730277
1790;"Nakke";"no";0;0;0;55,923333;11,730277
1791;"Nakke";"no";0;0;0;55,923333;11,730277
1792;"Nakke";"no";0;0;0;55,923333;11,730277
1793;"Nakke";"no";0;0;0;55,923333;11,730277
1794;"Nakke";"no";0;0;0;55,923333;11,730277
1795;"Nakke";"no";0;0;0;55,923333;11,730277
1796;"Nakke";"no";0;0;0;55,923333;11,730277
1797;"Nakke";"no";0;0;0;55,923333;11,730277
1798;"Nakke";"no";0;0;0;55,923333;11,730277
1799;"Nakke";"no";0;0;0;55,923333;11,730277
1800;"Nakke";"no";0;0;0;55,923333;11,730277
1801;"Nakke";"no";0;0;0;55,923333;11,730277
1802;"Nakke";"no";0;0;0;55,923333;11,730277
1803;"Nakke";"no";0;0;0;55,923333;11,730277
1804;"Nakke";"no";0;0;0;55,923333;11,730277
1805;"Nakke";"no";0;0;0;55,923333;11,730277
1806;"Nakke";"no";0;0;0;55,923333;11,730277
1807;"Nakke";"no";0;0;0;55,923333;11,730277
1808;"Nakke";"no";0;0;0;55,923333;11,730277
1809;"Nakke";"no";0;0;0;55,923333;11,730277
1810;"Nakke";"no";0;0;0;55,923333;11,730277
1811;"Nakke";"no";0;0;0;55,923333;11,730277
1812;"Nakke";"no";0;0;0;55,923333;11,730277
1813;"Nakke";"no";0;0;0;55,923333;11,730277
1814;"Nakke";"no";0;0;0;55,923333;11,730277
1815;"Nakke";"no";0;0;0;55,923333;11,730277
1816;"Nakke";"no";0;0;0;55,923333;11,730277
1817;"Nakke";"no";0;0;0;55,923333;11,730277
1818;"Nakke";"no";0;0;0;55,923333;11,730277
1819;"Nakke";"no";0;0;0;55,923333;11,730277
1820;"Nakke";"no";0;0;0;55,923333;11,730277
1821;"Nakke";"no";0;0;0;55,923333;11,730277
1822;"Nakke";"no";0;0;0;55,923333;11,730277
1823;"Nakke";"no";0;0;0;55,923333;11,730277
1824;"Nakke";"no";0;0;0;55,923333;11,730277
1825;"Nakke";"no";0;0;0;55,923333;11,730277
1826;"Nakke";"no";0;0;0;55,923333;11,730277
1827;"Nakke";"no";0;0;0;55,923333;11,730277
1828;"Nakke";"no";0;0;0;55,923333;11,730277
1829;"Nakke";"no";0;0;0;55,923333;11,730277
1830;"Nakke";"no";0;0;0;55,923333;11,730277
1831;"Nakke";"no";0;0;0;55,923333;11,730277
1832;"Nakke";"no";0;0;0;55,923333;11,730277
1833;"Nakke";"no";0;0;0;55,923333;11,730277
1834;"Nakke";"no";0;0;0;55,923333;11,730277
1835;"Nakke";"no";0;0;0;55,923333;11,730277
1836;"Nakke";"no";0;0;0;55,923333;11,730277
1837;"Nakke";"no";0;0;0;55,923333;11,730277
1838;"Nakke";"no";0;0;0;55,923333;11,730277
1839;"Nakke";"no";0;0;0;55,923333;11,730277
1840;"Nakke";"no";0;0;0;55,923333;11,730277
1841;"Nakke";"no";0;0;0;55,923333;11,730277
1842;"Nakke";"no";0;0;0;55,923333;11,730277
1843;"Nakke";"no";0;0;0;55,923333;11,730277
1844;"Nakke";"no";0;0;0;55,923333;11,730277
1845;"Nakke";"no";0;0;0;55,923333;11,730277
1846;"Nakke";"no";0;0;0;55,923333;11,730277
1847;"Nakke";"no";0;0;0;55,923333;11,730277
1848;"Nakke";"no";0;0;0;55,923333;11,730277
1849;"Nakke";"no";0;0;0;55,923333;11,730277
1850;"Nakke";"no";0;0;0;55,923333;11,730277
1851;"Nakke";"no";0;1;1;55,923333;11,730277
1852;"Nakke";"no";0;0;0;55,923333;11,730277
1853;"Nakke";"no";0;0;0;55,923333;11,730277
1854;"Nakke";"no";0;0;0;55,923333;11,730277
1855;"Nakke";"no";0;0;0;55,923333;11,730277
1856;"Nakke";"no";0;0;0;55,923333;11,730277
1857;"Nakke";"no";0;0;0;55,923333;11,730277
1634;"Struer";"west";0;0;0;56,491111;8,583611
1635;"Struer";"west";0;0;0;56,491111;8,583611
1636;"Struer";"west";0;0;0;56,491111;8,583611
1637;"Struer";"west";0;0;0;56,491111;8,583611
1638;"Struer";"west";0;0;0;56,491111;8,583611
1639;"Struer";"west";0;0;0;56,491111;8,583611
1640;"Struer";"west";0;0;0;56,491111;8,583611
1641;"Struer";"west";0;0;0;56,491111;8,583611
1642;"Struer";"west";0;0;0;56,491111;8,583611
1643;"Struer";"west";0;0;0;56,491111;8,583611
1644;"Struer";"west";0;0;0;56,491111;8,583611
1645;"Struer";"west";0;0;0;56,491111;8,583611
1646;"Struer";"west";0;0;0;56,491111;8,583611
1647;"Struer";"west";0;0;0;56,491111;8,583611
1648;"Struer";"west";0;0;0;56,491111;8,583611
1649;"Struer";"west";0;0;0;56,491111;8,583611
1650;"Struer";"west";0;0;0;56,491111;8,583611
1651;"Struer";"west";0;0;0;56,491111;8,583611
1652;"Struer";"west";0;0;0;56,491111;8,583611
1653;"Struer";"west";0;0;0;56,491111;8,583611
1654;"Struer";"west";0;0;0;56,491111;8,583611
1655;"Struer";"west";0;0;0;56,491111;8,583611
1656;"Struer";"west";0;0;0;56,491111;8,583611
1657;"Struer";"west";0;0;0;56,491111;8,583611
1658;"Struer";"west";0;0;0;56,491111;8,583611
1659;"Struer";"west";0;0;0;56,491111;8,583611
1660;"Struer";"west";0;0;0;56,491111;8,583611
1661;"Struer";"west";0;0;0;56,491111;8,583611
1662;"Struer";"west";0;0;0;56,491111;8,583611
1663;"Struer";"west";0;0;0;56,491111;8,583611
1664;"Struer";"west";0;0;0;56,491111;8,583611
1665;"Struer";"west";0;0;0;56,491111;8,583611
1666;"Struer";"west";0;0;0;56,491111;8,583611
1667;"Struer";"west";0;0;0;56,491111;8,583611
1668;"Struer";"west";0;0;0;56,491111;8,583611
1669;"Struer";"west";0;0;0;56,491111;8,583611
1670;"Struer";"west";0;0;0;56,491111;8,583611
1671;"Struer";"west";0;0;0;56,491111;8,583611
1672;"Struer";"west";0;0;0;56,491111;8,583611
1673;"Struer";"west";0;0;0;56,491111;8,583611
1674;"Struer";"west";0;0;0;56,491111;8,583611
1675;"Struer";"west";0;0;0;56,491111;8,583611
1676;"Struer";"west";0;0;0;56,491111;8,583611
1677;"Struer";"west";0;0;0;56,491111;8,583611
1678;"Struer";"west";0;0;0;56,491111;8,583611
1679;"Struer";"west";0;0;0;56,491111;8,583611
1680;"Struer";"west";0;0;0;56,491111;8,583611
1681;"Struer";"west";0;0;0;56,491111;8,583611
1682;"Struer";"west";0;0;0;56,491111;8,583611
1683;"Struer";"west";0;0;0;56,491111;8,583611
1684;"Struer";"west";0;0;0;56,491111;8,583611
1685;"Struer";"west";0;0;0;56,491111;8,583611
1686;"Struer";"west";0;0;0;56,491111;8,583611
1687;"Struer";"west";0;0;0;56,491111;8,583611
1688;"Struer";"west";0;0;0;56,491111;8,583611
1689;"Struer";"west";0;0;0;56,491111;8,583611
1690;"Struer";"west";0;0;0;56,491111;8,583611
1691;"Struer";"west";0;0;0;56,491111;8,583611
1692;"Struer";"west";0;0;0;56,491111;8,583611
1693;"Struer";"west";0;0;0;56,491111;8,583611
1694;"Struer";"west";0;0;0;56,491111;8,583611
1695;"Struer";"west";0;0;0;56,491111;8,583611
1696;"Struer";"west";0;0;0;56,491111;8,583611
1697;"Struer";"west";0;0;0;56,491111;8,583611
1698;"Struer";"west";0;0;0;56,491111;8,583611
1699;"Struer";"west";0;0;0;56,491111;8,583611
1700;"Struer";"west";0;0;0;56,491111;8,583611
1701;"Struer";"west";0;0;0;56,491111;8,583611
1702;"Struer";"west";0;0;0;56,491111;8,583611
1703;"Struer";"west";0;0;0;56,491111;8,583611
1704;"Struer";"west";0;0;0;56,491111;8,583611
1705;"Struer";"west";0;0;0;56,491111;8,583611
1706;"Struer";"west";0;0;0;56,491111;8,583611
1707;"Struer";"west";0;0;0;56,491111;8,583611
1708;"Struer";"west";0;0;0;56,491111;8,583611
1709;"Struer";"west";0;0;0;56,491111;8,583611
1710;"Struer";"west";0;0;0;56,491111;8,583611
1711;"Struer";"west";0;0;0;56,491111;8,583611
1712;"Struer";"west";0;0;0;56,491111;8,583611
1713;"Struer";"west";0;0;0;56,491111;8,583611
1714;"Struer";"west";0;0;0;56,491111;8,583611
1715;"Struer";"west";0;0;0;56,491111;8,583611
1716;"Struer";"west";0;0;0;56,491111;8,583611
1717;"Struer";"west";0;0;0;56,491111;8,583611
1718;"Struer";"west";0;0;0;56,491111;8,583611
1719;"Struer";"west";0;0;0;56,491111;8,583611
1720;"Struer";"west";0;0;0;56,491111;8,583611
1721;"Struer";"west";0;0;0;56,491111;8,583611
1722;"Struer";"west";0;0;0;56,491111;8,583611
1723;"Struer";"west";0;0;0;56,491111;8,583611
1724;"Struer";"west";0;0;0;56,491111;8,583611
1725;"Struer";"west";0;0;0;56,491111;8,583611
1726;"Struer";"west";0;0;0;56,491111;8,583611
1727;"Struer";"west";0;0;0;56,491111;8,583611
1728;"Struer";"west";0;0;0;56,491111;8,583611
1729;"Struer";"west";0;0;0;56,491111;8,583611
1730;"Struer";"west";0;0;0;56,491111;8,583611
1731;"Struer";"west";0;0;0;56,491111;8,583611
1732;"Struer";"west";0;0;0;56,491111;8,583611
1733;"Struer";"west";0;0;0;56,491111;8,583611
1734;"Struer";"west";0;0;0;56,491111;8,583611
1735;"Struer";"west";0;0;0;56,491111;8,583611
1736;"Struer";"west";0;0;0;56,491111;8,583611
1737;"Struer";"west";0;0;0;56,491111;8,583611
1738;"Struer";"west";0;0;0;56,491111;8,583611
1739;"Struer";"west";0;0;0;56,491111;8,583611
1740;"Struer";"west";0;0;0;56,491111;8,583611
1741;"Struer";"west";0;0;0;56,491111;8,583611
1742;"Struer";"west";0;0;0;56,491111;8,583611
1743;"Struer";"west";0;0;0;56,491111;8,583611
1744;"Struer";"west";0;0;0;56,491111;8,583611
1745;"Struer";"west";0;0;0;56,491111;8,583611
1746;"Struer";"west";0;0;0;56,491111;8,583611
1747;"Struer";"west";0;0;0;56,491111;8,583611
1748;"Struer";"west";0;0;0;56,491111;8,583611
1749;"Struer";"west";0;0;0;56,491111;8,583611
1750;"Struer";"west";0;0;0;56,491111;8,583611
1751;"Struer";"west";0;0;0;56,491111;8,583611
1752;"Struer";"west";0;0;0;56,491111;8,583611
1753;"Struer";"west";0;0;0;56,491111;8,583611
1754;"Struer";"west";0;0;0;56,491111;8,583611
1755;"Struer";"west";0;0;0;56,491111;8,583611
1756;"Struer";"west";0;0;0;56,491111;8,583611
1757;"Struer";"west";0;0;0;56,491111;8,583611
1758;"Struer";"west";0;0;0;56,491111;8,583611
1759;"Struer";"west";0;0;0;56,491111;8,583611
1760;"Struer";"west";0;0;0;56,491111;8,583611
1761;"Struer";"west";0;0;0;56,491111;8,583611
1762;"Struer";"west";0;0;0;56,491111;8,583611
1763;"Struer";"west";0;0;0;56,491111;8,583611
1764;"Struer";"west";0;0;0;56,491111;8,583611
1765;"Struer";"west";0;0;0;56,491111;8,583611
1766;"Struer";"west";0;0;0;56,491111;8,583611
1767;"Struer";"west";0;0;0;56,491111;8,583611
1768;"Struer";"west";0;0;0;56,491111;8,583611
1769;"Struer";"west";0;0;0;56,491111;8,583611
1770;"Struer";"west";0;0;0;56,491111;8,583611
1771;"Struer";"west";0;0;0;56,491111;8,583611
1772;"Struer";"west";0;0;0;56,491111;8,583611
1773;"Struer";"west";0;0;0;56,491111;8,583611
1774;"Struer";"west";0;0;0;56,491111;8,583611
1775;"Struer";"west";0;0;0;56,491111;8,583611
1776;"Struer";"west";0;0;0;56,491111;8,583611
1777;"Struer";"west";0;0;0;56,491111;8,583611
1778;"Struer";"west";0;0;0;56,491111;8,583611
1779;"Struer";"west";0;0;0;56,491111;8,583611
1780;"Struer";"west";0;0;0;56,491111;8,583611
1781;"Struer";"west";0;0;0;56,491111;8,583611
1782;"Struer";"west";0;0;0;56,491111;8,583611
1783;"Struer";"west";0;0;0;56,491111;8,583611
1784;"Struer";"west";0;0;0;56,491111;8,583611
1785;"Struer";"west";0;0;0;56,491111;8,583611
1786;"Struer";"west";0;0;0;56,491111;8,583611
1787;"Struer";"west";0;0;0;56,491111;8,583611
1788;"Struer";"west";0;0;0;56,491111;8,583611
1789;"Struer";"west";0;0;0;56,491111;8,583611
1790;"Struer";"west";0;0;0;56,491111;8,583611
1791;"Struer";"west";0;0;0;56,491111;8,583611
1792;"Struer";"west";0;0;0;56,491111;8,583611
1793;"Struer";"west";0;0;0;56,491111;8,583611
1794;"Struer";"west";0;0;0;56,491111;8,583611
1795;"Struer";"west";0;0;0;56,491111;8,583611
1796;"Struer";"west";0;0;0;56,491111;8,583611
1797;"Struer";"west";0;0;0;56,491111;8,583611
1798;"Struer";"west";0;0;0;56,491111;8,583611
1799;"Struer";"west";0;0;0;56,491111;8,583611
1800;"Struer";"west";0;0;0;56,491111;8,583611
1801;"Struer";"west";0;0;0;56,491111;8,583611
1802;"Struer";"west";0;0;0;56,491111;8,583611
1803;"Struer";"west";0;0;0;56,491111;8,583611
1804;"Struer";"west";0;0;0;56,491111;8,583611
1805;"Struer";"west";0;0;0;56,491111;8,583611
1806;"Struer";"west";0;0;0;56,491111;8,583611
1807;"Struer";"west";0;0;0;56,491111;8,583611
1808;"Struer";"west";0;0;0;56,491111;8,583611
1809;"Struer";"west";0;0;0;56,491111;8,583611
1810;"Struer";"west";0;0;0;56,491111;8,583611
1811;"Struer";"west";0;0;0;56,491111;8,583611
1812;"Struer";"west";0;0;0;56,491111;8,583611
1813;"Struer";"west";0;0;0;56,491111;8,583611
1814;"Struer";"west";0;0;0;56,491111;8,583611
1815;"Struer";"west";0;0;0;56,491111;8,583611
1816;"Struer";"west";0;0;0;56,491111;8,583611
1817;"Struer";"west";0;0;0;56,491111;8,583611
1818;"Struer";"west";0;0;0;56,491111;8,583611
1819;"Struer";"west";0;0;0;56,491111;8,583611
1820;"Struer";"west";0;0;0;56,491111;8,583611
1821;"Struer";"west";0;0;0;56,491111;8,583611
1822;"Struer";"west";0;0;0;56,491111;8,583611
1823;"Struer";"west";0;0;0;56,491111;8,583611
1824;"Struer";"west";0;0;0;56,491111;8,583611
1825;"Struer";"west";0;0;0;56,491111;8,583611
1826;"Struer";"west";0;0;0;56,491111;8,583611
1827;"Struer";"west";0;0;0;56,491111;8,583611
1828;"Struer";"west";0;0;0;56,491111;8,583611
1829;"Struer";"west";0;0;0;56,491111;8,583611
1830;"Struer";"west";0;0;0;56,491111;8,583611
1831;"Struer";"west";0;0;0;56,491111;8,583611
1832;"Struer";"west";0;0;0;56,491111;8,583611
1833;"Struer";"west";0;0;0;56,491111;8,583611
1834;"Struer";"west";0;0;0;56,491111;8,583611
1835;"Struer";"west";0;0;0;56,491111;8,583611
1836;"Struer";"west";0;0;0;56,491111;8,583611
1837;"Struer";"west";0;0;0;56,491111;8,583611
1838;"Struer";"west";0;0;0;56,491111;8,583611
1839;"Struer";"west";0;0;0;56,491111;8,583611
1840;"Struer";"west";0;0;0;56,491111;8,583611
1841;"Struer";"west";0;0;0;56,491111;8,583611
1842;"Struer";"west";0;0;0;56,491111;8,583611
1843;"Struer";"west";0;0;0;56,491111;8,583611
1844;"Struer";"west";0;0;0;56,491111;8,583611
1845;"Struer";"west";0;0;0;56,491111;8,583611
1846;"Struer";"west";0;0;0;56,491111;8,583611
1847;"Struer";"west";0;0;0;56,491111;8,583611
1848;"Struer";"west";0;0;0;56,491111;8,583611
1849;"Struer";"west";0;0;0;56,491111;8,583611
1850;"Struer";"west";0;0;0;56,491111;8,583611
1851;"Struer";"west";0;2;2;56,491111;8,583611
1852;"Struer";"west";0;0;0;56,491111;8,583611
1853;"Struer";"west";0;1;1;56,491111;8,583611
1854;"Struer";"west";0;0;0;56,491111;8,583611
1855;"Struer";"west";0;0;0;56,491111;8,583611
1856;"Struer";"west";0;0;0;56,491111;8,583611
1857;"Struer";"west";0;0;0;56,491111;8,583611
1634;"Varde";"no";0;0;0;55,621111;8,480555
1635;"Varde";"no";0;0;0;55,621111;8,480555
1636;"Varde";"no";0;0;0;55,621111;8,480555
1637;"Varde";"no";0;0;0;55,621111;8,480555
1638;"Varde";"no";0;0;0;55,621111;8,480555
1639;"Varde";"no";0;0;0;55,621111;8,480555
1640;"Varde";"no";0;0;0;55,621111;8,480555
1641;"Varde";"no";0;0;0;55,621111;8,480555
1642;"Varde";"no";0;0;0;55,621111;8,480555
1643;"Varde";"no";0;0;0;55,621111;8,480555
1644;"Varde";"no";0;0;0;55,621111;8,480555
1645;"Varde";"no";0;0;0;55,621111;8,480555
1646;"Varde";"no";0;0;0;55,621111;8,480555
1647;"Varde";"no";0;0;0;55,621111;8,480555
1648;"Varde";"no";0;0;0;55,621111;8,480555
1649;"Varde";"no";0;0;0;55,621111;8,480555
1650;"Varde";"no";0;0;0;55,621111;8,480555
1651;"Varde";"no";0;0;0;55,621111;8,480555
1652;"Varde";"no";0;0;0;55,621111;8,480555
1653;"Varde";"no";0;0;0;55,621111;8,480555
1654;"Varde";"no";0;0;0;55,621111;8,480555
1655;"Varde";"no";0;0;0;55,621111;8,480555
1656;"Varde";"no";0;0;0;55,621111;8,480555
1657;"Varde";"no";0;0;0;55,621111;8,480555
1658;"Varde";"no";0;0;0;55,621111;8,480555
1659;"Varde";"no";0;0;0;55,621111;8,480555
1660;"Varde";"no";0;0;0;55,621111;8,480555
1661;"Varde";"no";0;0;0;55,621111;8,480555
1662;"Varde";"no";0;0;0;55,621111;8,480555
1663;"Varde";"no";0;0;0;55,621111;8,480555
1664;"Varde";"no";0;0;0;55,621111;8,480555
1665;"Varde";"no";0;0;0;55,621111;8,480555
1666;"Varde";"no";0;0;0;55,621111;8,480555
1667;"Varde";"no";0;0;0;55,621111;8,480555
1668;"Varde";"no";0;0;0;55,621111;8,480555
1669;"Varde";"no";0;0;0;55,621111;8,480555
1670;"Varde";"no";0;0;0;55,621111;8,480555
1671;"Varde";"no";0;0;0;55,621111;8,480555
1672;"Varde";"no";0;0;0;55,621111;8,480555
1673;"Varde";"no";0;0;0;55,621111;8,480555
1674;"Varde";"no";0;0;0;55,621111;8,480555
1675;"Varde";"no";0;0;0;55,621111;8,480555
1676;"Varde";"no";0;0;0;55,621111;8,480555
1677;"Varde";"no";0;0;0;55,621111;8,480555
1678;"Varde";"no";0;0;0;55,621111;8,480555
1679;"Varde";"no";0;0;0;55,621111;8,480555
1680;"Varde";"no";0;0;0;55,621111;8,480555
1681;"Varde";"no";0;0;0;55,621111;8,480555
1682;"Varde";"no";0;0;0;55,621111;8,480555
1683;"Varde";"no";0;0;0;55,621111;8,480555
1684;"Varde";"no";0;0;0;55,621111;8,480555
1685;"Varde";"no";0;0;0;55,621111;8,480555
1686;"Varde";"no";0;0;0;55,621111;8,480555
1687;"Varde";"no";0;0;0;55,621111;8,480555
1688;"Varde";"no";0;0;0;55,621111;8,480555
1689;"Varde";"no";0;0;0;55,621111;8,480555
1690;"Varde";"no";0;0;0;55,621111;8,480555
1691;"Varde";"no";0;0;0;55,621111;8,480555
1692;"Varde";"no";0;0;0;55,621111;8,480555
1693;"Varde";"no";0;0;0;55,621111;8,480555
1694;"Varde";"no";0;0;0;55,621111;8,480555
1695;"Varde";"no";0;0;0;55,621111;8,480555
1696;"Varde";"no";0;0;0;55,621111;8,480555
1697;"Varde";"no";0;0;0;55,621111;8,480555
1698;"Varde";"no";0;0;0;55,621111;8,480555
1699;"Varde";"no";0;0;0;55,621111;8,480555
1700;"Varde";"no";0;0;0;55,621111;8,480555
1701;"Varde";"no";0;0;0;55,621111;8,480555
1702;"Varde";"no";0;0;0;55,621111;8,480555
1703;"Varde";"no";0;0;0;55,621111;8,480555
1704;"Varde";"no";0;0;0;55,621111;8,480555
1705;"Varde";"no";0;0;0;55,621111;8,480555
1706;"Varde";"no";0;0;0;55,621111;8,480555
1707;"Varde";"no";0;0;0;55,621111;8,480555
1708;"Varde";"no";0;0;0;55,621111;8,480555
1709;"Varde";"no";0;0;0;55,621111;8,480555
1710;"Varde";"no";0;0;0;55,621111;8,480555
1711;"Varde";"no";0;0;0;55,621111;8,480555
1712;"Varde";"no";0;0;0;55,621111;8,480555
1713;"Varde";"no";0;0;0;55,621111;8,480555
1714;"Varde";"no";0;0;0;55,621111;8,480555
1715;"Varde";"no";0;0;0;55,621111;8,480555
1716;"Varde";"no";0;0;0;55,621111;8,480555
1717;"Varde";"no";0;0;0;55,621111;8,480555
1718;"Varde";"no";0;0;0;55,621111;8,480555
1719;"Varde";"no";0;0;0;55,621111;8,480555
1720;"Varde";"no";0;0;0;55,621111;8,480555
1721;"Varde";"no";0;0;0;55,621111;8,480555
1722;"Varde";"no";0;0;0;55,621111;8,480555
1723;"Varde";"no";0;0;0;55,621111;8,480555
1724;"Varde";"no";0;0;0;55,621111;8,480555
1725;"Varde";"no";0;0;0;55,621111;8,480555
1726;"Varde";"no";0;0;0;55,621111;8,480555
1727;"Varde";"no";0;0;0;55,621111;8,480555
1728;"Varde";"no";0;0;0;55,621111;8,480555
1729;"Varde";"no";0;0;0;55,621111;8,480555
1730;"Varde";"no";0;0;0;55,621111;8,480555
1731;"Varde";"no";0;0;0;55,621111;8,480555
1732;"Varde";"no";0;0;0;55,621111;8,480555
1733;"Varde";"no";0;0;0;55,621111;8,480555
1734;"Varde";"no";0;0;0;55,621111;8,480555
1735;"Varde";"no";0;0;0;55,621111;8,480555
1736;"Varde";"no";0;0;0;55,621111;8,480555
1737;"Varde";"no";0;0;0;55,621111;8,480555
1738;"Varde";"no";0;0;0;55,621111;8,480555
1739;"Varde";"no";0;0;0;55,621111;8,480555
1740;"Varde";"no";0;0;0;55,621111;8,480555
1741;"Varde";"no";0;0;0;55,621111;8,480555
1742;"Varde";"no";0;0;0;55,621111;8,480555
1743;"Varde";"no";0;0;0;55,621111;8,480555
1744;"Varde";"no";0;0;0;55,621111;8,480555
1745;"Varde";"no";0;0;0;55,621111;8,480555
1746;"Varde";"no";0;0;0;55,621111;8,480555
1747;"Varde";"no";0;0;0;55,621111;8,480555
1748;"Varde";"no";0;0;0;55,621111;8,480555
1749;"Varde";"no";0;0;0;55,621111;8,480555
1750;"Varde";"no";0;0;0;55,621111;8,480555
1751;"Varde";"no";0;0;0;55,621111;8,480555
1752;"Varde";"no";0;0;0;55,621111;8,480555
1753;"Varde";"no";0;0;0;55,621111;8,480555
1754;"Varde";"no";0;0;0;55,621111;8,480555
1755;"Varde";"no";0;0;0;55,621111;8,480555
1756;"Varde";"no";0;0;0;55,621111;8,480555
1757;"Varde";"no";0;0;0;55,621111;8,480555
1758;"Varde";"no";0;0;0;55,621111;8,480555
1759;"Varde";"no";0;0;0;55,621111;8,480555
1760;"Varde";"no";0;0;0;55,621111;8,480555
1761;"Varde";"no";0;0;0;55,621111;8,480555
1762;"Varde";"no";0;0;0;55,621111;8,480555
1763;"Varde";"no";0;0;0;55,621111;8,480555
1764;"Varde";"no";0;0;0;55,621111;8,480555
1765;"Varde";"no";0;0;0;55,621111;8,480555
1766;"Varde";"no";0;0;0;55,621111;8,480555
1767;"Varde";"no";0;0;0;55,621111;8,480555
1768;"Varde";"no";0;0;0;55,621111;8,480555
1769;"Varde";"no";0;0;0;55,621111;8,480555
1770;"Varde";"no";0;0;0;55,621111;8,480555
1771;"Varde";"no";0;0;0;55,621111;8,480555
1772;"Varde";"no";0;0;0;55,621111;8,480555
1773;"Varde";"no";0;0;0;55,621111;8,480555
1774;"Varde";"no";0;0;0;55,621111;8,480555
1775;"Varde";"no";0;0;0;55,621111;8,480555
1776;"Varde";"no";0;0;0;55,621111;8,480555
1777;"Varde";"no";0;0;0;55,621111;8,480555
1778;"Varde";"no";0;0;0;55,621111;8,480555
1779;"Varde";"no";0;0;0;55,621111;8,480555
1780;"Varde";"no";0;0;0;55,621111;8,480555
1781;"Varde";"no";0;0;0;55,621111;8,480555
1782;"Varde";"no";0;0;0;55,621111;8,480555
1783;"Varde";"no";0;0;0;55,621111;8,480555
1784;"Varde";"no";0;0;0;55,621111;8,480555
1785;"Varde";"no";0;0;0;55,621111;8,480555
1786;"Varde";"no";0;0;0;55,621111;8,480555
1787;"Varde";"no";0;0;0;55,621111;8,480555
1788;"Varde";"no";0;0;0;55,621111;8,480555
1789;"Varde";"no";0;0;0;55,621111;8,480555
1790;"Varde";"no";0;0;0;55,621111;8,480555
1791;"Varde";"no";0;0;0;55,621111;8,480555
1792;"Varde";"no";0;0;0;55,621111;8,480555
1793;"Varde";"no";0;0;0;55,621111;8,480555
1794;"Varde";"no";0;0;0;55,621111;8,480555
1795;"Varde";"no";0;0;0;55,621111;8,480555
1796;"Varde";"no";0;0;0;55,621111;8,480555
1797;"Varde";"no";0;0;0;55,621111;8,480555
1798;"Varde";"no";0;0;0;55,621111;8,480555
1799;"Varde";"no";0;0;0;55,621111;8,480555
1800;"Varde";"no";0;0;0;55,621111;8,480555
1801;"Varde";"no";0;0;0;55,621111;8,480555
1802;"Varde";"no";0;0;0;55,621111;8,480555
1803;"Varde";"no";0;0;0;55,621111;8,480555
1804;"Varde";"no";0;0;0;55,621111;8,480555
1805;"Varde";"no";0;0;0;55,621111;8,480555
1806;"Varde";"no";0;0;0;55,621111;8,480555
1807;"Varde";"no";0;0;0;55,621111;8,480555
1808;"Varde";"no";0;0;0;55,621111;8,480555
1809;"Varde";"no";0;0;0;55,621111;8,480555
1810;"Varde";"no";0;0;0;55,621111;8,480555
1811;"Varde";"no";0;0;0;55,621111;8,480555
1812;"Varde";"no";0;0;0;55,621111;8,480555
1813;"Varde";"no";0;0;0;55,621111;8,480555
1814;"Varde";"no";0;0;0;55,621111;8,480555
1815;"Varde";"no";0;0;0;55,621111;8,480555
1816;"Varde";"no";0;0;0;55,621111;8,480555
1817;"Varde";"no";0;0;0;55,621111;8,480555
1818;"Varde";"no";0;0;0;55,621111;8,480555
1819;"Varde";"no";0;0;0;55,621111;8,480555
1820;"Varde";"no";0;0;0;55,621111;8,480555
1821;"Varde";"no";0;0;0;55,621111;8,480555
1822;"Varde";"no";0;0;0;55,621111;8,480555
1823;"Varde";"no";0;0;0;55,621111;8,480555
1824;"Varde";"no";0;0;0;55,621111;8,480555
1825;"Varde";"no";0;0;0;55,621111;8,480555
1826;"Varde";"no";0;0;0;55,621111;8,480555
1827;"Varde";"no";0;0;0;55,621111;8,480555
1828;"Varde";"no";0;0;0;55,621111;8,480555
1829;"Varde";"no";0;0;0;55,621111;8,480555
1830;"Varde";"no";0;0;0;55,621111;8,480555
1831;"Varde";"no";0;0;0;55,621111;8,480555
1832;"Varde";"no";0;0;0;55,621111;8,480555
1833;"Varde";"no";0;0;0;55,621111;8,480555
1834;"Varde";"no";0;0;0;55,621111;8,480555
1835;"Varde";"no";0;0;0;55,621111;8,480555
1836;"Varde";"no";0;0;0;55,621111;8,480555
1837;"Varde";"no";0;0;0;55,621111;8,480555
1838;"Varde";"no";0;0;0;55,621111;8,480555
1839;"Varde";"no";0;0;0;55,621111;8,480555
1840;"Varde";"no";0;0;0;55,621111;8,480555
1841;"Varde";"no";0;0;0;55,621111;8,480555
1842;"Varde";"no";0;0;0;55,621111;8,480555
1843;"Varde";"no";0;0;0;55,621111;8,480555
1844;"Varde";"no";0;0;0;55,621111;8,480555
1845;"Varde";"no";0;0;0;55,621111;8,480555
1846;"Varde";"no";0;0;0;55,621111;8,480555
1847;"Varde";"no";0;0;0;55,621111;8,480555
1848;"Varde";"no";0;0;0;55,621111;8,480555
1849;"Varde";"no";0;0;0;55,621111;8,480555
1850;"Varde";"no";0;0;0;55,621111;8,480555
1851;"Varde";"no";0;0;0;55,621111;8,480555
1852;"Varde";"no";0;0;0;55,621111;8,480555
1853;"Varde";"no";0;0;0;55,621111;8,480555
1854;"Varde";"no";0;0;0;55,621111;8,480555
1855;"Varde";"no";0;1;1;55,621111;8,480555
1856;"Varde";"no";0;0;0;55,621111;8,480555
1857;"Varde";"no";0;0;0;55,621111;8,480555
